time,subj_course_id,sec_code,sec_id,prof,available,waitlist,total,enrolled_ct
1657192942028,COGS 9,A01,083615,Shannon; Kyle Michael,7,0,75,68
1657192948059,COGS 11,A01,083617,Boyle; Mary E. T.,22,0,48,26
1657192954085,COGS 13,A01,083071,Bastos; Amalia Pinkusfeld,9,0,71,62
1657192960122,COGS 14A,A01,092681,Semenuks; Arturs,1,1,100,99
1657192966152,COGS 14B,A01,083073,Cheng; Tzu-Han,6,0,63,57
1657192972186,COGS 17,A01,092677,Semenuks; Arturs,4,0,81,77
1657192978218,COGS 100,A01,083619,Allen; Michael Gordon,15,0,70,55
1657192984247,COGS 101A,A01,083621,Davis; Joshua Daniel,9,0,68,59
1657192990278,COGS 101B,A01,091572,Allen; Michael Gordon,9,0,65,56
1657192996310,COGS 101C,A01,083625,Delgado; Tania,17,0,35,18
1657193002339,COGS 107A,A01,083627,Boyle; Mary E. T.,13,0,60,47
1657193008370,COGS 118A,A01,083075,Gupta; Anjum,16,0,76,60
1657193014398,CSE 3,A50,083646,Miranda; Gregory Joseph,24,0,50,26
1657193020433,CSE 8A,A50,083650,Miranda; Gregory Joseph,17,1,56,39
1657193026461,CSE 11,A01,083080,Cao; Yingjun,5,15,40,35
1657193032489,CSE 12,A01,083652,Krause-Levy; Sophia Louisa,24,1,120,96
1657193038521,CSE 15L,A01,083654,Morris; Justin Loren,9,0,50,41
1657193038521,CSE 15L,A02,083655,Morris; Justin Loren,9,0,50,41
1657193044556,CSE 20,A01,083657,Tran; Khoa Dang,38,0,80,42
1657193050585,CSE 21,A01,095574,Bach; Quang Tran,22,0,48,26
1657193056615,CSE 30,A01,083084,Eldon; John,4,0,80,76
1657193056615,CSE 30,B01,095061,Bhaskar; Nishant,7,0,50,43
1657193062650,CSE 100,A01,083659,Cao; Yingjun,4,4,70,66
1657193068684,CSE 134B,A01,083661,Powell; Thomas Allan,20,0,100,80
1657193074713,CSE 140,A01,083663,Gungor; Onat,13,0,85,72
1657193080741,CSE 140L,A01,083088,Eldon; John,17,0,100,83
1657193086772,CSE 175,A01,083665,Kumar; Rakesh,3,0,25,22
1657193092802,CSE 190,A00,092507,Dubnov; Shlomo,7,0,20,13
1657193098839,ECE 45,A01,083139,Congero; Spencer William,5,0,75,70
1657193104868,ECE 65,A50,083695,Saad; Andrew S,12,0,30,18
1657193104868,ECE 65,A51,095125,Saad; Andrew S,25,0,26,1
1657193110900,ECE 109,A01,091882,Touri; Behrouz,19,0,70,51
1657193116936,ECE 180,A00,083140,Abi Samra; Nicholas Camill,1,0,30,29
1657193116936,ECE 180,B00,083141,Abi Samra; Nicholas Camill,0,0,30,30
1657193122969,MATH 10A,A01,083735,Patchell; Gregory David,2,0,30,28
1657193122969,MATH 10A,A02,083736,Patchell; Gregory David,20,0,30,10
1657193122969,MATH 10A,A03,083737,Patchell; Gregory David,16,0,30,14
1657193129006,MATH 10B,A01,083207,Lim; Seonhee,7,0,34,27
1657193129006,MATH 10B,A02,083208,Lim; Seonhee,9,0,35,26
1657193129006,MATH 10B,A03,093472,Lim; Seonhee,5,0,34,29
1657193129006,MATH 10B,B01,083739,Sinha; Shubham,10,0,30,20
1657193135033,MATH 18,A01,083743,Cinel; Cameron Alexander,6,0,30,24
1657193135033,MATH 18,A02,083744,Cinel; Cameron Alexander,15,0,30,15
1657193135033,MATH 18,A03,083745,Cinel; Cameron Alexander,8,0,30,22
1657193135033,MATH 18,B01,083748,Rideout; David Porter,4,0,37,33
1657193135033,MATH 18,B02,083749,Rideout; David Porter,4,0,36,32
1657193135033,MATH 18,B03,083750,Rideout; David Porter,2,0,37,35
1657193135033,MATH 18,B04,083751,Rideout; David Porter,5,0,36,31
1657193135033,MATH 18,B05,093473,Rideout; David Porter,5,0,36,31
1657193135033,MATH 18,B06,093474,Rideout; David Porter,5,0,36,31
1657193141066,MATH 20A,A01,083754,Zheng; Zequn,13,0,40,27
1657193147102,MATH 20B,A01,083756,Briones; Jor-el Thomas Caparas,1,0,36,35
1657193147102,MATH 20B,A02,083757,Briones; Jor-el Thomas Caparas,1,0,36,35
1657193147102,MATH 20B,A03,093475,Briones; Jor-el Thomas Caparas,1,0,36,35
1657193153131,MATH 20C,A01,083760,Briones; Jor-el Thomas Caparas,1,0,35,34
1657193153131,MATH 20C,A02,083761,Briones; Jor-el Thomas Caparas,8,0,35,27
1657193153131,MATH 20C,A03,093476,Briones; Jor-el Thomas Caparas,0,1,36,36
1657193153131,MATH 20C,B01,083762,Bach; Quang Tran,1,0,30,29
1657193159164,MATH 20D,A01,083765,Tran; Brian Kha,4,0,30,26
1657193159164,MATH 20D,A02,083766,Tran; Brian Kha,5,0,30,25
1657193159164,MATH 20D,A03,083767,Tran; Brian Kha,4,0,30,26
1657193165194,MATH 20E,A01,083771,Ganguly; Soumya,7,0,32,25
1657193165194,MATH 20E,A02,083772,Ganguly; Soumya,7,0,32,25
1657193165194,MATH 20E,B01,083773,Ciotti; Benjamin,19,0,35,16
1657193165194,MATH 20E,B02,083774,Ciotti; Benjamin,17,0,35,18
1657193171228,MATH 103A,A01,083777,Greenfeld; Be'Eri,2,0,36,34
1657193171228,MATH 103A,A02,083778,Greenfeld; Be'Eri,5,0,36,31
1657193171228,MATH 103A,A03,093561,Greenfeld; Be'Eri,4,0,36,32
1657193171228,MATH 103A,B01,083779,Greenfeld; Be'Eri,6,0,36,30
1657193171228,MATH 103A,B02,083780,Greenfeld; Be'Eri,3,0,36,33
1657193171228,MATH 103A,B03,093562,Greenfeld; Be'Eri,3,0,36,33
1657193177262,MATH 105,A01,085443,Carter; Anne Toulson,14,0,35,21
1657193177262,MATH 105,A02,093477,Carter; Anne Toulson,20,0,35,15
1657193183294,MATH 109,A01,083213,Ganzberger; Geoffrey Michael,2,0,34,32
1657193183294,MATH 109,A02,083214,Ganzberger; Geoffrey Michael,4,0,34,30
1657193183294,MATH 109,A03,093478,Ganzberger; Geoffrey Michael,1,0,34,33
1657193183294,MATH 109,B01,083215,Ganzberger; Geoffrey Michael,1,0,32,31
1657193183294,MATH 109,B02,083216,Ganzberger; Geoffrey Michael,1,0,32,31
1657193183294,MATH 109,B03,093479,Ganzberger; Geoffrey Michael,7,0,32,25
1657193189326,MATH 142A,A01,083219,Chow; Bennett,6,0,32,26
1657193189326,MATH 142A,A02,083220,Chow; Bennett,10,0,32,22
1657193189326,MATH 142A,A03,093480,Chow; Bennett,7,0,32,25
1657193189326,MATH 142A,B03,093481,Chow; Bennett,8,0,32,24
1657193189326,MATH 142A,B04,093558,Chow; Bennett,11,0,32,21
1657193189326,MATH 142A,B05,093559,Chow; Bennett,6,0,32,26
1657193195364,MATH 193A,A01,083224,Rotar; Vladimir,7,0,34,27
1657193195364,MATH 193A,A02,083225,Rotar; Vladimir,5,0,34,29
1657193195364,MATH 193A,A03,083781,Rotar; Vladimir,1,0,34,33
1657193195364,MATH 193A,A04,083782,Rotar; Vladimir,8,0,34,26
1657193195364,MATH 193A,A05,093482,Rotar; Vladimir,6,0,34,28
1657193201393,MATH 197,001,091859,McAuley; Julian John,9999,0,9999,0
1657193201393,MATH 197,002,095566,Kedlaya; Kiran S.,9997,0,9999,2
1657193201393,MATH 197,003,095567,Xiao; Ming,9999,0,9999,0
1657193201393,MATH 197,004,095571,Perols; Johan Lars,9998,0,9999,1
1657193208498,COGS 9,A01,083615,Shannon; Kyle Michael,7,0,75,68
1657193214526,COGS 11,A01,083617,Boyle; Mary E. T.,22,0,48,26
1657193220561,COGS 13,A01,083071,Bastos; Amalia Pinkusfeld,9,0,71,62
1657193226591,COGS 14A,A01,092681,Semenuks; Arturs,1,1,100,99
1657193232622,COGS 14B,A01,083073,Cheng; Tzu-Han,6,0,63,57
1657193238657,COGS 17,A01,092677,Semenuks; Arturs,4,0,81,77
1657193244691,COGS 100,A01,083619,Allen; Michael Gordon,15,0,70,55
1657193250722,COGS 101A,A01,083621,Davis; Joshua Daniel,9,0,68,59
1657193256753,COGS 101B,A01,091572,Allen; Michael Gordon,9,0,65,56
1657193262784,COGS 101C,A01,083625,Delgado; Tania,17,0,35,18
1657193268813,COGS 107A,A01,083627,Boyle; Mary E. T.,13,0,60,47
1657193274842,COGS 118A,A01,083075,Gupta; Anjum,16,0,76,60
1657193280872,CSE 3,A50,083646,Miranda; Gregory Joseph,24,0,50,26
1657193286904,CSE 8A,A50,083650,Miranda; Gregory Joseph,17,1,56,39
1657193292935,CSE 11,A01,083080,Cao; Yingjun,5,15,40,35
1657193298973,CSE 12,A01,083652,Krause-Levy; Sophia Louisa,24,1,120,96
1657193305000,CSE 15L,A01,083654,Morris; Justin Loren,9,0,50,41
1657193305000,CSE 15L,A02,083655,Morris; Justin Loren,9,0,50,41
1657193311035,CSE 20,A01,083657,Tran; Khoa Dang,38,0,80,42
1657193317063,CSE 21,A01,095574,Bach; Quang Tran,22,0,48,26
1657193323092,CSE 30,A01,083084,Eldon; John,4,0,80,76
1657193323092,CSE 30,B01,095061,Bhaskar; Nishant,7,0,50,43
1657193329119,CSE 100,A01,083659,Cao; Yingjun,4,4,70,66
1657193335152,CSE 134B,A01,083661,Powell; Thomas Allan,20,0,100,80
1657193341179,CSE 140,A01,083663,Gungor; Onat,13,0,85,72
1657193347207,CSE 140L,A01,083088,Eldon; John,17,0,100,83
1657193353239,CSE 175,A01,083665,Kumar; Rakesh,3,0,25,22
1657193359268,CSE 190,A00,092507,Dubnov; Shlomo,7,0,20,13
1657193365299,ECE 45,A01,083139,Congero; Spencer William,5,0,75,70
1657193371331,ECE 65,A50,083695,Saad; Andrew S,12,0,30,18
1657193371331,ECE 65,A51,095125,Saad; Andrew S,25,0,26,1
1657193377359,ECE 109,A01,091882,Touri; Behrouz,19,0,70,51
1657193383389,ECE 180,A00,083140,Abi Samra; Nicholas Camill,1,0,30,29
1657193383389,ECE 180,B00,083141,Abi Samra; Nicholas Camill,0,0,30,30
1657193389426,MATH 10A,A01,083735,Patchell; Gregory David,2,0,30,28
1657193389426,MATH 10A,A02,083736,Patchell; Gregory David,20,0,30,10
1657193389426,MATH 10A,A03,083737,Patchell; Gregory David,16,0,30,14
1657193395459,MATH 10B,A01,083207,Lim; Seonhee,7,0,34,27
1657193395459,MATH 10B,A02,083208,Lim; Seonhee,9,0,35,26
1657193395459,MATH 10B,A03,093472,Lim; Seonhee,5,0,34,29
1657193395459,MATH 10B,B01,083739,Sinha; Shubham,10,0,30,20
1657193401493,MATH 18,A01,083743,Cinel; Cameron Alexander,6,0,30,24
1657193401493,MATH 18,A02,083744,Cinel; Cameron Alexander,15,0,30,15
1657193401493,MATH 18,A03,083745,Cinel; Cameron Alexander,8,0,30,22
1657193401493,MATH 18,B01,083748,Rideout; David Porter,4,0,37,33
1657193401493,MATH 18,B02,083749,Rideout; David Porter,4,0,36,32
1657193401493,MATH 18,B03,083750,Rideout; David Porter,2,0,37,35
1657193401493,MATH 18,B04,083751,Rideout; David Porter,5,0,36,31
1657193401493,MATH 18,B05,093473,Rideout; David Porter,5,0,36,31
1657193401493,MATH 18,B06,093474,Rideout; David Porter,5,0,36,31
1657193407521,MATH 20A,A01,083754,Zheng; Zequn,13,0,40,27
1657193413553,MATH 20B,A01,083756,Briones; Jor-el Thomas Caparas,1,0,36,35
1657193413553,MATH 20B,A02,083757,Briones; Jor-el Thomas Caparas,1,0,36,35
1657193413553,MATH 20B,A03,093475,Briones; Jor-el Thomas Caparas,1,0,36,35
1657193419591,MATH 20C,A01,083760,Briones; Jor-el Thomas Caparas,1,0,35,34
1657193419591,MATH 20C,A02,083761,Briones; Jor-el Thomas Caparas,8,0,35,27
1657193419591,MATH 20C,A03,093476,Briones; Jor-el Thomas Caparas,0,1,36,36
1657193419591,MATH 20C,B01,083762,Bach; Quang Tran,1,0,30,29
1657193425621,MATH 20D,A01,083765,Tran; Brian Kha,4,0,30,26
1657193425621,MATH 20D,A02,083766,Tran; Brian Kha,5,0,30,25
1657193425621,MATH 20D,A03,083767,Tran; Brian Kha,4,0,30,26
1657193431655,MATH 20E,A01,083771,Ganguly; Soumya,7,0,32,25
1657193431655,MATH 20E,A02,083772,Ganguly; Soumya,7,0,32,25
1657193431655,MATH 20E,B01,083773,Ciotti; Benjamin,19,0,35,16
1657193431655,MATH 20E,B02,083774,Ciotti; Benjamin,17,0,35,18
1657193437689,MATH 103A,A01,083777,Greenfeld; Be'Eri,2,0,36,34
1657193437689,MATH 103A,A02,083778,Greenfeld; Be'Eri,5,0,36,31
1657193437689,MATH 103A,A03,093561,Greenfeld; Be'Eri,4,0,36,32
1657193437689,MATH 103A,B01,083779,Greenfeld; Be'Eri,6,0,36,30
1657193437689,MATH 103A,B02,083780,Greenfeld; Be'Eri,3,0,36,33
1657193437689,MATH 103A,B03,093562,Greenfeld; Be'Eri,3,0,36,33
1657193443721,MATH 105,A01,085443,Carter; Anne Toulson,14,0,35,21
1657193443721,MATH 105,A02,093477,Carter; Anne Toulson,20,0,35,15
1657193449748,MATH 109,A01,083213,Ganzberger; Geoffrey Michael,2,0,34,32
1657193449748,MATH 109,A02,083214,Ganzberger; Geoffrey Michael,4,0,34,30
1657193449748,MATH 109,A03,093478,Ganzberger; Geoffrey Michael,1,0,34,33
1657193449748,MATH 109,B01,083215,Ganzberger; Geoffrey Michael,1,0,32,31
1657193449748,MATH 109,B02,083216,Ganzberger; Geoffrey Michael,1,0,32,31
1657193449748,MATH 109,B03,093479,Ganzberger; Geoffrey Michael,7,0,32,25
1657193455780,MATH 142A,A01,083219,Chow; Bennett,6,0,32,26
1657193455780,MATH 142A,A02,083220,Chow; Bennett,10,0,32,22
1657193455780,MATH 142A,A03,093480,Chow; Bennett,7,0,32,25
1657193455780,MATH 142A,B03,093481,Chow; Bennett,8,0,32,24
1657193455780,MATH 142A,B04,093558,Chow; Bennett,11,0,32,21
1657193455780,MATH 142A,B05,093559,Chow; Bennett,6,0,32,26
1657193461810,MATH 193A,A01,083224,Rotar; Vladimir,7,0,34,27
1657193461810,MATH 193A,A02,083225,Rotar; Vladimir,5,0,34,29
1657193461810,MATH 193A,A03,083781,Rotar; Vladimir,1,0,34,33
1657193461810,MATH 193A,A04,083782,Rotar; Vladimir,8,0,34,26
1657193461810,MATH 193A,A05,093482,Rotar; Vladimir,6,0,34,28
1657193467839,MATH 197,001,091859,McAuley; Julian John,9999,0,9999,0
1657193467839,MATH 197,002,095566,Kedlaya; Kiran S.,9997,0,9999,2
1657193467839,MATH 197,003,095567,Xiao; Ming,9999,0,9999,0
1657193467839,MATH 197,004,095571,Perols; Johan Lars,9998,0,9999,1
1657193474907,COGS 9,A01,083615,Shannon; Kyle Michael,7,0,75,68
1657193480937,COGS 11,A01,083617,Boyle; Mary E. T.,22,0,48,26
1657193486967,COGS 13,A01,083071,Bastos; Amalia Pinkusfeld,9,0,71,62
1657193492998,COGS 14A,A01,092681,Semenuks; Arturs,1,1,100,99
1657193499030,COGS 14B,A01,083073,Cheng; Tzu-Han,6,0,63,57
1657193505058,COGS 17,A01,092677,Semenuks; Arturs,4,0,81,77
1657193511091,COGS 100,A01,083619,Allen; Michael Gordon,15,0,70,55
1657193517197,COGS 101A,A01,083621,Davis; Joshua Daniel,9,0,68,59
1657193523229,COGS 101B,A01,091572,Allen; Michael Gordon,9,0,65,56
1657193529255,COGS 101C,A01,083625,Delgado; Tania,17,0,35,18
1657193535285,COGS 107A,A01,083627,Boyle; Mary E. T.,13,0,60,47
1657193541315,COGS 118A,A01,083075,Gupta; Anjum,16,0,76,60
1657193547347,CSE 3,A50,083646,Miranda; Gregory Joseph,24,0,50,26
1657193553377,CSE 8A,A50,083650,Miranda; Gregory Joseph,17,1,56,39
1657193559405,CSE 11,A01,083080,Cao; Yingjun,5,15,40,35
1657193565437,CSE 12,A01,083652,Krause-Levy; Sophia Louisa,24,1,120,96
1657193571469,CSE 15L,A01,083654,Morris; Justin Loren,9,0,50,41
1657193571469,CSE 15L,A02,083655,Morris; Justin Loren,9,0,50,41
1657193577499,CSE 20,A01,083657,Tran; Khoa Dang,38,0,80,42
1657193583527,CSE 21,A01,095574,Bach; Quang Tran,22,0,48,26
1657193589559,CSE 30,A01,083084,Eldon; John,4,0,80,76
1657193589559,CSE 30,B01,095061,Bhaskar; Nishant,7,0,50,43
1657193595586,CSE 100,A01,083659,Cao; Yingjun,4,4,70,66
1657193601616,CSE 134B,A01,083661,Powell; Thomas Allan,20,0,100,80
1657193607649,CSE 140,A01,083663,Gungor; Onat,13,0,85,72
1657193613675,CSE 140L,A01,083088,Eldon; John,17,0,100,83
1657193619703,CSE 175,A01,083665,Kumar; Rakesh,3,0,25,22
1657193625736,CSE 190,A00,092507,Dubnov; Shlomo,7,0,20,13
1657193631762,ECE 45,A01,083139,Congero; Spencer William,5,0,75,70
1657193637793,ECE 65,A50,083695,Saad; Andrew S,12,0,30,18
1657193637793,ECE 65,A51,095125,Saad; Andrew S,25,0,26,1
1657193643829,ECE 109,A01,091882,Touri; Behrouz,19,0,70,51
1657193649860,ECE 180,A00,083140,Abi Samra; Nicholas Camill,1,0,30,29
1657193649860,ECE 180,B00,083141,Abi Samra; Nicholas Camill,0,0,30,30
1657193655893,MATH 10A,A01,083735,Patchell; Gregory David,2,0,30,28
1657193655893,MATH 10A,A02,083736,Patchell; Gregory David,20,0,30,10
1657193655893,MATH 10A,A03,083737,Patchell; Gregory David,16,0,30,14
1657193661924,MATH 10B,A01,083207,Lim; Seonhee,7,0,34,27
1657193661924,MATH 10B,A02,083208,Lim; Seonhee,9,0,35,26
1657193661924,MATH 10B,A03,093472,Lim; Seonhee,5,0,34,29
1657193661924,MATH 10B,B01,083739,Sinha; Shubham,10,0,30,20
1657193667959,MATH 18,A01,083743,Cinel; Cameron Alexander,6,0,30,24
1657193667959,MATH 18,A02,083744,Cinel; Cameron Alexander,15,0,30,15
1657193667959,MATH 18,A03,083745,Cinel; Cameron Alexander,8,0,30,22
1657193667959,MATH 18,B01,083748,Rideout; David Porter,4,0,37,33
1657193667959,MATH 18,B02,083749,Rideout; David Porter,4,0,36,32
1657193667959,MATH 18,B03,083750,Rideout; David Porter,2,0,37,35
1657193667959,MATH 18,B04,083751,Rideout; David Porter,5,0,36,31
1657193667959,MATH 18,B05,093473,Rideout; David Porter,5,0,36,31
1657193667959,MATH 18,B06,093474,Rideout; David Porter,5,0,36,31
1657193673990,MATH 20A,A01,083754,Zheng; Zequn,13,0,40,27
1657193680018,MATH 20B,A01,083756,Briones; Jor-el Thomas Caparas,1,0,36,35
1657193680018,MATH 20B,A02,083757,Briones; Jor-el Thomas Caparas,1,0,36,35
1657193680018,MATH 20B,A03,093475,Briones; Jor-el Thomas Caparas,1,0,36,35
1657193686051,MATH 20C,A01,083760,Briones; Jor-el Thomas Caparas,1,0,35,34
1657193686051,MATH 20C,A02,083761,Briones; Jor-el Thomas Caparas,8,0,35,27
1657193686051,MATH 20C,A03,093476,Briones; Jor-el Thomas Caparas,0,1,36,36
1657193686051,MATH 20C,B01,083762,Bach; Quang Tran,1,0,30,29
1657193692081,MATH 20D,A01,083765,Tran; Brian Kha,4,0,30,26
1657193692081,MATH 20D,A02,083766,Tran; Brian Kha,5,0,30,25
1657193692081,MATH 20D,A03,083767,Tran; Brian Kha,4,0,30,26
1657193698114,MATH 20E,A01,083771,Ganguly; Soumya,7,0,32,25
1657193698114,MATH 20E,A02,083772,Ganguly; Soumya,7,0,32,25
1657193698114,MATH 20E,B01,083773,Ciotti; Benjamin,19,0,35,16
1657193698114,MATH 20E,B02,083774,Ciotti; Benjamin,17,0,35,18
1657193704149,MATH 103A,A01,083777,Greenfeld; Be'Eri,2,0,36,34
1657193704149,MATH 103A,A02,083778,Greenfeld; Be'Eri,5,0,36,31
1657193704149,MATH 103A,A03,093561,Greenfeld; Be'Eri,4,0,36,32
1657193704149,MATH 103A,B01,083779,Greenfeld; Be'Eri,6,0,36,30
1657193704149,MATH 103A,B02,083780,Greenfeld; Be'Eri,3,0,36,33
1657193704149,MATH 103A,B03,093562,Greenfeld; Be'Eri,3,0,36,33
1657193710180,MATH 105,A01,085443,Carter; Anne Toulson,14,0,35,21
1657193710180,MATH 105,A02,093477,Carter; Anne Toulson,20,0,35,15
1657193716215,MATH 109,A01,083213,Ganzberger; Geoffrey Michael,2,0,34,32
1657193716215,MATH 109,A02,083214,Ganzberger; Geoffrey Michael,4,0,34,30
1657193716215,MATH 109,A03,093478,Ganzberger; Geoffrey Michael,1,0,34,33
1657193716215,MATH 109,B01,083215,Ganzberger; Geoffrey Michael,1,0,32,31
1657193716215,MATH 109,B02,083216,Ganzberger; Geoffrey Michael,1,0,32,31
1657193716215,MATH 109,B03,093479,Ganzberger; Geoffrey Michael,7,0,32,25
1657193722240,MATH 142A,A01,083219,Chow; Bennett,6,0,32,26
1657193722240,MATH 142A,A02,083220,Chow; Bennett,10,0,32,22
1657193722240,MATH 142A,A03,093480,Chow; Bennett,7,0,32,25
1657193722240,MATH 142A,B03,093481,Chow; Bennett,8,0,32,24
1657193722240,MATH 142A,B04,093558,Chow; Bennett,11,0,32,21
1657193722240,MATH 142A,B05,093559,Chow; Bennett,6,0,32,26
1657193728283,MATH 193A,A01,083224,Rotar; Vladimir,7,0,34,27
1657193728283,MATH 193A,A02,083225,Rotar; Vladimir,5,0,34,29
1657193728283,MATH 193A,A03,083781,Rotar; Vladimir,1,0,34,33
1657193728283,MATH 193A,A04,083782,Rotar; Vladimir,8,0,34,26
1657193728283,MATH 193A,A05,093482,Rotar; Vladimir,6,0,34,28
1657193734312,MATH 197,001,091859,McAuley; Julian John,9999,0,9999,0
1657193734312,MATH 197,002,095566,Kedlaya; Kiran S.,9997,0,9999,2
1657193734312,MATH 197,003,095567,Xiao; Ming,9999,0,9999,0
1657193734312,MATH 197,004,095571,Perols; Johan Lars,9998,0,9999,1
1657193741383,COGS 9,A01,083615,Shannon; Kyle Michael,7,0,75,68
1657193747416,COGS 11,A01,083617,Boyle; Mary E. T.,22,0,48,26
1657193753443,COGS 13,A01,083071,Bastos; Amalia Pinkusfeld,9,0,71,62
1657193759471,COGS 14A,A01,092681,Semenuks; Arturs,1,1,100,99
1657193765505,COGS 14B,A01,083073,Cheng; Tzu-Han,6,0,63,57
1657193771533,COGS 17,A01,092677,Semenuks; Arturs,4,0,81,77
1657193777568,COGS 100,A01,083619,Allen; Michael Gordon,15,0,70,55
1657193783596,COGS 101A,A01,083621,Davis; Joshua Daniel,9,0,68,59
1657193789627,COGS 101B,A01,091572,Allen; Michael Gordon,9,0,65,56
1657193795656,COGS 101C,A01,083625,Delgado; Tania,17,0,35,18
1657193801687,COGS 107A,A01,083627,Boyle; Mary E. T.,13,0,60,47
1657193807717,COGS 118A,A01,083075,Gupta; Anjum,16,0,76,60
1657193813754,CSE 3,A50,083646,Miranda; Gregory Joseph,24,0,50,26
1657193819785,CSE 8A,A50,083650,Miranda; Gregory Joseph,17,1,56,39
1657193825817,CSE 11,A01,083080,Cao; Yingjun,5,15,40,35
1657193831846,CSE 12,A01,083652,Krause-Levy; Sophia Louisa,24,1,120,96
1657193837878,CSE 15L,A01,083654,Morris; Justin Loren,9,0,50,41
1657193837878,CSE 15L,A02,083655,Morris; Justin Loren,9,0,50,41
1657193843909,CSE 20,A01,083657,Tran; Khoa Dang,38,0,80,42
1657193849942,CSE 21,A01,095574,Bach; Quang Tran,22,0,48,26
1657193855972,CSE 30,A01,083084,Eldon; John,4,0,80,76
1657193855972,CSE 30,B01,095061,Bhaskar; Nishant,7,0,50,43
1657193861999,CSE 100,A01,083659,Cao; Yingjun,4,4,70,66
1657193868035,CSE 134B,A01,083661,Powell; Thomas Allan,20,0,100,80
1657193874061,CSE 140,A01,083663,Gungor; Onat,13,0,85,72
1657193880094,CSE 140L,A01,083088,Eldon; John,17,0,100,83
1657193886123,CSE 175,A01,083665,Kumar; Rakesh,3,0,25,22
1657193892149,CSE 190,A00,092507,Dubnov; Shlomo,7,0,20,13
1657193898176,ECE 45,A01,083139,Congero; Spencer William,5,0,75,70
1657193904211,ECE 65,A50,083695,Saad; Andrew S,12,0,30,18
1657193904211,ECE 65,A51,095125,Saad; Andrew S,25,0,26,1
1657193910241,ECE 109,A01,091882,Touri; Behrouz,19,0,70,51
1657193916272,ECE 180,A00,083140,Abi Samra; Nicholas Camill,1,0,30,29
1657193916272,ECE 180,B00,083141,Abi Samra; Nicholas Camill,0,0,30,30
1657193922302,MATH 10A,A01,083735,Patchell; Gregory David,2,0,30,28
1657193922302,MATH 10A,A02,083736,Patchell; Gregory David,20,0,30,10
1657193922302,MATH 10A,A03,083737,Patchell; Gregory David,16,0,30,14
1657193928336,MATH 10B,A01,083207,Lim; Seonhee,7,0,34,27
1657193928336,MATH 10B,A02,083208,Lim; Seonhee,9,0,35,26
1657193928336,MATH 10B,A03,093472,Lim; Seonhee,5,0,34,29
1657193928336,MATH 10B,B01,083739,Sinha; Shubham,10,0,30,20
1657193934364,MATH 18,A01,083743,Cinel; Cameron Alexander,6,0,30,24
1657193934364,MATH 18,A02,083744,Cinel; Cameron Alexander,15,0,30,15
1657193934364,MATH 18,A03,083745,Cinel; Cameron Alexander,8,0,30,22
1657193934364,MATH 18,B01,083748,Rideout; David Porter,4,0,37,33
1657193934364,MATH 18,B02,083749,Rideout; David Porter,4,0,36,32
1657193934364,MATH 18,B03,083750,Rideout; David Porter,2,0,37,35
1657193934364,MATH 18,B04,083751,Rideout; David Porter,5,0,36,31
1657193934364,MATH 18,B05,093473,Rideout; David Porter,5,0,36,31
1657193934364,MATH 18,B06,093474,Rideout; David Porter,5,0,36,31
1657193940396,MATH 20A,A01,083754,Zheng; Zequn,13,0,40,27
1657193946429,MATH 20B,A01,083756,Briones; Jor-el Thomas Caparas,1,0,36,35
1657193946429,MATH 20B,A02,083757,Briones; Jor-el Thomas Caparas,1,0,36,35
1657193946429,MATH 20B,A03,093475,Briones; Jor-el Thomas Caparas,1,0,36,35
1657193952460,MATH 20C,A01,083760,Briones; Jor-el Thomas Caparas,1,0,35,34
1657193952460,MATH 20C,A02,083761,Briones; Jor-el Thomas Caparas,8,0,35,27
1657193952460,MATH 20C,A03,093476,Briones; Jor-el Thomas Caparas,0,1,36,36
1657193952460,MATH 20C,B01,083762,Bach; Quang Tran,1,0,30,29
1657193958499,MATH 20D,A01,083765,Tran; Brian Kha,4,0,30,26
1657193958499,MATH 20D,A02,083766,Tran; Brian Kha,5,0,30,25
1657193958499,MATH 20D,A03,083767,Tran; Brian Kha,4,0,30,26
1657193964524,MATH 20E,A01,083771,Ganguly; Soumya,7,0,32,25
1657193964524,MATH 20E,A02,083772,Ganguly; Soumya,7,0,32,25
1657193964524,MATH 20E,B01,083773,Ciotti; Benjamin,19,0,35,16
1657193964524,MATH 20E,B02,083774,Ciotti; Benjamin,17,0,35,18
1657193970560,MATH 103A,A01,083777,Greenfeld; Be'Eri,2,0,36,34
1657193970560,MATH 103A,A02,083778,Greenfeld; Be'Eri,5,0,36,31
1657193970560,MATH 103A,A03,093561,Greenfeld; Be'Eri,4,0,36,32
1657193970560,MATH 103A,B01,083779,Greenfeld; Be'Eri,6,0,36,30
1657193970560,MATH 103A,B02,083780,Greenfeld; Be'Eri,3,0,36,33
1657193970560,MATH 103A,B03,093562,Greenfeld; Be'Eri,3,0,36,33
1657193976590,MATH 105,A01,085443,Carter; Anne Toulson,14,0,35,21
1657193976590,MATH 105,A02,093477,Carter; Anne Toulson,20,0,35,15
1657193982622,MATH 109,A01,083213,Ganzberger; Geoffrey Michael,2,0,34,32
1657193982622,MATH 109,A02,083214,Ganzberger; Geoffrey Michael,4,0,34,30
1657193982622,MATH 109,A03,093478,Ganzberger; Geoffrey Michael,1,0,34,33
1657193982622,MATH 109,B01,083215,Ganzberger; Geoffrey Michael,1,0,32,31
1657193982622,MATH 109,B02,083216,Ganzberger; Geoffrey Michael,1,0,32,31
1657193982622,MATH 109,B03,093479,Ganzberger; Geoffrey Michael,7,0,32,25
1657193988652,MATH 142A,A01,083219,Chow; Bennett,6,0,32,26
1657193988652,MATH 142A,A02,083220,Chow; Bennett,10,0,32,22
1657193988652,MATH 142A,A03,093480,Chow; Bennett,7,0,32,25
1657193988652,MATH 142A,B03,093481,Chow; Bennett,8,0,32,24
1657193988652,MATH 142A,B04,093558,Chow; Bennett,11,0,32,21
1657193988652,MATH 142A,B05,093559,Chow; Bennett,6,0,32,26
1657193994681,MATH 193A,A01,083224,Rotar; Vladimir,7,0,34,27
1657193994681,MATH 193A,A02,083225,Rotar; Vladimir,5,0,34,29
1657193994681,MATH 193A,A03,083781,Rotar; Vladimir,1,0,34,33
1657193994681,MATH 193A,A04,083782,Rotar; Vladimir,8,0,34,26
1657193994681,MATH 193A,A05,093482,Rotar; Vladimir,6,0,34,28
1657194000707,MATH 197,001,091859,McAuley; Julian John,9999,0,9999,0
1657194000707,MATH 197,002,095566,Kedlaya; Kiran S.,9997,0,9999,2
1657194000707,MATH 197,003,095567,Xiao; Ming,9999,0,9999,0
1657194000707,MATH 197,004,095571,Perols; Johan Lars,9998,0,9999,1
1657194007778,COGS 9,A01,083615,Shannon; Kyle Michael,7,0,75,68
1657194013807,COGS 11,A01,083617,Boyle; Mary E. T.,22,0,48,26
1657194019836,COGS 13,A01,083071,Bastos; Amalia Pinkusfeld,9,0,71,62
1657194025867,COGS 14A,A01,092681,Semenuks; Arturs,1,1,100,99
1657194031894,COGS 14B,A01,083073,Cheng; Tzu-Han,6,0,63,57
1657194037923,COGS 17,A01,092677,Semenuks; Arturs,4,0,81,77
1657194043953,COGS 100,A01,083619,Allen; Michael Gordon,15,0,70,55
1657194049979,COGS 101A,A01,083621,Davis; Joshua Daniel,9,0,68,59
1657194056006,COGS 101B,A01,091572,Allen; Michael Gordon,9,0,65,56
1657194062035,COGS 101C,A01,083625,Delgado; Tania,17,0,35,18
1657194068066,COGS 107A,A01,083627,Boyle; Mary E. T.,13,0,60,47
1657194074093,COGS 118A,A01,083075,Gupta; Anjum,16,0,76,60
1657194080123,CSE 3,A50,083646,Miranda; Gregory Joseph,24,0,50,26
1657194086149,CSE 8A,A50,083650,Miranda; Gregory Joseph,17,1,56,39
1657194092179,CSE 11,A01,083080,Cao; Yingjun,5,15,40,35
1657194098208,CSE 12,A01,083652,Krause-Levy; Sophia Louisa,24,1,120,96
1657194104235,CSE 15L,A01,083654,Morris; Justin Loren,9,0,50,41
1657194104235,CSE 15L,A02,083655,Morris; Justin Loren,9,0,50,41
1657194110265,CSE 20,A01,083657,Tran; Khoa Dang,38,0,80,42
1657194116378,CSE 21,A01,095574,Bach; Quang Tran,22,0,48,26
1657194122408,CSE 30,A01,083084,Eldon; John,4,0,80,76
1657194122408,CSE 30,B01,095061,Bhaskar; Nishant,7,0,50,43
1657194128434,CSE 100,A01,083659,Cao; Yingjun,4,4,70,66
1657194134461,CSE 134B,A01,083661,Powell; Thomas Allan,20,0,100,80
1657194140490,CSE 140,A01,083663,Gungor; Onat,13,0,85,72
1657194146520,CSE 140L,A01,083088,Eldon; John,17,0,100,83
1657194152550,CSE 175,A01,083665,Kumar; Rakesh,3,0,25,22
1657194158577,CSE 190,A00,092507,Dubnov; Shlomo,7,0,20,13
1657194164604,ECE 45,A01,083139,Congero; Spencer William,5,0,75,70
1657194170632,ECE 65,A50,083695,Saad; Andrew S,12,0,30,18
1657194170632,ECE 65,A51,095125,Saad; Andrew S,25,0,26,1
1657194176658,ECE 109,A01,091882,Touri; Behrouz,19,0,70,51
1657194182686,ECE 180,A00,083140,Abi Samra; Nicholas Camill,1,0,30,29
1657194182686,ECE 180,B00,083141,Abi Samra; Nicholas Camill,0,0,30,30
1657194188715,MATH 10A,A01,083735,Patchell; Gregory David,2,0,30,28
1657194188715,MATH 10A,A02,083736,Patchell; Gregory David,20,0,30,10
1657194188715,MATH 10A,A03,083737,Patchell; Gregory David,16,0,30,14
1657194194748,MATH 10B,A01,083207,Lim; Seonhee,7,0,34,27
1657194194748,MATH 10B,A02,083208,Lim; Seonhee,9,0,35,26
1657194194748,MATH 10B,A03,093472,Lim; Seonhee,5,0,34,29
1657194194748,MATH 10B,B01,083739,Sinha; Shubham,10,0,30,20
1657194200778,MATH 18,A01,083743,Cinel; Cameron Alexander,6,0,30,24
1657194200778,MATH 18,A02,083744,Cinel; Cameron Alexander,15,0,30,15
1657194200778,MATH 18,A03,083745,Cinel; Cameron Alexander,8,0,30,22
1657194200778,MATH 18,B01,083748,Rideout; David Porter,4,0,37,33
1657194200778,MATH 18,B02,083749,Rideout; David Porter,4,0,36,32
1657194200778,MATH 18,B03,083750,Rideout; David Porter,2,0,37,35
1657194200778,MATH 18,B04,083751,Rideout; David Porter,5,0,36,31
1657194200778,MATH 18,B05,093473,Rideout; David Porter,5,0,36,31
1657194200778,MATH 18,B06,093474,Rideout; David Porter,5,0,36,31
1657194206804,MATH 20A,A01,083754,Zheng; Zequn,13,0,40,27
1657194212832,MATH 20B,A01,083756,Briones; Jor-el Thomas Caparas,1,0,36,35
1657194212832,MATH 20B,A02,083757,Briones; Jor-el Thomas Caparas,1,0,36,35
1657194212832,MATH 20B,A03,093475,Briones; Jor-el Thomas Caparas,1,0,36,35
1657194218861,MATH 20C,A01,083760,Briones; Jor-el Thomas Caparas,1,0,35,34
1657194218861,MATH 20C,A02,083761,Briones; Jor-el Thomas Caparas,8,0,35,27
1657194218861,MATH 20C,A03,093476,Briones; Jor-el Thomas Caparas,0,1,36,36
1657194218861,MATH 20C,B01,083762,Bach; Quang Tran,1,0,30,29
1657194224892,MATH 20D,A01,083765,Tran; Brian Kha,4,0,30,26
1657194224892,MATH 20D,A02,083766,Tran; Brian Kha,5,0,30,25
1657194224892,MATH 20D,A03,083767,Tran; Brian Kha,4,0,30,26
1657194230923,MATH 20E,A01,083771,Ganguly; Soumya,7,0,32,25
1657194230923,MATH 20E,A02,083772,Ganguly; Soumya,7,0,32,25
1657194230923,MATH 20E,B01,083773,Ciotti; Benjamin,19,0,35,16
1657194230923,MATH 20E,B02,083774,Ciotti; Benjamin,17,0,35,18
1657194236957,MATH 103A,A01,083777,Greenfeld; Be'Eri,2,0,36,34
1657194236957,MATH 103A,A02,083778,Greenfeld; Be'Eri,5,0,36,31
1657194236957,MATH 103A,A03,093561,Greenfeld; Be'Eri,4,0,36,32
1657194236957,MATH 103A,B01,083779,Greenfeld; Be'Eri,6,0,36,30
1657194236957,MATH 103A,B02,083780,Greenfeld; Be'Eri,3,0,36,33
1657194236957,MATH 103A,B03,093562,Greenfeld; Be'Eri,3,0,36,33
1657194242984,MATH 105,A01,085443,Carter; Anne Toulson,14,0,35,21
1657194242984,MATH 105,A02,093477,Carter; Anne Toulson,20,0,35,15
1657194249021,MATH 109,A01,083213,Ganzberger; Geoffrey Michael,2,0,34,32
1657194249021,MATH 109,A02,083214,Ganzberger; Geoffrey Michael,4,0,34,30
1657194249021,MATH 109,A03,093478,Ganzberger; Geoffrey Michael,1,0,34,33
1657194249021,MATH 109,B01,083215,Ganzberger; Geoffrey Michael,1,0,32,31
1657194249021,MATH 109,B02,083216,Ganzberger; Geoffrey Michael,1,0,32,31
1657194249021,MATH 109,B03,093479,Ganzberger; Geoffrey Michael,7,0,32,25
1657194255054,MATH 142A,A01,083219,Chow; Bennett,6,0,32,26
1657194255054,MATH 142A,A02,083220,Chow; Bennett,10,0,32,22
1657194255054,MATH 142A,A03,093480,Chow; Bennett,7,0,32,25
1657194255054,MATH 142A,B03,093481,Chow; Bennett,8,0,32,24
1657194255054,MATH 142A,B04,093558,Chow; Bennett,11,0,32,21
1657194255054,MATH 142A,B05,093559,Chow; Bennett,6,0,32,26
1657194261083,MATH 193A,A01,083224,Rotar; Vladimir,7,0,34,27
1657194261083,MATH 193A,A02,083225,Rotar; Vladimir,5,0,34,29
1657194261083,MATH 193A,A03,083781,Rotar; Vladimir,1,0,34,33
1657194261083,MATH 193A,A04,083782,Rotar; Vladimir,8,0,34,26
1657194261083,MATH 193A,A05,093482,Rotar; Vladimir,6,0,34,28
1657194267112,MATH 197,001,091859,McAuley; Julian John,9999,0,9999,0
1657194267112,MATH 197,002,095566,Kedlaya; Kiran S.,9997,0,9999,2
1657194267112,MATH 197,003,095567,Xiao; Ming,9999,0,9999,0
1657194267112,MATH 197,004,095571,Perols; Johan Lars,9998,0,9999,1
1657194274174,COGS 9,A01,083615,Shannon; Kyle Michael,7,0,75,68
1657194280201,COGS 11,A01,083617,Boyle; Mary E. T.,22,0,48,26
1657194286226,COGS 13,A01,083071,Bastos; Amalia Pinkusfeld,9,0,71,62
1657194292258,COGS 14A,A01,092681,Semenuks; Arturs,1,1,100,99
1657194298288,COGS 14B,A01,083073,Cheng; Tzu-Han,6,0,63,57
1657194304317,COGS 17,A01,092677,Semenuks; Arturs,4,0,81,77
1657194310343,COGS 100,A01,083619,Allen; Michael Gordon,15,0,70,55
1657194316372,COGS 101A,A01,083621,Davis; Joshua Daniel,9,0,68,59
1657194322399,COGS 101B,A01,091572,Allen; Michael Gordon,9,0,65,56
1657194328427,COGS 101C,A01,083625,Delgado; Tania,17,0,35,18
1657194334455,COGS 107A,A01,083627,Boyle; Mary E. T.,13,0,60,47
1657194340486,COGS 118A,A01,083075,Gupta; Anjum,16,0,76,60
1657194346514,CSE 3,A50,083646,Miranda; Gregory Joseph,24,0,50,26
1657194352542,CSE 8A,A50,083650,Miranda; Gregory Joseph,17,1,56,39
1657194358572,CSE 11,A01,083080,Cao; Yingjun,5,15,40,35
1657194364597,CSE 12,A01,083652,Krause-Levy; Sophia Louisa,24,1,120,96
1657194370623,CSE 15L,A01,083654,Morris; Justin Loren,9,0,50,41
1657194370623,CSE 15L,A02,083655,Morris; Justin Loren,9,0,50,41
1657194376652,CSE 20,A01,083657,Tran; Khoa Dang,38,0,80,42
1657194382681,CSE 21,A01,095574,Bach; Quang Tran,22,0,48,26
1657194388713,CSE 30,A01,083084,Eldon; John,4,0,80,76
1657194388713,CSE 30,B01,095061,Bhaskar; Nishant,7,0,50,43
1657194394750,CSE 100,A01,083659,Cao; Yingjun,4,4,70,66
1657194400774,CSE 134B,A01,083661,Powell; Thomas Allan,20,0,100,80
1657194406801,CSE 140,A01,083663,Gungor; Onat,13,0,85,72
1657194412826,CSE 140L,A01,083088,Eldon; John,17,0,100,83
1657194418856,CSE 175,A01,083665,Kumar; Rakesh,3,0,25,22
1657194424880,CSE 190,A00,092507,Dubnov; Shlomo,7,0,20,13
1657194430910,ECE 45,A01,083139,Congero; Spencer William,5,0,75,70
1657194436934,ECE 65,A50,083695,Saad; Andrew S,12,0,30,18
1657194436934,ECE 65,A51,095125,Saad; Andrew S,25,0,26,1
1657194442959,ECE 109,A01,091882,Touri; Behrouz,19,0,70,51
1657194448990,ECE 180,A00,083140,Abi Samra; Nicholas Camill,1,0,30,29
1657194448990,ECE 180,B00,083141,Abi Samra; Nicholas Camill,0,0,30,30
1657194455018,MATH 10A,A01,083735,Patchell; Gregory David,2,0,30,28
1657194455018,MATH 10A,A02,083736,Patchell; Gregory David,20,0,30,10
1657194455018,MATH 10A,A03,083737,Patchell; Gregory David,16,0,30,14
1657194461047,MATH 10B,A01,083207,Lim; Seonhee,7,0,34,27
1657194461047,MATH 10B,A02,083208,Lim; Seonhee,9,0,35,26
1657194461047,MATH 10B,A03,093472,Lim; Seonhee,5,0,34,29
1657194461047,MATH 10B,B01,083739,Sinha; Shubham,10,0,30,20
1657194467077,MATH 18,A01,083743,Cinel; Cameron Alexander,6,0,30,24
1657194467077,MATH 18,A02,083744,Cinel; Cameron Alexander,15,0,30,15
1657194467077,MATH 18,A03,083745,Cinel; Cameron Alexander,8,0,30,22
1657194467077,MATH 18,B01,083748,Rideout; David Porter,4,0,37,33
1657194467077,MATH 18,B02,083749,Rideout; David Porter,4,0,36,32
1657194467077,MATH 18,B03,083750,Rideout; David Porter,2,0,37,35
1657194467077,MATH 18,B04,083751,Rideout; David Porter,5,0,36,31
1657194467077,MATH 18,B05,093473,Rideout; David Porter,5,0,36,31
1657194467077,MATH 18,B06,093474,Rideout; David Porter,5,0,36,31
1657194473104,MATH 20A,A01,083754,Zheng; Zequn,13,0,40,27
1657194479129,MATH 20B,A01,083756,Briones; Jor-el Thomas Caparas,1,0,36,35
1657194479129,MATH 20B,A02,083757,Briones; Jor-el Thomas Caparas,1,0,36,35
1657194479129,MATH 20B,A03,093475,Briones; Jor-el Thomas Caparas,1,0,36,35
1657194485157,MATH 20C,A01,083760,Briones; Jor-el Thomas Caparas,1,0,35,34
1657194485157,MATH 20C,A02,083761,Briones; Jor-el Thomas Caparas,8,0,35,27
1657194485157,MATH 20C,A03,093476,Briones; Jor-el Thomas Caparas,0,1,36,36
1657194485157,MATH 20C,B01,083762,Bach; Quang Tran,1,0,30,29
1657194491185,MATH 20D,A01,083765,Tran; Brian Kha,4,0,30,26
1657194491185,MATH 20D,A02,083766,Tran; Brian Kha,5,0,30,25
1657194491185,MATH 20D,A03,083767,Tran; Brian Kha,4,0,30,26
1657194497218,MATH 20E,A01,083771,Ganguly; Soumya,7,0,32,25
1657194497218,MATH 20E,A02,083772,Ganguly; Soumya,7,0,32,25
1657194497218,MATH 20E,B01,083773,Ciotti; Benjamin,19,0,35,16
1657194497218,MATH 20E,B02,083774,Ciotti; Benjamin,17,0,35,18
1657194503246,MATH 103A,A01,083777,Greenfeld; Be'Eri,2,0,36,34
1657194503246,MATH 103A,A02,083778,Greenfeld; Be'Eri,5,0,36,31
1657194503246,MATH 103A,A03,093561,Greenfeld; Be'Eri,4,0,36,32
1657194503246,MATH 103A,B01,083779,Greenfeld; Be'Eri,6,0,36,30
1657194503246,MATH 103A,B02,083780,Greenfeld; Be'Eri,3,0,36,33
1657194503246,MATH 103A,B03,093562,Greenfeld; Be'Eri,3,0,36,33
1657194509278,MATH 105,A01,085443,Carter; Anne Toulson,14,0,35,21
1657194509278,MATH 105,A02,093477,Carter; Anne Toulson,20,0,35,15
1657194515307,MATH 109,A01,083213,Ganzberger; Geoffrey Michael,2,0,34,32
1657194515307,MATH 109,A02,083214,Ganzberger; Geoffrey Michael,4,0,34,30
1657194515307,MATH 109,A03,093478,Ganzberger; Geoffrey Michael,1,0,34,33
1657194515307,MATH 109,B01,083215,Ganzberger; Geoffrey Michael,1,0,32,31
1657194515307,MATH 109,B02,083216,Ganzberger; Geoffrey Michael,1,0,32,31
1657194515307,MATH 109,B03,093479,Ganzberger; Geoffrey Michael,7,0,32,25
1657194521335,MATH 142A,A01,083219,Chow; Bennett,6,0,32,26
1657194521335,MATH 142A,A02,083220,Chow; Bennett,10,0,32,22
1657194521335,MATH 142A,A03,093480,Chow; Bennett,7,0,32,25
1657194521335,MATH 142A,B03,093481,Chow; Bennett,8,0,32,24
1657194521335,MATH 142A,B04,093558,Chow; Bennett,11,0,32,21
1657194521335,MATH 142A,B05,093559,Chow; Bennett,6,0,32,26
1657194527367,MATH 193A,A01,083224,Rotar; Vladimir,7,0,34,27
1657194527367,MATH 193A,A02,083225,Rotar; Vladimir,5,0,34,29
1657194527367,MATH 193A,A03,083781,Rotar; Vladimir,1,0,34,33
1657194527367,MATH 193A,A04,083782,Rotar; Vladimir,8,0,34,26
1657194527367,MATH 193A,A05,093482,Rotar; Vladimir,6,0,34,28
1657194533394,MATH 197,001,091859,McAuley; Julian John,9999,0,9999,0
1657194533394,MATH 197,002,095566,Kedlaya; Kiran S.,9997,0,9999,2
1657194533394,MATH 197,003,095567,Xiao; Ming,9999,0,9999,0
1657194533394,MATH 197,004,095571,Perols; Johan Lars,9998,0,9999,1
1657194540480,COGS 9,A01,083615,Shannon; Kyle Michael,7,0,75,68
1657194546511,COGS 11,A01,083617,Boyle; Mary E. T.,22,0,48,26
1657194552538,COGS 13,A01,083071,Bastos; Amalia Pinkusfeld,9,0,71,62
1657194558566,COGS 14A,A01,092681,Semenuks; Arturs,1,1,100,99
1657194564595,COGS 14B,A01,083073,Cheng; Tzu-Han,6,0,63,57
1657194570621,COGS 17,A01,092677,Semenuks; Arturs,4,0,81,77
1657194576647,COGS 100,A01,083619,Allen; Michael Gordon,15,0,70,55
1657194582674,COGS 101A,A01,083621,Davis; Joshua Daniel,9,0,68,59
1657194588701,COGS 101B,A01,091572,Allen; Michael Gordon,9,0,65,56
1657194594732,COGS 101C,A01,083625,Delgado; Tania,17,0,35,18
1657194600761,COGS 107A,A01,083627,Boyle; Mary E. T.,13,0,60,47
1657194606790,COGS 118A,A01,083075,Gupta; Anjum,16,0,76,60
1657194612816,CSE 3,A50,083646,Miranda; Gregory Joseph,24,0,50,26
1657194618843,CSE 8A,A50,083650,Miranda; Gregory Joseph,17,1,56,39
1657194624874,CSE 11,A01,083080,Cao; Yingjun,5,15,40,35
1657194630902,CSE 12,A01,083652,Krause-Levy; Sophia Louisa,24,1,120,96
1657194636931,CSE 15L,A01,083654,Morris; Justin Loren,9,0,50,41
1657194636931,CSE 15L,A02,083655,Morris; Justin Loren,9,0,50,41
1657194642960,CSE 20,A01,083657,Tran; Khoa Dang,38,0,80,42
1657194648988,CSE 21,A01,095574,Bach; Quang Tran,22,0,48,26
1657194655015,CSE 30,A01,083084,Eldon; John,4,0,80,76
1657194655015,CSE 30,B01,095061,Bhaskar; Nishant,7,0,50,43
1657194661041,CSE 100,A01,083659,Cao; Yingjun,4,4,70,66
1657194667065,CSE 134B,A01,083661,Powell; Thomas Allan,20,0,100,80
1657194673092,CSE 140,A01,083663,Gungor; Onat,13,0,85,72
1657194679125,CSE 140L,A01,083088,Eldon; John,17,0,100,83
1657194685156,CSE 175,A01,083665,Kumar; Rakesh,3,0,25,22
1657194691189,CSE 190,A00,092507,Dubnov; Shlomo,7,0,20,13
1657194697214,ECE 45,A01,083139,Congero; Spencer William,5,0,75,70
1657194703243,ECE 65,A50,083695,Saad; Andrew S,12,0,30,18
1657194703243,ECE 65,A51,095125,Saad; Andrew S,25,0,26,1
1657194709271,ECE 109,A01,091882,Touri; Behrouz,19,0,70,51
1657194715371,ECE 180,A00,083140,Abi Samra; Nicholas Camill,1,0,30,29
1657194715371,ECE 180,B00,083141,Abi Samra; Nicholas Camill,0,0,30,30
1657194721400,MATH 10A,A01,083735,Patchell; Gregory David,2,0,30,28
1657194721400,MATH 10A,A02,083736,Patchell; Gregory David,20,0,30,10
1657194721400,MATH 10A,A03,083737,Patchell; Gregory David,16,0,30,14
1657194727430,MATH 10B,A01,083207,Lim; Seonhee,7,0,34,27
1657194727430,MATH 10B,A02,083208,Lim; Seonhee,9,0,35,26
1657194727430,MATH 10B,A03,093472,Lim; Seonhee,5,0,34,29
1657194727430,MATH 10B,B01,083739,Sinha; Shubham,10,0,30,20
1657194733457,MATH 18,A01,083743,Cinel; Cameron Alexander,6,0,30,24
1657194733457,MATH 18,A02,083744,Cinel; Cameron Alexander,15,0,30,15
1657194733457,MATH 18,A03,083745,Cinel; Cameron Alexander,8,0,30,22
1657194733457,MATH 18,B01,083748,Rideout; David Porter,4,0,37,33
1657194733457,MATH 18,B02,083749,Rideout; David Porter,4,0,36,32
1657194733457,MATH 18,B03,083750,Rideout; David Porter,2,0,37,35
1657194733457,MATH 18,B04,083751,Rideout; David Porter,5,0,36,31
1657194733457,MATH 18,B05,093473,Rideout; David Porter,5,0,36,31
1657194733457,MATH 18,B06,093474,Rideout; David Porter,5,0,36,31
1657194739484,MATH 20A,A01,083754,Zheng; Zequn,13,0,40,27
1657194745511,MATH 20B,A01,083756,Briones; Jor-el Thomas Caparas,1,0,36,35
1657194745511,MATH 20B,A02,083757,Briones; Jor-el Thomas Caparas,1,0,36,35
1657194745511,MATH 20B,A03,093475,Briones; Jor-el Thomas Caparas,1,0,36,35
1657194751539,MATH 20C,A01,083760,Briones; Jor-el Thomas Caparas,1,0,35,34
1657194751539,MATH 20C,A02,083761,Briones; Jor-el Thomas Caparas,8,0,35,27
1657194751539,MATH 20C,A03,093476,Briones; Jor-el Thomas Caparas,0,1,36,36
1657194751539,MATH 20C,B01,083762,Bach; Quang Tran,1,0,30,29
1657194757566,MATH 20D,A01,083765,Tran; Brian Kha,4,0,30,26
1657194757566,MATH 20D,A02,083766,Tran; Brian Kha,5,0,30,25
1657194757566,MATH 20D,A03,083767,Tran; Brian Kha,4,0,30,26
1657194763593,MATH 20E,A01,083771,Ganguly; Soumya,7,0,32,25
1657194763593,MATH 20E,A02,083772,Ganguly; Soumya,7,0,32,25
1657194763593,MATH 20E,B01,083773,Ciotti; Benjamin,19,0,35,16
1657194763593,MATH 20E,B02,083774,Ciotti; Benjamin,17,0,35,18
1657194769617,MATH 103A,A01,083777,Greenfeld; Be'Eri,2,0,36,34
1657194769617,MATH 103A,A02,083778,Greenfeld; Be'Eri,5,0,36,31
1657194769617,MATH 103A,A03,093561,Greenfeld; Be'Eri,4,0,36,32
1657194769617,MATH 103A,B01,083779,Greenfeld; Be'Eri,6,0,36,30
1657194769617,MATH 103A,B02,083780,Greenfeld; Be'Eri,3,0,36,33
1657194769617,MATH 103A,B03,093562,Greenfeld; Be'Eri,3,0,36,33
1657194775648,MATH 105,A01,085443,Carter; Anne Toulson,14,0,35,21
1657194775648,MATH 105,A02,093477,Carter; Anne Toulson,20,0,35,15
1657194781672,MATH 109,A01,083213,Ganzberger; Geoffrey Michael,2,0,34,32
1657194781672,MATH 109,A02,083214,Ganzberger; Geoffrey Michael,4,0,34,30
1657194781672,MATH 109,A03,093478,Ganzberger; Geoffrey Michael,1,0,34,33
1657194781672,MATH 109,B01,083215,Ganzberger; Geoffrey Michael,1,0,32,31
1657194781672,MATH 109,B02,083216,Ganzberger; Geoffrey Michael,1,0,32,31
1657194781672,MATH 109,B03,093479,Ganzberger; Geoffrey Michael,7,0,32,25
1657194787704,MATH 142A,A01,083219,Chow; Bennett,6,0,32,26
1657194787704,MATH 142A,A02,083220,Chow; Bennett,10,0,32,22
1657194787704,MATH 142A,A03,093480,Chow; Bennett,7,0,32,25
1657194787704,MATH 142A,B03,093481,Chow; Bennett,8,0,32,24
1657194787704,MATH 142A,B04,093558,Chow; Bennett,11,0,32,21
1657194787704,MATH 142A,B05,093559,Chow; Bennett,6,0,32,26
1657194793729,MATH 193A,A01,083224,Rotar; Vladimir,7,0,34,27
1657194793729,MATH 193A,A02,083225,Rotar; Vladimir,5,0,34,29
1657194793729,MATH 193A,A03,083781,Rotar; Vladimir,1,0,34,33
1657194793729,MATH 193A,A04,083782,Rotar; Vladimir,8,0,34,26
1657194793729,MATH 193A,A05,093482,Rotar; Vladimir,6,0,34,28
1657194799753,MATH 197,001,091859,McAuley; Julian John,9999,0,9999,0
1657194799753,MATH 197,002,095566,Kedlaya; Kiran S.,9997,0,9999,2
1657194799753,MATH 197,003,095567,Xiao; Ming,9999,0,9999,0
1657194799753,MATH 197,004,095571,Perols; Johan Lars,9998,0,9999,1
1657194806813,COGS 9,A01,083615,Shannon; Kyle Michael,7,0,75,68
1657194812837,COGS 11,A01,083617,Boyle; Mary E. T.,22,0,48,26
1657194818864,COGS 13,A01,083071,Bastos; Amalia Pinkusfeld,9,0,71,62
1657194824890,COGS 14A,A01,092681,Semenuks; Arturs,1,1,100,99
1657194830919,COGS 14B,A01,083073,Cheng; Tzu-Han,6,0,63,57
1657194836947,COGS 17,A01,092677,Semenuks; Arturs,4,0,81,77
1657194842977,COGS 100,A01,083619,Allen; Michael Gordon,15,0,70,55
1657194849005,COGS 101A,A01,083621,Davis; Joshua Daniel,9,0,68,59
1657194855030,COGS 101B,A01,091572,Allen; Michael Gordon,9,0,65,56
1657194861056,COGS 101C,A01,083625,Delgado; Tania,17,0,35,18
1657194867086,COGS 107A,A01,083627,Boyle; Mary E. T.,13,0,60,47
1657194873112,COGS 118A,A01,083075,Gupta; Anjum,16,0,76,60
1657194879142,CSE 3,A50,083646,Miranda; Gregory Joseph,24,0,50,26
1657194885168,CSE 8A,A50,083650,Miranda; Gregory Joseph,17,1,56,39
1657194891195,CSE 11,A01,083080,Cao; Yingjun,5,15,40,35
1657194897221,CSE 12,A01,083652,Krause-Levy; Sophia Louisa,24,1,120,96
1657194903249,CSE 15L,A01,083654,Morris; Justin Loren,9,0,50,41
1657194903249,CSE 15L,A02,083655,Morris; Justin Loren,9,0,50,41
1657194909278,CSE 20,A01,083657,Tran; Khoa Dang,38,0,80,42
1657194915313,CSE 21,A01,095574,Bach; Quang Tran,22,0,48,26
1657194921340,CSE 30,A01,083084,Eldon; John,4,0,80,76
1657194921340,CSE 30,B01,095061,Bhaskar; Nishant,7,0,50,43
1657194927369,CSE 100,A01,083659,Cao; Yingjun,4,4,70,66
1657194933393,CSE 134B,A01,083661,Powell; Thomas Allan,20,0,100,80
1657194939424,CSE 140,A01,083663,Gungor; Onat,13,0,85,72
1657194945449,CSE 140L,A01,083088,Eldon; John,17,0,100,83
1657194951476,CSE 175,A01,083665,Kumar; Rakesh,3,0,25,22
1657194957503,CSE 190,A00,092507,Dubnov; Shlomo,7,0,20,13
1657194963531,ECE 45,A01,083139,Congero; Spencer William,5,0,75,70
1657194969561,ECE 65,A50,083695,Saad; Andrew S,12,0,30,18
1657194969561,ECE 65,A51,095125,Saad; Andrew S,25,0,26,1
1657194975591,ECE 109,A01,091882,Touri; Behrouz,19,0,70,51
1657194981614,ECE 180,A00,083140,Abi Samra; Nicholas Camill,1,0,30,29
1657194981614,ECE 180,B00,083141,Abi Samra; Nicholas Camill,0,0,30,30
1657194987647,MATH 10A,A01,083735,Patchell; Gregory David,2,0,30,28
1657194987647,MATH 10A,A02,083736,Patchell; Gregory David,20,0,30,10
1657194987647,MATH 10A,A03,083737,Patchell; Gregory David,16,0,30,14
1657194993674,MATH 10B,A01,083207,Lim; Seonhee,7,0,34,27
1657194993674,MATH 10B,A02,083208,Lim; Seonhee,9,0,35,26
1657194993674,MATH 10B,A03,093472,Lim; Seonhee,5,0,34,29
1657194993674,MATH 10B,B01,083739,Sinha; Shubham,10,0,30,20
1657194999708,MATH 18,A01,083743,Cinel; Cameron Alexander,6,0,30,24
1657194999708,MATH 18,A02,083744,Cinel; Cameron Alexander,15,0,30,15
1657194999708,MATH 18,A03,083745,Cinel; Cameron Alexander,8,0,30,22
1657194999708,MATH 18,B01,083748,Rideout; David Porter,4,0,37,33
1657194999708,MATH 18,B02,083749,Rideout; David Porter,4,0,36,32
1657194999708,MATH 18,B03,083750,Rideout; David Porter,2,0,37,35
1657194999708,MATH 18,B04,083751,Rideout; David Porter,5,0,36,31
1657194999708,MATH 18,B05,093473,Rideout; David Porter,5,0,36,31
1657194999708,MATH 18,B06,093474,Rideout; David Porter,5,0,36,31
1657195005737,MATH 20A,A01,083754,Zheng; Zequn,13,0,40,27
1657195011765,MATH 20B,A01,083756,Briones; Jor-el Thomas Caparas,1,0,36,35
1657195011765,MATH 20B,A02,083757,Briones; Jor-el Thomas Caparas,1,0,36,35
1657195011765,MATH 20B,A03,093475,Briones; Jor-el Thomas Caparas,1,0,36,35
1657195017789,MATH 20C,A01,083760,Briones; Jor-el Thomas Caparas,1,0,35,34
1657195017789,MATH 20C,A02,083761,Briones; Jor-el Thomas Caparas,8,0,35,27
1657195017789,MATH 20C,A03,093476,Briones; Jor-el Thomas Caparas,0,1,36,36
1657195017789,MATH 20C,B01,083762,Bach; Quang Tran,1,0,30,29
1657195023821,MATH 20D,A01,083765,Tran; Brian Kha,4,0,30,26
1657195023821,MATH 20D,A02,083766,Tran; Brian Kha,5,0,30,25
1657195023821,MATH 20D,A03,083767,Tran; Brian Kha,4,0,30,26
1657195029849,MATH 20E,A01,083771,Ganguly; Soumya,7,0,32,25
1657195029849,MATH 20E,A02,083772,Ganguly; Soumya,7,0,32,25
1657195029849,MATH 20E,B01,083773,Ciotti; Benjamin,19,0,35,16
1657195029849,MATH 20E,B02,083774,Ciotti; Benjamin,17,0,35,18
1657195035876,MATH 103A,A01,083777,Greenfeld; Be'Eri,2,0,36,34
1657195035876,MATH 103A,A02,083778,Greenfeld; Be'Eri,5,0,36,31
1657195035876,MATH 103A,A03,093561,Greenfeld; Be'Eri,4,0,36,32
1657195035876,MATH 103A,B01,083779,Greenfeld; Be'Eri,6,0,36,30
1657195035876,MATH 103A,B02,083780,Greenfeld; Be'Eri,3,0,36,33
1657195035876,MATH 103A,B03,093562,Greenfeld; Be'Eri,3,0,36,33
1657195041903,MATH 105,A01,085443,Carter; Anne Toulson,14,0,35,21
1657195041903,MATH 105,A02,093477,Carter; Anne Toulson,20,0,35,15
1657195047935,MATH 109,A01,083213,Ganzberger; Geoffrey Michael,2,0,34,32
1657195047935,MATH 109,A02,083214,Ganzberger; Geoffrey Michael,4,0,34,30
1657195047935,MATH 109,A03,093478,Ganzberger; Geoffrey Michael,1,0,34,33
1657195047935,MATH 109,B01,083215,Ganzberger; Geoffrey Michael,1,0,32,31
1657195047935,MATH 109,B02,083216,Ganzberger; Geoffrey Michael,1,0,32,31
1657195047935,MATH 109,B03,093479,Ganzberger; Geoffrey Michael,7,0,32,25
1657195053961,MATH 142A,A01,083219,Chow; Bennett,6,0,32,26
1657195053961,MATH 142A,A02,083220,Chow; Bennett,10,0,32,22
1657195053961,MATH 142A,A03,093480,Chow; Bennett,7,0,32,25
1657195053961,MATH 142A,B03,093481,Chow; Bennett,8,0,32,24
1657195053961,MATH 142A,B04,093558,Chow; Bennett,11,0,32,21
1657195053961,MATH 142A,B05,093559,Chow; Bennett,6,0,32,26
1657195059990,MATH 193A,A01,083224,Rotar; Vladimir,7,0,34,27
1657195059990,MATH 193A,A02,083225,Rotar; Vladimir,5,0,34,29
1657195059990,MATH 193A,A03,083781,Rotar; Vladimir,1,0,34,33
1657195059990,MATH 193A,A04,083782,Rotar; Vladimir,8,0,34,26
1657195059990,MATH 193A,A05,093482,Rotar; Vladimir,6,0,34,28
1657195066016,MATH 197,001,091859,McAuley; Julian John,9999,0,9999,0
1657195066016,MATH 197,002,095566,Kedlaya; Kiran S.,9997,0,9999,2
1657195066016,MATH 197,003,095567,Xiao; Ming,9999,0,9999,0
1657195066016,MATH 197,004,095571,Perols; Johan Lars,9998,0,9999,1
1657195073077,COGS 9,A01,083615,Shannon; Kyle Michael,7,0,75,68
1657195079102,COGS 11,A01,083617,Boyle; Mary E. T.,22,0,48,26
1657195085131,COGS 13,A01,083071,Bastos; Amalia Pinkusfeld,9,0,71,62
1657195091169,COGS 14A,A01,092681,Semenuks; Arturs,1,1,100,99
1657195097195,COGS 14B,A01,083073,Cheng; Tzu-Han,6,0,63,57
1657195103224,COGS 17,A01,092677,Semenuks; Arturs,4,0,81,77
1657195109256,COGS 100,A01,083619,Allen; Michael Gordon,15,0,70,55
1657195115283,COGS 101A,A01,083621,Davis; Joshua Daniel,9,0,68,59
1657195121313,COGS 101B,A01,091572,Allen; Michael Gordon,9,0,65,56
1657195127338,COGS 101C,A01,083625,Delgado; Tania,17,0,35,18
1657195133365,COGS 107A,A01,083627,Boyle; Mary E. T.,13,0,60,47
1657195139394,COGS 118A,A01,083075,Gupta; Anjum,16,0,76,60
1657195145426,CSE 3,A50,083646,Miranda; Gregory Joseph,24,0,50,26
1657195151453,CSE 8A,A50,083650,Miranda; Gregory Joseph,17,1,56,39
1657195157480,CSE 11,A01,083080,Cao; Yingjun,5,15,40,35
1657195163504,CSE 12,A01,083652,Krause-Levy; Sophia Louisa,24,1,120,96
1657195169531,CSE 15L,A01,083654,Morris; Justin Loren,9,0,50,41
1657195169531,CSE 15L,A02,083655,Morris; Justin Loren,9,0,50,41
1657195175565,CSE 20,A01,083657,Tran; Khoa Dang,38,0,80,42
1657195181592,CSE 21,A01,095574,Bach; Quang Tran,22,0,48,26
1657195187619,CSE 30,A01,083084,Eldon; John,4,0,80,76
1657195187619,CSE 30,B01,095061,Bhaskar; Nishant,7,0,50,43
1657195193649,CSE 100,A01,083659,Cao; Yingjun,4,4,70,66
1657195199677,CSE 134B,A01,083661,Powell; Thomas Allan,20,0,100,80
1657195205703,CSE 140,A01,083663,Gungor; Onat,13,0,85,72
1657195211731,CSE 140L,A01,083088,Eldon; John,17,0,100,83
1657195217756,CSE 175,A01,083665,Kumar; Rakesh,3,0,25,22
1657195223784,CSE 190,A00,092507,Dubnov; Shlomo,7,0,20,13
1657195229819,ECE 45,A01,083139,Congero; Spencer William,5,0,75,70
1657195235842,ECE 65,A50,083695,Saad; Andrew S,12,0,30,18
1657195235842,ECE 65,A51,095125,Saad; Andrew S,25,0,26,1
1657195241872,ECE 109,A01,091882,Touri; Behrouz,19,0,70,51
1657195247901,ECE 180,A00,083140,Abi Samra; Nicholas Camill,1,0,30,29
1657195247901,ECE 180,B00,083141,Abi Samra; Nicholas Camill,0,0,30,30
1657195253934,MATH 10A,A01,083735,Patchell; Gregory David,2,0,30,28
1657195253934,MATH 10A,A02,083736,Patchell; Gregory David,20,0,30,10
1657195253934,MATH 10A,A03,083737,Patchell; Gregory David,16,0,30,14
1657195259961,MATH 10B,A01,083207,Lim; Seonhee,7,0,34,27
1657195259961,MATH 10B,A02,083208,Lim; Seonhee,9,0,35,26
1657195259961,MATH 10B,A03,093472,Lim; Seonhee,5,0,34,29
1657195259961,MATH 10B,B01,083739,Sinha; Shubham,10,0,30,20
1657195265987,MATH 18,A01,083743,Cinel; Cameron Alexander,6,0,30,24
1657195265987,MATH 18,A02,083744,Cinel; Cameron Alexander,15,0,30,15
1657195265987,MATH 18,A03,083745,Cinel; Cameron Alexander,8,0,30,22
1657195265987,MATH 18,B01,083748,Rideout; David Porter,4,0,37,33
1657195265987,MATH 18,B02,083749,Rideout; David Porter,4,0,36,32
1657195265987,MATH 18,B03,083750,Rideout; David Porter,2,0,37,35
1657195265987,MATH 18,B04,083751,Rideout; David Porter,5,0,36,31
1657195265987,MATH 18,B05,093473,Rideout; David Porter,5,0,36,31
1657195265987,MATH 18,B06,093474,Rideout; David Porter,5,0,36,31
1657195272011,MATH 20A,A01,083754,Zheng; Zequn,13,0,40,27
1657195278042,MATH 20B,A01,083756,Briones; Jor-el Thomas Caparas,1,0,36,35
1657195278042,MATH 20B,A02,083757,Briones; Jor-el Thomas Caparas,1,0,36,35
1657195278042,MATH 20B,A03,093475,Briones; Jor-el Thomas Caparas,1,0,36,35
1657195284074,MATH 20C,A01,083760,Briones; Jor-el Thomas Caparas,1,0,35,34
1657195284074,MATH 20C,A02,083761,Briones; Jor-el Thomas Caparas,8,0,35,27
1657195284074,MATH 20C,A03,093476,Briones; Jor-el Thomas Caparas,0,1,36,36
1657195284074,MATH 20C,B01,083762,Bach; Quang Tran,1,0,30,29
1657195290101,MATH 20D,A01,083765,Tran; Brian Kha,4,0,30,26
1657195290101,MATH 20D,A02,083766,Tran; Brian Kha,5,0,30,25
1657195290101,MATH 20D,A03,083767,Tran; Brian Kha,4,0,30,26
1657195296133,MATH 20E,A01,083771,Ganguly; Soumya,7,0,32,25
1657195296133,MATH 20E,A02,083772,Ganguly; Soumya,7,0,32,25
1657195296133,MATH 20E,B01,083773,Ciotti; Benjamin,19,0,35,16
1657195296133,MATH 20E,B02,083774,Ciotti; Benjamin,17,0,35,18
1657195302165,MATH 103A,A01,083777,Greenfeld; Be'Eri,2,0,36,34
1657195302165,MATH 103A,A02,083778,Greenfeld; Be'Eri,5,0,36,31
1657195302165,MATH 103A,A03,093561,Greenfeld; Be'Eri,4,0,36,32
1657195302165,MATH 103A,B01,083779,Greenfeld; Be'Eri,6,0,36,30
1657195302165,MATH 103A,B02,083780,Greenfeld; Be'Eri,3,0,36,33
1657195302165,MATH 103A,B03,093562,Greenfeld; Be'Eri,3,0,36,33
1657195308201,MATH 105,A01,085443,Carter; Anne Toulson,14,0,35,21
1657195308201,MATH 105,A02,093477,Carter; Anne Toulson,20,0,35,15
1657195314303,MATH 109,A01,083213,Ganzberger; Geoffrey Michael,2,0,34,32
1657195314303,MATH 109,A02,083214,Ganzberger; Geoffrey Michael,4,0,34,30
1657195314303,MATH 109,A03,093478,Ganzberger; Geoffrey Michael,1,0,34,33
1657195314303,MATH 109,B01,083215,Ganzberger; Geoffrey Michael,1,0,32,31
1657195314303,MATH 109,B02,083216,Ganzberger; Geoffrey Michael,1,0,32,31
1657195314303,MATH 109,B03,093479,Ganzberger; Geoffrey Michael,7,0,32,25
1657195320335,MATH 142A,A01,083219,Chow; Bennett,6,0,32,26
1657195320335,MATH 142A,A02,083220,Chow; Bennett,10,0,32,22
1657195320335,MATH 142A,A03,093480,Chow; Bennett,7,0,32,25
1657195320335,MATH 142A,B03,093481,Chow; Bennett,8,0,32,24
1657195320335,MATH 142A,B04,093558,Chow; Bennett,11,0,32,21
1657195320335,MATH 142A,B05,093559,Chow; Bennett,6,0,32,26
1657195326375,MATH 193A,A01,083224,Rotar; Vladimir,7,0,34,27
1657195326375,MATH 193A,A02,083225,Rotar; Vladimir,5,0,34,29
1657195326375,MATH 193A,A03,083781,Rotar; Vladimir,1,0,34,33
1657195326375,MATH 193A,A04,083782,Rotar; Vladimir,8,0,34,26
1657195326375,MATH 193A,A05,093482,Rotar; Vladimir,6,0,34,28
1657195332410,MATH 197,001,091859,McAuley; Julian John,9999,0,9999,0
1657195332410,MATH 197,002,095566,Kedlaya; Kiran S.,9997,0,9999,2
1657195332410,MATH 197,003,095567,Xiao; Ming,9999,0,9999,0
1657195332410,MATH 197,004,095571,Perols; Johan Lars,9998,0,9999,1
1657195339473,COGS 9,A01,083615,Shannon; Kyle Michael,7,0,75,68
1657195345506,COGS 11,A01,083617,Boyle; Mary E. T.,22,0,48,26
1657195351533,COGS 13,A01,083071,Bastos; Amalia Pinkusfeld,9,0,71,62
1657195357559,COGS 14A,A01,092681,Semenuks; Arturs,1,1,100,99
1657195363586,COGS 14B,A01,083073,Cheng; Tzu-Han,6,0,63,57
1657195369612,COGS 17,A01,092677,Semenuks; Arturs,4,0,81,77
1657195375636,COGS 100,A01,083619,Allen; Michael Gordon,15,0,70,55
1657195381663,COGS 101A,A01,083621,Davis; Joshua Daniel,9,0,68,59
1657195387689,COGS 101B,A01,091572,Allen; Michael Gordon,9,0,65,56
1657195393716,COGS 101C,A01,083625,Delgado; Tania,17,0,35,18
1657195399741,COGS 107A,A01,083627,Boyle; Mary E. T.,13,0,60,47
1657195405775,COGS 118A,A01,083075,Gupta; Anjum,16,0,76,60
1657195411811,CSE 3,A50,083646,Miranda; Gregory Joseph,24,0,50,26
1657195417838,CSE 8A,A50,083650,Miranda; Gregory Joseph,17,1,56,39
1657195423866,CSE 11,A01,083080,Cao; Yingjun,5,15,40,35
1657195429895,CSE 12,A01,083652,Krause-Levy; Sophia Louisa,24,1,120,96
1657195435920,CSE 15L,A01,083654,Morris; Justin Loren,9,0,50,41
1657195435920,CSE 15L,A02,083655,Morris; Justin Loren,9,0,50,41
1657195441952,CSE 20,A01,083657,Tran; Khoa Dang,38,0,80,42
1657195447981,CSE 21,A01,095574,Bach; Quang Tran,22,0,48,26
1657195454015,CSE 30,A01,083084,Eldon; John,4,0,80,76
1657195454015,CSE 30,B01,095061,Bhaskar; Nishant,7,0,50,43
1657195460042,CSE 100,A01,083659,Cao; Yingjun,4,4,70,66
1657195466069,CSE 134B,A01,083661,Powell; Thomas Allan,20,0,100,80
1657195472094,CSE 140,A01,083663,Gungor; Onat,13,0,85,72
1657195478124,CSE 140L,A01,083088,Eldon; John,17,0,100,83
1657195484153,CSE 175,A01,083665,Kumar; Rakesh,3,0,25,22
1657195490180,CSE 190,A00,092507,Dubnov; Shlomo,7,0,20,13
1657195496209,ECE 45,A01,083139,Congero; Spencer William,5,0,75,70
1657195502239,ECE 65,A50,083695,Saad; Andrew S,12,0,30,18
1657195502239,ECE 65,A51,095125,Saad; Andrew S,25,0,26,1
1657195508266,ECE 109,A01,091882,Touri; Behrouz,19,0,70,51
1657195514294,ECE 180,A00,083140,Abi Samra; Nicholas Camill,1,0,30,29
1657195514294,ECE 180,B00,083141,Abi Samra; Nicholas Camill,0,0,30,30
1657195520319,MATH 10A,A01,083735,Patchell; Gregory David,2,0,30,28
1657195520319,MATH 10A,A02,083736,Patchell; Gregory David,20,0,30,10
1657195520319,MATH 10A,A03,083737,Patchell; Gregory David,16,0,30,14
1657195526346,MATH 10B,A01,083207,Lim; Seonhee,7,0,34,27
1657195526346,MATH 10B,A02,083208,Lim; Seonhee,9,0,35,26
1657195526346,MATH 10B,A03,093472,Lim; Seonhee,5,0,34,29
1657195526346,MATH 10B,B01,083739,Sinha; Shubham,10,0,30,20
1657195532373,MATH 18,A01,083743,Cinel; Cameron Alexander,6,0,30,24
1657195532373,MATH 18,A02,083744,Cinel; Cameron Alexander,15,0,30,15
1657195532373,MATH 18,A03,083745,Cinel; Cameron Alexander,8,0,30,22
1657195532373,MATH 18,B01,083748,Rideout; David Porter,4,0,37,33
1657195532373,MATH 18,B02,083749,Rideout; David Porter,4,0,36,32
1657195532373,MATH 18,B03,083750,Rideout; David Porter,2,0,37,35
1657195532373,MATH 18,B04,083751,Rideout; David Porter,5,0,36,31
1657195532373,MATH 18,B05,093473,Rideout; David Porter,5,0,36,31
1657195532373,MATH 18,B06,093474,Rideout; David Porter,5,0,36,31
1657195538403,MATH 20A,A01,083754,Zheng; Zequn,13,0,40,27
1657195544428,MATH 20B,A01,083756,Briones; Jor-el Thomas Caparas,1,0,36,35
1657195544428,MATH 20B,A02,083757,Briones; Jor-el Thomas Caparas,1,0,36,35
1657195544428,MATH 20B,A03,093475,Briones; Jor-el Thomas Caparas,1,0,36,35
1657195550454,MATH 20C,A01,083760,Briones; Jor-el Thomas Caparas,1,0,35,34
1657195550454,MATH 20C,A02,083761,Briones; Jor-el Thomas Caparas,8,0,35,27
1657195550454,MATH 20C,A03,093476,Briones; Jor-el Thomas Caparas,0,1,36,36
1657195550454,MATH 20C,B01,083762,Bach; Quang Tran,1,0,30,29
1657195556481,MATH 20D,A01,083765,Tran; Brian Kha,4,0,30,26
1657195556481,MATH 20D,A02,083766,Tran; Brian Kha,5,0,30,25
1657195556481,MATH 20D,A03,083767,Tran; Brian Kha,4,0,30,26
1657195562522,MATH 20E,A01,083771,Ganguly; Soumya,7,0,32,25
1657195562522,MATH 20E,A02,083772,Ganguly; Soumya,7,0,32,25
1657195562522,MATH 20E,B01,083773,Ciotti; Benjamin,19,0,35,16
1657195562522,MATH 20E,B02,083774,Ciotti; Benjamin,17,0,35,18
1657195568555,MATH 103A,A01,083777,Greenfeld; Be'Eri,2,0,36,34
1657195568555,MATH 103A,A02,083778,Greenfeld; Be'Eri,5,0,36,31
1657195568555,MATH 103A,A03,093561,Greenfeld; Be'Eri,4,0,36,32
1657195568555,MATH 103A,B01,083779,Greenfeld; Be'Eri,6,0,36,30
1657195568555,MATH 103A,B02,083780,Greenfeld; Be'Eri,3,0,36,33
1657195568555,MATH 103A,B03,093562,Greenfeld; Be'Eri,3,0,36,33
1657195574582,MATH 105,A01,085443,Carter; Anne Toulson,14,0,35,21
1657195574582,MATH 105,A02,093477,Carter; Anne Toulson,20,0,35,15
1657195580608,MATH 109,A01,083213,Ganzberger; Geoffrey Michael,2,0,34,32
1657195580608,MATH 109,A02,083214,Ganzberger; Geoffrey Michael,4,0,34,30
1657195580608,MATH 109,A03,093478,Ganzberger; Geoffrey Michael,1,0,34,33
1657195580608,MATH 109,B01,083215,Ganzberger; Geoffrey Michael,1,0,32,31
1657195580608,MATH 109,B02,083216,Ganzberger; Geoffrey Michael,1,0,32,31
1657195580608,MATH 109,B03,093479,Ganzberger; Geoffrey Michael,7,0,32,25
1657195586635,MATH 142A,A01,083219,Chow; Bennett,6,0,32,26
1657195586635,MATH 142A,A02,083220,Chow; Bennett,10,0,32,22
1657195586635,MATH 142A,A03,093480,Chow; Bennett,7,0,32,25
1657195586635,MATH 142A,B03,093481,Chow; Bennett,8,0,32,24
1657195586635,MATH 142A,B04,093558,Chow; Bennett,11,0,32,21
1657195586635,MATH 142A,B05,093559,Chow; Bennett,6,0,32,26
1657195592672,MATH 193A,A01,083224,Rotar; Vladimir,7,0,34,27
1657195592672,MATH 193A,A02,083225,Rotar; Vladimir,5,0,34,29
1657195592672,MATH 193A,A03,083781,Rotar; Vladimir,1,0,34,33
1657195592672,MATH 193A,A04,083782,Rotar; Vladimir,8,0,34,26
1657195592672,MATH 193A,A05,093482,Rotar; Vladimir,6,0,34,28
1657195598697,MATH 197,001,091859,McAuley; Julian John,9999,0,9999,0
1657195598697,MATH 197,002,095566,Kedlaya; Kiran S.,9997,0,9999,2
1657195598697,MATH 197,003,095567,Xiao; Ming,9999,0,9999,0
1657195598697,MATH 197,004,095571,Perols; Johan Lars,9998,0,9999,1
1657195605761,COGS 9,A01,083615,Shannon; Kyle Michael,7,0,75,68
1657195611800,COGS 11,A01,083617,Boyle; Mary E. T.,22,0,48,26
1657195617826,COGS 13,A01,083071,Bastos; Amalia Pinkusfeld,9,0,71,62
1657195623856,COGS 14A,A01,092681,Semenuks; Arturs,1,1,100,99
1657195629884,COGS 14B,A01,083073,Cheng; Tzu-Han,6,0,63,57
1657195635913,COGS 17,A01,092677,Semenuks; Arturs,4,0,81,77
1657195641937,COGS 100,A01,083619,Allen; Michael Gordon,15,0,70,55
1657195647971,COGS 101A,A01,083621,Davis; Joshua Daniel,9,0,68,59
1657195654003,COGS 101B,A01,091572,Allen; Michael Gordon,9,0,65,56
1657195660029,COGS 101C,A01,083625,Delgado; Tania,17,0,35,18
1657195666059,COGS 107A,A01,083627,Boyle; Mary E. T.,13,0,60,47
1657195672085,COGS 118A,A01,083075,Gupta; Anjum,16,0,76,60
1657195678110,CSE 3,A50,083646,Miranda; Gregory Joseph,24,0,50,26
1657195684139,CSE 8A,A50,083650,Miranda; Gregory Joseph,17,1,56,39
1657195690164,CSE 11,A01,083080,Cao; Yingjun,5,15,40,35
1657195696188,CSE 12,A01,083652,Krause-Levy; Sophia Louisa,24,1,120,96
1657195702224,CSE 15L,A01,083654,Morris; Justin Loren,9,0,50,41
1657195702224,CSE 15L,A02,083655,Morris; Justin Loren,9,0,50,41
1657195708258,CSE 20,A01,083657,Tran; Khoa Dang,38,0,80,42
1657195714285,CSE 21,A01,095574,Bach; Quang Tran,22,0,48,26
1657195720316,CSE 30,A01,083084,Eldon; John,4,0,80,76
1657195720316,CSE 30,B01,095061,Bhaskar; Nishant,7,0,50,43
1657195726346,CSE 100,A01,083659,Cao; Yingjun,4,4,70,66
1657195732375,CSE 134B,A01,083661,Powell; Thomas Allan,20,0,100,80
1657195738403,CSE 140,A01,083663,Gungor; Onat,13,0,85,72
1657195744439,CSE 140L,A01,083088,Eldon; John,17,0,100,83
1657195750470,CSE 175,A01,083665,Kumar; Rakesh,3,0,25,22
1657195756498,CSE 190,A00,092507,Dubnov; Shlomo,7,0,20,13
1657195762528,ECE 45,A01,083139,Congero; Spencer William,5,0,75,70
1657195768563,ECE 65,A50,083695,Saad; Andrew S,12,0,30,18
1657195768563,ECE 65,A51,095125,Saad; Andrew S,25,0,26,1
1657195774592,ECE 109,A01,091882,Touri; Behrouz,19,0,70,51
1657195780618,ECE 180,A00,083140,Abi Samra; Nicholas Camill,1,0,30,29
1657195780618,ECE 180,B00,083141,Abi Samra; Nicholas Camill,0,0,30,30
1657195786650,MATH 10A,A01,083735,Patchell; Gregory David,2,0,30,28
1657195786650,MATH 10A,A02,083736,Patchell; Gregory David,20,0,30,10
1657195786650,MATH 10A,A03,083737,Patchell; Gregory David,16,0,30,14
1657195792676,MATH 10B,A01,083207,Lim; Seonhee,7,0,34,27
1657195792676,MATH 10B,A02,083208,Lim; Seonhee,9,0,35,26
1657195792676,MATH 10B,A03,093472,Lim; Seonhee,5,0,34,29
1657195792676,MATH 10B,B01,083739,Sinha; Shubham,10,0,30,20
1657195798706,MATH 18,A01,083743,Cinel; Cameron Alexander,6,0,30,24
1657195798706,MATH 18,A02,083744,Cinel; Cameron Alexander,15,0,30,15
1657195798706,MATH 18,A03,083745,Cinel; Cameron Alexander,8,0,30,22
1657195798706,MATH 18,B01,083748,Rideout; David Porter,4,0,37,33
1657195798706,MATH 18,B02,083749,Rideout; David Porter,4,0,36,32
1657195798706,MATH 18,B03,083750,Rideout; David Porter,2,0,37,35
1657195798706,MATH 18,B04,083751,Rideout; David Porter,5,0,36,31
1657195798706,MATH 18,B05,093473,Rideout; David Porter,5,0,36,31
1657195798706,MATH 18,B06,093474,Rideout; David Porter,5,0,36,31
1657195804737,MATH 20A,A01,083754,Zheng; Zequn,13,0,40,27
1657195810761,MATH 20B,A01,083756,Briones; Jor-el Thomas Caparas,1,0,36,35
1657195810761,MATH 20B,A02,083757,Briones; Jor-el Thomas Caparas,1,0,36,35
1657195810761,MATH 20B,A03,093475,Briones; Jor-el Thomas Caparas,1,0,36,35
1657195816793,MATH 20C,A01,083760,Briones; Jor-el Thomas Caparas,1,0,35,34
1657195816793,MATH 20C,A02,083761,Briones; Jor-el Thomas Caparas,8,0,35,27
1657195816793,MATH 20C,A03,093476,Briones; Jor-el Thomas Caparas,0,1,36,36
1657195816793,MATH 20C,B01,083762,Bach; Quang Tran,1,0,30,29
1657195822821,MATH 20D,A01,083765,Tran; Brian Kha,4,0,30,26
1657195822821,MATH 20D,A02,083766,Tran; Brian Kha,5,0,30,25
1657195822821,MATH 20D,A03,083767,Tran; Brian Kha,4,0,30,26
1657195828853,MATH 20E,A01,083771,Ganguly; Soumya,7,0,32,25
1657195828853,MATH 20E,A02,083772,Ganguly; Soumya,7,0,32,25
1657195828853,MATH 20E,B01,083773,Ciotti; Benjamin,19,0,35,16
1657195828853,MATH 20E,B02,083774,Ciotti; Benjamin,17,0,35,18
1657195834881,MATH 103A,A01,083777,Greenfeld; Be'Eri,2,0,36,34
1657195834881,MATH 103A,A02,083778,Greenfeld; Be'Eri,5,0,36,31
1657195834881,MATH 103A,A03,093561,Greenfeld; Be'Eri,4,0,36,32
1657195834881,MATH 103A,B01,083779,Greenfeld; Be'Eri,6,0,36,30
1657195834881,MATH 103A,B02,083780,Greenfeld; Be'Eri,3,0,36,33
1657195834881,MATH 103A,B03,093562,Greenfeld; Be'Eri,3,0,36,33
1657195840910,MATH 105,A01,085443,Carter; Anne Toulson,14,0,35,21
1657195840910,MATH 105,A02,093477,Carter; Anne Toulson,20,0,35,15
1657195846942,MATH 109,A01,083213,Ganzberger; Geoffrey Michael,2,0,34,32
1657195846942,MATH 109,A02,083214,Ganzberger; Geoffrey Michael,4,0,34,30
1657195846942,MATH 109,A03,093478,Ganzberger; Geoffrey Michael,1,0,34,33
1657195846942,MATH 109,B01,083215,Ganzberger; Geoffrey Michael,1,0,32,31
1657195846942,MATH 109,B02,083216,Ganzberger; Geoffrey Michael,1,0,32,31
1657195846942,MATH 109,B03,093479,Ganzberger; Geoffrey Michael,7,0,32,25
1657195852969,MATH 142A,A01,083219,Chow; Bennett,6,0,32,26
1657195852969,MATH 142A,A02,083220,Chow; Bennett,10,0,32,22
1657195852969,MATH 142A,A03,093480,Chow; Bennett,7,0,32,25
1657195852969,MATH 142A,B03,093481,Chow; Bennett,8,0,32,24
1657195852969,MATH 142A,B04,093558,Chow; Bennett,11,0,32,21
1657195852969,MATH 142A,B05,093559,Chow; Bennett,6,0,32,26
1657195858995,MATH 193A,A01,083224,Rotar; Vladimir,7,0,34,27
1657195858995,MATH 193A,A02,083225,Rotar; Vladimir,5,0,34,29
1657195858995,MATH 193A,A03,083781,Rotar; Vladimir,1,0,34,33
1657195858995,MATH 193A,A04,083782,Rotar; Vladimir,8,0,34,26
1657195858995,MATH 193A,A05,093482,Rotar; Vladimir,6,0,34,28
1657195865021,MATH 197,001,091859,McAuley; Julian John,9999,0,9999,0
1657195865021,MATH 197,002,095566,Kedlaya; Kiran S.,9997,0,9999,2
1657195865021,MATH 197,003,095567,Xiao; Ming,9999,0,9999,0
1657195865021,MATH 197,004,095571,Perols; Johan Lars,9998,0,9999,1
1657195872092,COGS 9,A01,083615,Shannon; Kyle Michael,7,0,75,68
1657195878118,COGS 11,A01,083617,Boyle; Mary E. T.,22,0,48,26
1657195884148,COGS 13,A01,083071,Bastos; Amalia Pinkusfeld,9,0,71,62
1657195890177,COGS 14A,A01,092681,Semenuks; Arturs,1,1,100,99
1657195896206,COGS 14B,A01,083073,Cheng; Tzu-Han,6,0,63,57
1657195902234,COGS 17,A01,092677,Semenuks; Arturs,4,0,81,77
1657195908334,COGS 100,A01,083619,Allen; Michael Gordon,15,0,70,55
1657195914367,COGS 101A,A01,083621,Davis; Joshua Daniel,9,0,68,59
1657195920391,COGS 101B,A01,091572,Allen; Michael Gordon,9,0,65,56
1657195926419,COGS 101C,A01,083625,Delgado; Tania,17,0,35,18
1657195932450,COGS 107A,A01,083627,Boyle; Mary E. T.,13,0,60,47
1657195938477,COGS 118A,A01,083075,Gupta; Anjum,16,0,76,60
1657195944504,CSE 3,A50,083646,Miranda; Gregory Joseph,24,0,50,26
1657195950531,CSE 8A,A50,083650,Miranda; Gregory Joseph,17,1,56,39
1657195956562,CSE 11,A01,083080,Cao; Yingjun,5,15,40,35
1657195962588,CSE 12,A01,083652,Krause-Levy; Sophia Louisa,24,1,120,96
1657195968614,CSE 15L,A01,083654,Morris; Justin Loren,9,0,50,41
1657195968614,CSE 15L,A02,083655,Morris; Justin Loren,9,0,50,41
1657195974643,CSE 20,A01,083657,Tran; Khoa Dang,38,0,80,42
1657195980667,CSE 21,A01,095574,Bach; Quang Tran,22,0,48,26
1657195986695,CSE 30,A01,083084,Eldon; John,4,0,80,76
1657195986695,CSE 30,B01,095061,Bhaskar; Nishant,7,0,50,43
1657195992718,CSE 100,A01,083659,Cao; Yingjun,4,4,70,66
1657195998749,CSE 134B,A01,083661,Powell; Thomas Allan,20,0,100,80
1657196004772,CSE 140,A01,083663,Gungor; Onat,13,0,85,72
1657196010801,CSE 140L,A01,083088,Eldon; John,17,0,100,83
1657196016825,CSE 175,A01,083665,Kumar; Rakesh,3,0,25,22
1657196022853,CSE 190,A00,092507,Dubnov; Shlomo,7,0,20,13
1657196028876,ECE 45,A01,083139,Congero; Spencer William,5,0,75,70
1657196034902,ECE 65,A50,083695,Saad; Andrew S,12,0,30,18
1657196034902,ECE 65,A51,095125,Saad; Andrew S,25,0,26,1
1657196040934,ECE 109,A01,091882,Touri; Behrouz,19,0,70,51
1657196046962,ECE 180,A00,083140,Abi Samra; Nicholas Camill,1,0,30,29
1657196046962,ECE 180,B00,083141,Abi Samra; Nicholas Camill,0,0,30,30
1657196052989,MATH 10A,A01,083735,Patchell; Gregory David,2,0,30,28
1657196052989,MATH 10A,A02,083736,Patchell; Gregory David,20,0,30,10
1657196052989,MATH 10A,A03,083737,Patchell; Gregory David,16,0,30,14
1657196059029,MATH 10B,A01,083207,Lim; Seonhee,7,0,34,27
1657196059029,MATH 10B,A02,083208,Lim; Seonhee,9,0,35,26
1657196059029,MATH 10B,A03,093472,Lim; Seonhee,5,0,34,29
1657196059029,MATH 10B,B01,083739,Sinha; Shubham,10,0,30,20
1657196065067,MATH 18,A01,083743,Cinel; Cameron Alexander,6,0,30,24
1657196065067,MATH 18,A02,083744,Cinel; Cameron Alexander,15,0,30,15
1657196065067,MATH 18,A03,083745,Cinel; Cameron Alexander,8,0,30,22
1657196065067,MATH 18,B01,083748,Rideout; David Porter,4,0,37,33
1657196065067,MATH 18,B02,083749,Rideout; David Porter,4,0,36,32
1657196065067,MATH 18,B03,083750,Rideout; David Porter,2,0,37,35
1657196065067,MATH 18,B04,083751,Rideout; David Porter,5,0,36,31
1657196065067,MATH 18,B05,093473,Rideout; David Porter,5,0,36,31
1657196065067,MATH 18,B06,093474,Rideout; David Porter,5,0,36,31
1657196071096,MATH 20A,A01,083754,Zheng; Zequn,13,0,40,27
1657196077121,MATH 20B,A01,083756,Briones; Jor-el Thomas Caparas,1,0,36,35
1657196077121,MATH 20B,A02,083757,Briones; Jor-el Thomas Caparas,1,0,36,35
1657196077121,MATH 20B,A03,093475,Briones; Jor-el Thomas Caparas,1,0,36,35
1657196083148,MATH 20C,A01,083760,Briones; Jor-el Thomas Caparas,1,0,35,34
1657196083148,MATH 20C,A02,083761,Briones; Jor-el Thomas Caparas,8,0,35,27
1657196083148,MATH 20C,A03,093476,Briones; Jor-el Thomas Caparas,0,1,36,36
1657196083148,MATH 20C,B01,083762,Bach; Quang Tran,1,0,30,29
1657196089175,MATH 20D,A01,083765,Tran; Brian Kha,4,0,30,26
1657196089175,MATH 20D,A02,083766,Tran; Brian Kha,5,0,30,25
1657196089175,MATH 20D,A03,083767,Tran; Brian Kha,4,0,30,26
1657196095209,MATH 20E,A01,083771,Ganguly; Soumya,7,0,32,25
1657196095209,MATH 20E,A02,083772,Ganguly; Soumya,7,0,32,25
1657196095209,MATH 20E,B01,083773,Ciotti; Benjamin,19,0,35,16
1657196095209,MATH 20E,B02,083774,Ciotti; Benjamin,17,0,35,18
1657196101235,MATH 103A,A01,083777,Greenfeld; Be'Eri,2,0,36,34
1657196101235,MATH 103A,A02,083778,Greenfeld; Be'Eri,5,0,36,31
1657196101235,MATH 103A,A03,093561,Greenfeld; Be'Eri,4,0,36,32
1657196101235,MATH 103A,B01,083779,Greenfeld; Be'Eri,6,0,36,30
1657196101235,MATH 103A,B02,083780,Greenfeld; Be'Eri,3,0,36,33
1657196101235,MATH 103A,B03,093562,Greenfeld; Be'Eri,3,0,36,33
1657196107260,MATH 105,A01,085443,Carter; Anne Toulson,14,0,35,21
1657196107260,MATH 105,A02,093477,Carter; Anne Toulson,20,0,35,15
1657196113287,MATH 109,A01,083213,Ganzberger; Geoffrey Michael,2,0,34,32
1657196113287,MATH 109,A02,083214,Ganzberger; Geoffrey Michael,4,0,34,30
1657196113287,MATH 109,A03,093478,Ganzberger; Geoffrey Michael,1,0,34,33
1657196113287,MATH 109,B01,083215,Ganzberger; Geoffrey Michael,1,0,32,31
1657196113287,MATH 109,B02,083216,Ganzberger; Geoffrey Michael,1,0,32,31
1657196113287,MATH 109,B03,093479,Ganzberger; Geoffrey Michael,7,0,32,25
1657196119314,MATH 142A,A01,083219,Chow; Bennett,6,0,32,26
1657196119314,MATH 142A,A02,083220,Chow; Bennett,10,0,32,22
1657196119314,MATH 142A,A03,093480,Chow; Bennett,7,0,32,25
1657196119314,MATH 142A,B03,093481,Chow; Bennett,8,0,32,24
1657196119314,MATH 142A,B04,093558,Chow; Bennett,11,0,32,21
1657196119314,MATH 142A,B05,093559,Chow; Bennett,6,0,32,26
1657196125347,MATH 193A,A01,083224,Rotar; Vladimir,7,0,34,27
1657196125347,MATH 193A,A02,083225,Rotar; Vladimir,5,0,34,29
1657196125347,MATH 193A,A03,083781,Rotar; Vladimir,1,0,34,33
1657196125347,MATH 193A,A04,083782,Rotar; Vladimir,8,0,34,26
1657196125347,MATH 193A,A05,093482,Rotar; Vladimir,6,0,34,28
1657196131376,MATH 197,001,091859,McAuley; Julian John,9999,0,9999,0
1657196131376,MATH 197,002,095566,Kedlaya; Kiran S.,9997,0,9999,2
1657196131376,MATH 197,003,095567,Xiao; Ming,9999,0,9999,0
1657196131376,MATH 197,004,095571,Perols; Johan Lars,9998,0,9999,1
1657196138452,COGS 9,A01,083615,Shannon; Kyle Michael,7,0,75,68
1657196144481,COGS 11,A01,083617,Boyle; Mary E. T.,22,0,48,26
1657196150510,COGS 13,A01,083071,Bastos; Amalia Pinkusfeld,9,0,71,62
1657196156536,COGS 14A,A01,092681,Semenuks; Arturs,1,1,100,99
1657196162566,COGS 14B,A01,083073,Cheng; Tzu-Han,6,0,63,57
1657196168596,COGS 17,A01,092677,Semenuks; Arturs,4,0,81,77
1657196174626,COGS 100,A01,083619,Allen; Michael Gordon,15,0,70,55
1657196180655,COGS 101A,A01,083621,Davis; Joshua Daniel,9,0,68,59
1657196186692,COGS 101B,A01,091572,Allen; Michael Gordon,9,0,65,56
1657196192718,COGS 101C,A01,083625,Delgado; Tania,17,0,35,18
1657196198746,COGS 107A,A01,083627,Boyle; Mary E. T.,13,0,60,47
1657196204770,COGS 118A,A01,083075,Gupta; Anjum,16,0,76,60
1657196210795,CSE 3,A50,083646,Miranda; Gregory Joseph,24,0,50,26
1657196216832,CSE 8A,A50,083650,Miranda; Gregory Joseph,17,1,56,39
1657196222857,CSE 11,A01,083080,Cao; Yingjun,5,15,40,35
1657196228887,CSE 12,A01,083652,Krause-Levy; Sophia Louisa,24,1,120,96
1657196234919,CSE 15L,A01,083654,Morris; Justin Loren,9,0,50,41
1657196234919,CSE 15L,A02,083655,Morris; Justin Loren,9,0,50,41
1657196240944,CSE 20,A01,083657,Tran; Khoa Dang,38,0,80,42
1657196246969,CSE 21,A01,095574,Bach; Quang Tran,22,0,48,26
1657196252993,CSE 30,A01,083084,Eldon; John,4,0,80,76
1657196252993,CSE 30,B01,095061,Bhaskar; Nishant,7,0,50,43
1657196259018,CSE 100,A01,083659,Cao; Yingjun,4,4,70,66
1657196265043,CSE 134B,A01,083661,Powell; Thomas Allan,20,0,100,80
1657196271072,CSE 140,A01,083663,Gungor; Onat,13,0,85,72
1657196277097,CSE 140L,A01,083088,Eldon; John,17,0,100,83
1657196283122,CSE 175,A01,083665,Kumar; Rakesh,3,0,25,22
1657196289146,CSE 190,A00,092507,Dubnov; Shlomo,7,0,20,13
1657196295173,ECE 45,A01,083139,Congero; Spencer William,5,0,75,70
1657196301196,ECE 65,A50,083695,Saad; Andrew S,12,0,30,18
1657196301196,ECE 65,A51,095125,Saad; Andrew S,25,0,26,1
1657196307223,ECE 109,A01,091882,Touri; Behrouz,19,0,70,51
1657196313253,ECE 180,A00,083140,Abi Samra; Nicholas Camill,1,0,30,29
1657196313253,ECE 180,B00,083141,Abi Samra; Nicholas Camill,0,0,30,30
1657196319287,MATH 10A,A01,083735,Patchell; Gregory David,2,0,30,28
1657196319287,MATH 10A,A02,083736,Patchell; Gregory David,20,0,30,10
1657196319287,MATH 10A,A03,083737,Patchell; Gregory David,16,0,30,14
1657196325312,MATH 10B,A01,083207,Lim; Seonhee,7,0,34,27
1657196325312,MATH 10B,A02,083208,Lim; Seonhee,9,0,35,26
1657196325312,MATH 10B,A03,093472,Lim; Seonhee,5,0,34,29
1657196325312,MATH 10B,B01,083739,Sinha; Shubham,10,0,30,20
1657196331345,MATH 18,A01,083743,Cinel; Cameron Alexander,6,0,30,24
1657196331345,MATH 18,A02,083744,Cinel; Cameron Alexander,15,0,30,15
1657196331345,MATH 18,A03,083745,Cinel; Cameron Alexander,8,0,30,22
1657196331345,MATH 18,B01,083748,Rideout; David Porter,4,0,37,33
1657196331345,MATH 18,B02,083749,Rideout; David Porter,4,0,36,32
1657196331345,MATH 18,B03,083750,Rideout; David Porter,2,0,37,35
1657196331345,MATH 18,B04,083751,Rideout; David Porter,5,0,36,31
1657196331345,MATH 18,B05,093473,Rideout; David Porter,5,0,36,31
1657196331345,MATH 18,B06,093474,Rideout; David Porter,5,0,36,31
1657196337370,MATH 20A,A01,083754,Zheng; Zequn,13,0,40,27
1657196343400,MATH 20B,A01,083756,Briones; Jor-el Thomas Caparas,1,0,36,35
1657196343400,MATH 20B,A02,083757,Briones; Jor-el Thomas Caparas,1,0,36,35
1657196343400,MATH 20B,A03,093475,Briones; Jor-el Thomas Caparas,1,0,36,35
1657196349427,MATH 20C,A01,083760,Briones; Jor-el Thomas Caparas,1,0,35,34
1657196349427,MATH 20C,A02,083761,Briones; Jor-el Thomas Caparas,8,0,35,27
1657196349427,MATH 20C,A03,093476,Briones; Jor-el Thomas Caparas,0,1,36,36
1657196349427,MATH 20C,B01,083762,Bach; Quang Tran,1,0,30,29
1657196355454,MATH 20D,A01,083765,Tran; Brian Kha,4,0,30,26
1657196355454,MATH 20D,A02,083766,Tran; Brian Kha,5,0,30,25
1657196355454,MATH 20D,A03,083767,Tran; Brian Kha,4,0,30,26
1657196361479,MATH 20E,A01,083771,Ganguly; Soumya,7,0,32,25
1657196361479,MATH 20E,A02,083772,Ganguly; Soumya,7,0,32,25
1657196361479,MATH 20E,B01,083773,Ciotti; Benjamin,19,0,35,16
1657196361479,MATH 20E,B02,083774,Ciotti; Benjamin,17,0,35,18
1657196367510,MATH 103A,A01,083777,Greenfeld; Be'Eri,2,0,36,34
1657196367510,MATH 103A,A02,083778,Greenfeld; Be'Eri,5,0,36,31
1657196367510,MATH 103A,A03,093561,Greenfeld; Be'Eri,4,0,36,32
1657196367510,MATH 103A,B01,083779,Greenfeld; Be'Eri,6,0,36,30
1657196367510,MATH 103A,B02,083780,Greenfeld; Be'Eri,3,0,36,33
1657196367510,MATH 103A,B03,093562,Greenfeld; Be'Eri,3,0,36,33
1657196373541,MATH 105,A01,085443,Carter; Anne Toulson,14,0,35,21
1657196373541,MATH 105,A02,093477,Carter; Anne Toulson,20,0,35,15
1657196379568,MATH 109,A01,083213,Ganzberger; Geoffrey Michael,2,0,34,32
1657196379568,MATH 109,A02,083214,Ganzberger; Geoffrey Michael,4,0,34,30
1657196379568,MATH 109,A03,093478,Ganzberger; Geoffrey Michael,1,0,34,33
1657196379568,MATH 109,B01,083215,Ganzberger; Geoffrey Michael,1,0,32,31
1657196379568,MATH 109,B02,083216,Ganzberger; Geoffrey Michael,1,0,32,31
1657196379568,MATH 109,B03,093479,Ganzberger; Geoffrey Michael,7,0,32,25
1657196385599,MATH 142A,A01,083219,Chow; Bennett,6,0,32,26
1657196385599,MATH 142A,A02,083220,Chow; Bennett,10,0,32,22
1657196385599,MATH 142A,A03,093480,Chow; Bennett,7,0,32,25
1657196385599,MATH 142A,B03,093481,Chow; Bennett,8,0,32,24
1657196385599,MATH 142A,B04,093558,Chow; Bennett,11,0,32,21
1657196385599,MATH 142A,B05,093559,Chow; Bennett,6,0,32,26
1657196391627,MATH 193A,A01,083224,Rotar; Vladimir,7,0,34,27
1657196391627,MATH 193A,A02,083225,Rotar; Vladimir,5,0,34,29
1657196391627,MATH 193A,A03,083781,Rotar; Vladimir,1,0,34,33
1657196391627,MATH 193A,A04,083782,Rotar; Vladimir,8,0,34,26
1657196391627,MATH 193A,A05,093482,Rotar; Vladimir,6,0,34,28
1657196397653,MATH 197,001,091859,McAuley; Julian John,9999,0,9999,0
1657196397653,MATH 197,002,095566,Kedlaya; Kiran S.,9997,0,9999,2
1657196397653,MATH 197,003,095567,Xiao; Ming,9999,0,9999,0
1657196397653,MATH 197,004,095571,Perols; Johan Lars,9998,0,9999,1
1657196404712,COGS 9,A01,083615,Shannon; Kyle Michael,7,0,75,68
1657196410738,COGS 11,A01,083617,Boyle; Mary E. T.,22,0,48,26
1657196416760,COGS 13,A01,083071,Bastos; Amalia Pinkusfeld,9,0,71,62
1657196422784,COGS 14A,A01,092681,Semenuks; Arturs,1,1,100,99
1657196428815,COGS 14B,A01,083073,Cheng; Tzu-Han,6,0,63,57
1657196434844,COGS 17,A01,092677,Semenuks; Arturs,4,0,81,77
1657196440869,COGS 100,A01,083619,Allen; Michael Gordon,15,0,70,55
1657196446895,COGS 101A,A01,083621,Davis; Joshua Daniel,9,0,68,59
1657196452919,COGS 101B,A01,091572,Allen; Michael Gordon,9,0,65,56
1657196458953,COGS 101C,A01,083625,Delgado; Tania,17,0,35,18
1657196464982,COGS 107A,A01,083627,Boyle; Mary E. T.,13,0,60,47
1657196471009,COGS 118A,A01,083075,Gupta; Anjum,16,0,76,60
1657196477038,CSE 3,A50,083646,Miranda; Gregory Joseph,24,0,50,26
1657196483062,CSE 8A,A50,083650,Miranda; Gregory Joseph,17,1,56,39
1657196489092,CSE 11,A01,083080,Cao; Yingjun,5,15,40,35
1657196495118,CSE 12,A01,083652,Krause-Levy; Sophia Louisa,24,1,120,96
1657196501145,CSE 15L,A01,083654,Morris; Justin Loren,9,0,50,41
1657196501145,CSE 15L,A02,083655,Morris; Justin Loren,9,0,50,41
1657196507244,CSE 20,A01,083657,Tran; Khoa Dang,38,0,80,42
1657196513278,CSE 21,A01,095574,Bach; Quang Tran,22,0,48,26
1657196519302,CSE 30,A01,083084,Eldon; John,4,0,80,76
1657196519302,CSE 30,B01,095061,Bhaskar; Nishant,7,0,50,43
1657196525339,CSE 100,A01,083659,Cao; Yingjun,4,4,70,66
1657196531364,CSE 134B,A01,083661,Powell; Thomas Allan,20,0,100,80
1657196537389,CSE 140,A01,083663,Gungor; Onat,13,0,85,72
1657196543425,CSE 140L,A01,083088,Eldon; John,17,0,100,83
1657196549454,CSE 175,A01,083665,Kumar; Rakesh,3,0,25,22
1657196555481,CSE 190,A00,092507,Dubnov; Shlomo,7,0,20,13
1657196561505,ECE 45,A01,083139,Congero; Spencer William,5,0,75,70
1657196567531,ECE 65,A50,083695,Saad; Andrew S,12,0,30,18
1657196567531,ECE 65,A51,095125,Saad; Andrew S,25,0,26,1
1657196573560,ECE 109,A01,091882,Touri; Behrouz,19,0,70,51
1657196579585,ECE 180,A00,083140,Abi Samra; Nicholas Camill,1,0,30,29
1657196579585,ECE 180,B00,083141,Abi Samra; Nicholas Camill,0,0,30,30
1657196585614,MATH 10A,A01,083735,Patchell; Gregory David,2,0,30,28
1657196585614,MATH 10A,A02,083736,Patchell; Gregory David,20,0,30,10
1657196585614,MATH 10A,A03,083737,Patchell; Gregory David,16,0,30,14
1657196591645,MATH 10B,A01,083207,Lim; Seonhee,7,0,34,27
1657196591645,MATH 10B,A02,083208,Lim; Seonhee,9,0,35,26
1657196591645,MATH 10B,A03,093472,Lim; Seonhee,5,0,34,29
1657196591645,MATH 10B,B01,083739,Sinha; Shubham,10,0,30,20
1657196597669,MATH 18,A01,083743,Cinel; Cameron Alexander,6,0,30,24
1657196597669,MATH 18,A02,083744,Cinel; Cameron Alexander,15,0,30,15
1657196597669,MATH 18,A03,083745,Cinel; Cameron Alexander,8,0,30,22
1657196597669,MATH 18,B01,083748,Rideout; David Porter,4,0,37,33
1657196597669,MATH 18,B02,083749,Rideout; David Porter,4,0,36,32
1657196597669,MATH 18,B03,083750,Rideout; David Porter,2,0,37,35
1657196597669,MATH 18,B04,083751,Rideout; David Porter,5,0,36,31
1657196597669,MATH 18,B05,093473,Rideout; David Porter,5,0,36,31
1657196597669,MATH 18,B06,093474,Rideout; David Porter,5,0,36,31
1657196603697,MATH 20A,A01,083754,Zheng; Zequn,13,0,40,27
1657196609726,MATH 20B,A01,083756,Briones; Jor-el Thomas Caparas,1,0,36,35
1657196609726,MATH 20B,A02,083757,Briones; Jor-el Thomas Caparas,1,0,36,35
1657196609726,MATH 20B,A03,093475,Briones; Jor-el Thomas Caparas,1,0,36,35
1657196615749,MATH 20C,A01,083760,Briones; Jor-el Thomas Caparas,1,0,35,34
1657196615749,MATH 20C,A02,083761,Briones; Jor-el Thomas Caparas,8,0,35,27
1657196615749,MATH 20C,A03,093476,Briones; Jor-el Thomas Caparas,0,1,36,36
1657196615749,MATH 20C,B01,083762,Bach; Quang Tran,1,0,30,29
1657196621780,MATH 20D,A01,083765,Tran; Brian Kha,4,0,30,26
1657196621780,MATH 20D,A02,083766,Tran; Brian Kha,5,0,30,25
1657196621780,MATH 20D,A03,083767,Tran; Brian Kha,4,0,30,26
1657196627804,MATH 20E,A01,083771,Ganguly; Soumya,7,0,32,25
1657196627804,MATH 20E,A02,083772,Ganguly; Soumya,7,0,32,25
1657196627804,MATH 20E,B01,083773,Ciotti; Benjamin,19,0,35,16
1657196627804,MATH 20E,B02,083774,Ciotti; Benjamin,17,0,35,18
1657196633828,MATH 103A,A01,083777,Greenfeld; Be'Eri,2,0,36,34
1657196633828,MATH 103A,A02,083778,Greenfeld; Be'Eri,5,0,36,31
1657196633828,MATH 103A,A03,093561,Greenfeld; Be'Eri,4,0,36,32
1657196633828,MATH 103A,B01,083779,Greenfeld; Be'Eri,6,0,36,30
1657196633828,MATH 103A,B02,083780,Greenfeld; Be'Eri,3,0,36,33
1657196633828,MATH 103A,B03,093562,Greenfeld; Be'Eri,3,0,36,33
1657196639857,MATH 105,A01,085443,Carter; Anne Toulson,14,0,35,21
1657196639857,MATH 105,A02,093477,Carter; Anne Toulson,20,0,35,15
1657196645880,MATH 109,A01,083213,Ganzberger; Geoffrey Michael,2,0,34,32
1657196645880,MATH 109,A02,083214,Ganzberger; Geoffrey Michael,4,0,34,30
1657196645880,MATH 109,A03,093478,Ganzberger; Geoffrey Michael,1,0,34,33
1657196645880,MATH 109,B01,083215,Ganzberger; Geoffrey Michael,1,0,32,31
1657196645880,MATH 109,B02,083216,Ganzberger; Geoffrey Michael,1,0,32,31
1657196645880,MATH 109,B03,093479,Ganzberger; Geoffrey Michael,7,0,32,25
1657196651909,MATH 142A,A01,083219,Chow; Bennett,6,0,32,26
1657196651909,MATH 142A,A02,083220,Chow; Bennett,10,0,32,22
1657196651909,MATH 142A,A03,093480,Chow; Bennett,7,0,32,25
1657196651909,MATH 142A,B03,093481,Chow; Bennett,8,0,32,24
1657196651909,MATH 142A,B04,093558,Chow; Bennett,11,0,32,21
1657196651909,MATH 142A,B05,093559,Chow; Bennett,6,0,32,26
1657196657940,MATH 193A,A01,083224,Rotar; Vladimir,7,0,34,27
1657196657940,MATH 193A,A02,083225,Rotar; Vladimir,5,0,34,29
1657196657940,MATH 193A,A03,083781,Rotar; Vladimir,1,0,34,33
1657196657940,MATH 193A,A04,083782,Rotar; Vladimir,8,0,34,26
1657196657940,MATH 193A,A05,093482,Rotar; Vladimir,6,0,34,28
1657196663965,MATH 197,001,091859,McAuley; Julian John,9999,0,9999,0
1657196663965,MATH 197,002,095566,Kedlaya; Kiran S.,9997,0,9999,2
1657196663965,MATH 197,003,095567,Xiao; Ming,9999,0,9999,0
1657196663965,MATH 197,004,095571,Perols; Johan Lars,9998,0,9999,1
1657196671025,COGS 9,A01,083615,Shannon; Kyle Michael,7,0,75,68
1657196677055,COGS 11,A01,083617,Boyle; Mary E. T.,22,0,48,26
1657196683082,COGS 13,A01,083071,Bastos; Amalia Pinkusfeld,9,0,71,62
1657196689108,COGS 14A,A01,092681,Semenuks; Arturs,1,1,100,99
1657196695134,COGS 14B,A01,083073,Cheng; Tzu-Han,6,0,63,57
1657196701163,COGS 17,A01,092677,Semenuks; Arturs,4,0,81,77
1657196707186,COGS 100,A01,083619,Allen; Michael Gordon,15,0,70,55
1657196713215,COGS 101A,A01,083621,Davis; Joshua Daniel,9,0,68,59
1657196719245,COGS 101B,A01,091572,Allen; Michael Gordon,9,0,65,56
1657196725285,COGS 101C,A01,083625,Delgado; Tania,17,0,35,18
1657196731312,COGS 107A,A01,083627,Boyle; Mary E. T.,13,0,60,47
1657196737338,COGS 118A,A01,083075,Gupta; Anjum,16,0,76,60
1657196743371,CSE 3,A50,083646,Miranda; Gregory Joseph,24,0,50,26
1657196749397,CSE 8A,A50,083650,Miranda; Gregory Joseph,17,1,56,39
1657196755428,CSE 11,A01,083080,Cao; Yingjun,5,15,40,35
1657196761454,CSE 12,A01,083652,Krause-Levy; Sophia Louisa,24,1,120,96
1657196767484,CSE 15L,A01,083654,Morris; Justin Loren,9,0,50,41
1657196767484,CSE 15L,A02,083655,Morris; Justin Loren,9,0,50,41
1657196773524,CSE 20,A01,083657,Tran; Khoa Dang,38,0,80,42
1657196779547,CSE 21,A01,095574,Bach; Quang Tran,22,0,48,26
1657196785577,CSE 30,A01,083084,Eldon; John,4,0,80,76
1657196785577,CSE 30,B01,095061,Bhaskar; Nishant,7,0,50,43
1657196791603,CSE 100,A01,083659,Cao; Yingjun,4,4,70,66
1657196797626,CSE 134B,A01,083661,Powell; Thomas Allan,20,0,100,80
1657196803655,CSE 140,A01,083663,Gungor; Onat,13,0,85,72
1657196809690,CSE 140L,A01,083088,Eldon; John,17,0,100,83
1657196815716,CSE 175,A01,083665,Kumar; Rakesh,3,0,25,22
1657196821755,CSE 190,A00,092507,Dubnov; Shlomo,7,0,20,13
1657196827777,ECE 45,A01,083139,Congero; Spencer William,5,0,75,70
1657196833802,ECE 65,A50,083695,Saad; Andrew S,12,0,30,18
1657196833802,ECE 65,A51,095125,Saad; Andrew S,25,0,26,1
1657196839827,ECE 109,A01,091882,Touri; Behrouz,19,0,70,51
1657196845855,ECE 180,A00,083140,Abi Samra; Nicholas Camill,1,0,30,29
1657196845855,ECE 180,B00,083141,Abi Samra; Nicholas Camill,0,0,30,30
1657196851881,MATH 10A,A01,083735,Patchell; Gregory David,2,0,30,28
1657196851881,MATH 10A,A02,083736,Patchell; Gregory David,20,0,30,10
1657196851881,MATH 10A,A03,083737,Patchell; Gregory David,16,0,30,14
1657196857911,MATH 10B,A01,083207,Lim; Seonhee,7,0,34,27
1657196857911,MATH 10B,A02,083208,Lim; Seonhee,9,0,35,26
1657196857911,MATH 10B,A03,093472,Lim; Seonhee,5,0,34,29
1657196857911,MATH 10B,B01,083739,Sinha; Shubham,10,0,30,20
1657196863941,MATH 18,A01,083743,Cinel; Cameron Alexander,6,0,30,24
1657196863941,MATH 18,A02,083744,Cinel; Cameron Alexander,15,0,30,15
1657196863941,MATH 18,A03,083745,Cinel; Cameron Alexander,8,0,30,22
1657196863941,MATH 18,B01,083748,Rideout; David Porter,4,0,37,33
1657196863941,MATH 18,B02,083749,Rideout; David Porter,4,0,36,32
1657196863941,MATH 18,B03,083750,Rideout; David Porter,2,0,37,35
1657196863941,MATH 18,B04,083751,Rideout; David Porter,5,0,36,31
1657196863941,MATH 18,B05,093473,Rideout; David Porter,5,0,36,31
1657196863941,MATH 18,B06,093474,Rideout; David Porter,5,0,36,31
1657196869964,MATH 20A,A01,083754,Zheng; Zequn,13,0,40,27
1657196875994,MATH 20B,A01,083756,Briones; Jor-el Thomas Caparas,1,0,36,35
1657196875994,MATH 20B,A02,083757,Briones; Jor-el Thomas Caparas,1,0,36,35
1657196875994,MATH 20B,A03,093475,Briones; Jor-el Thomas Caparas,1,0,36,35
1657196882024,MATH 20C,A01,083760,Briones; Jor-el Thomas Caparas,1,0,35,34
1657196882024,MATH 20C,A02,083761,Briones; Jor-el Thomas Caparas,8,0,35,27
1657196882024,MATH 20C,A03,093476,Briones; Jor-el Thomas Caparas,0,1,36,36
1657196882024,MATH 20C,B01,083762,Bach; Quang Tran,1,0,30,29
1657196888050,MATH 20D,A01,083765,Tran; Brian Kha,4,0,30,26
1657196888050,MATH 20D,A02,083766,Tran; Brian Kha,5,0,30,25
1657196888050,MATH 20D,A03,083767,Tran; Brian Kha,4,0,30,26
1657196894074,MATH 20E,A01,083771,Ganguly; Soumya,7,0,32,25
1657196894074,MATH 20E,A02,083772,Ganguly; Soumya,7,0,32,25
1657196894074,MATH 20E,B01,083773,Ciotti; Benjamin,19,0,35,16
1657196894074,MATH 20E,B02,083774,Ciotti; Benjamin,17,0,35,18
1657196900101,MATH 103A,A01,083777,Greenfeld; Be'Eri,2,0,36,34
1657196900101,MATH 103A,A02,083778,Greenfeld; Be'Eri,5,0,36,31
1657196900101,MATH 103A,A03,093561,Greenfeld; Be'Eri,4,0,36,32
1657196900101,MATH 103A,B01,083779,Greenfeld; Be'Eri,6,0,36,30
1657196900101,MATH 103A,B02,083780,Greenfeld; Be'Eri,3,0,36,33
1657196900101,MATH 103A,B03,093562,Greenfeld; Be'Eri,3,0,36,33
1657196906130,MATH 105,A01,085443,Carter; Anne Toulson,14,0,35,21
1657196906130,MATH 105,A02,093477,Carter; Anne Toulson,20,0,35,15
1657196912162,MATH 109,A01,083213,Ganzberger; Geoffrey Michael,2,0,34,32
1657196912162,MATH 109,A02,083214,Ganzberger; Geoffrey Michael,4,0,34,30
1657196912162,MATH 109,A03,093478,Ganzberger; Geoffrey Michael,1,0,34,33
1657196912162,MATH 109,B01,083215,Ganzberger; Geoffrey Michael,1,0,32,31
1657196912162,MATH 109,B02,083216,Ganzberger; Geoffrey Michael,1,0,32,31
1657196912162,MATH 109,B03,093479,Ganzberger; Geoffrey Michael,7,0,32,25
1657196918193,MATH 142A,A01,083219,Chow; Bennett,6,0,32,26
1657196918193,MATH 142A,A02,083220,Chow; Bennett,10,0,32,22
1657196918193,MATH 142A,A03,093480,Chow; Bennett,7,0,32,25
1657196918193,MATH 142A,B03,093481,Chow; Bennett,8,0,32,24
1657196918193,MATH 142A,B04,093558,Chow; Bennett,11,0,32,21
1657196918193,MATH 142A,B05,093559,Chow; Bennett,6,0,32,26
1657196924233,MATH 193A,A01,083224,Rotar; Vladimir,7,0,34,27
1657196924233,MATH 193A,A02,083225,Rotar; Vladimir,5,0,34,29
1657196924233,MATH 193A,A03,083781,Rotar; Vladimir,1,0,34,33
1657196924233,MATH 193A,A04,083782,Rotar; Vladimir,8,0,34,26
1657196924233,MATH 193A,A05,093482,Rotar; Vladimir,6,0,34,28
1657196930259,MATH 197,001,091859,McAuley; Julian John,9999,0,9999,0
1657196930259,MATH 197,002,095566,Kedlaya; Kiran S.,9997,0,9999,2
1657196930259,MATH 197,003,095567,Xiao; Ming,9999,0,9999,0
1657196930259,MATH 197,004,095571,Perols; Johan Lars,9998,0,9999,1
1657196937323,COGS 9,A01,083615,Shannon; Kyle Michael,7,0,75,68
1657196943346,COGS 11,A01,083617,Boyle; Mary E. T.,22,0,48,26
1657196949373,COGS 13,A01,083071,Bastos; Amalia Pinkusfeld,9,0,71,62
1657196955397,COGS 14A,A01,092681,Semenuks; Arturs,1,1,100,99
1657196961426,COGS 14B,A01,083073,Cheng; Tzu-Han,6,0,63,57
1657196967454,COGS 17,A01,092677,Semenuks; Arturs,4,0,81,77
1657196973491,COGS 100,A01,083619,Allen; Michael Gordon,15,0,70,55
1657196979517,COGS 101A,A01,083621,Davis; Joshua Daniel,9,0,68,59
1657196985549,COGS 101B,A01,091572,Allen; Michael Gordon,9,0,65,56
1657196991577,COGS 101C,A01,083625,Delgado; Tania,17,0,35,18
1657196997607,COGS 107A,A01,083627,Boyle; Mary E. T.,13,0,60,47
1657197003635,COGS 118A,A01,083075,Gupta; Anjum,16,0,76,60
1657197009664,CSE 3,A50,083646,Miranda; Gregory Joseph,24,0,50,26
1657197015695,CSE 8A,A50,083650,Miranda; Gregory Joseph,17,1,56,39
1657197021722,CSE 11,A01,083080,Cao; Yingjun,5,15,40,35
1657197027748,CSE 12,A01,083652,Krause-Levy; Sophia Louisa,24,1,120,96
1657197033775,CSE 15L,A01,083654,Morris; Justin Loren,9,0,50,41
1657197033775,CSE 15L,A02,083655,Morris; Justin Loren,9,0,50,41
1657197039809,CSE 20,A01,083657,Tran; Khoa Dang,38,0,80,42
1657197045838,CSE 21,A01,095574,Bach; Quang Tran,22,0,48,26
1657197051868,CSE 30,A01,083084,Eldon; John,4,0,80,76
1657197051868,CSE 30,B01,095061,Bhaskar; Nishant,7,0,50,43
1657197057892,CSE 100,A01,083659,Cao; Yingjun,4,4,70,66
1657197063921,CSE 134B,A01,083661,Powell; Thomas Allan,20,0,100,80
1657197069948,CSE 140,A01,083663,Gungor; Onat,13,0,85,72
1657197075977,CSE 140L,A01,083088,Eldon; John,17,0,100,83
1657197082005,CSE 175,A01,083665,Kumar; Rakesh,3,0,25,22
1657197088034,CSE 190,A00,092507,Dubnov; Shlomo,7,0,20,13
1657197094060,ECE 45,A01,083139,Congero; Spencer William,5,0,75,70
1657197100086,ECE 65,A50,083695,Saad; Andrew S,12,0,30,18
1657197100086,ECE 65,A51,095125,Saad; Andrew S,25,0,26,1
1657197106181,ECE 109,A01,091882,Touri; Behrouz,19,0,70,51
1657197112209,ECE 180,A00,083140,Abi Samra; Nicholas Camill,1,0,30,29
1657197112209,ECE 180,B00,083141,Abi Samra; Nicholas Camill,0,0,30,30
1657197118235,MATH 10A,A01,083735,Patchell; Gregory David,2,0,30,28
1657197118235,MATH 10A,A02,083736,Patchell; Gregory David,20,0,30,10
1657197118235,MATH 10A,A03,083737,Patchell; Gregory David,16,0,30,14
1657197124264,MATH 10B,A01,083207,Lim; Seonhee,7,0,34,27
1657197124264,MATH 10B,A02,083208,Lim; Seonhee,9,0,35,26
1657197124264,MATH 10B,A03,093472,Lim; Seonhee,5,0,34,29
1657197124264,MATH 10B,B01,083739,Sinha; Shubham,10,0,30,20
1657197130291,MATH 18,A01,083743,Cinel; Cameron Alexander,6,0,30,24
1657197130291,MATH 18,A02,083744,Cinel; Cameron Alexander,15,0,30,15
1657197130291,MATH 18,A03,083745,Cinel; Cameron Alexander,8,0,30,22
1657197130291,MATH 18,B01,083748,Rideout; David Porter,4,0,37,33
1657197130291,MATH 18,B02,083749,Rideout; David Porter,4,0,36,32
1657197130291,MATH 18,B03,083750,Rideout; David Porter,2,0,37,35
1657197130291,MATH 18,B04,083751,Rideout; David Porter,5,0,36,31
1657197130291,MATH 18,B05,093473,Rideout; David Porter,5,0,36,31
1657197130291,MATH 18,B06,093474,Rideout; David Porter,5,0,36,31
1657197136319,MATH 20A,A01,083754,Zheng; Zequn,13,0,40,27
1657197142345,MATH 20B,A01,083756,Briones; Jor-el Thomas Caparas,1,0,36,35
1657197142345,MATH 20B,A02,083757,Briones; Jor-el Thomas Caparas,1,0,36,35
1657197142345,MATH 20B,A03,093475,Briones; Jor-el Thomas Caparas,1,0,36,35
1657197148372,MATH 20C,A01,083760,Briones; Jor-el Thomas Caparas,1,0,35,34
1657197148372,MATH 20C,A02,083761,Briones; Jor-el Thomas Caparas,8,0,35,27
1657197148372,MATH 20C,A03,093476,Briones; Jor-el Thomas Caparas,0,1,36,36
1657197148372,MATH 20C,B01,083762,Bach; Quang Tran,1,0,30,29
1657197154402,MATH 20D,A01,083765,Tran; Brian Kha,4,0,30,26
1657197154402,MATH 20D,A02,083766,Tran; Brian Kha,5,0,30,25
1657197154402,MATH 20D,A03,083767,Tran; Brian Kha,4,0,30,26
1657197160433,MATH 20E,A01,083771,Ganguly; Soumya,7,0,32,25
1657197160433,MATH 20E,A02,083772,Ganguly; Soumya,7,0,32,25
1657197160433,MATH 20E,B01,083773,Ciotti; Benjamin,19,0,35,16
1657197160433,MATH 20E,B02,083774,Ciotti; Benjamin,17,0,35,18
1657197166460,MATH 103A,A01,083777,Greenfeld; Be'Eri,2,0,36,34
1657197166460,MATH 103A,A02,083778,Greenfeld; Be'Eri,5,0,36,31
1657197166460,MATH 103A,A03,093561,Greenfeld; Be'Eri,4,0,36,32
1657197166460,MATH 103A,B01,083779,Greenfeld; Be'Eri,6,0,36,30
1657197166460,MATH 103A,B02,083780,Greenfeld; Be'Eri,3,0,36,33
1657197166460,MATH 103A,B03,093562,Greenfeld; Be'Eri,3,0,36,33
1657197172490,MATH 105,A01,085443,Carter; Anne Toulson,14,0,35,21
1657197172490,MATH 105,A02,093477,Carter; Anne Toulson,20,0,35,15
1657197178516,MATH 109,A01,083213,Ganzberger; Geoffrey Michael,2,0,34,32
1657197178516,MATH 109,A02,083214,Ganzberger; Geoffrey Michael,4,0,34,30
1657197178516,MATH 109,A03,093478,Ganzberger; Geoffrey Michael,1,0,34,33
1657197178516,MATH 109,B01,083215,Ganzberger; Geoffrey Michael,1,0,32,31
1657197178516,MATH 109,B02,083216,Ganzberger; Geoffrey Michael,1,0,32,31
1657197178516,MATH 109,B03,093479,Ganzberger; Geoffrey Michael,7,0,32,25
1657197184542,MATH 142A,A01,083219,Chow; Bennett,6,0,32,26
1657197184542,MATH 142A,A02,083220,Chow; Bennett,10,0,32,22
1657197184542,MATH 142A,A03,093480,Chow; Bennett,7,0,32,25
1657197184542,MATH 142A,B03,093481,Chow; Bennett,8,0,32,24
1657197184542,MATH 142A,B04,093558,Chow; Bennett,11,0,32,21
1657197184542,MATH 142A,B05,093559,Chow; Bennett,6,0,32,26
1657197190566,MATH 193A,A01,083224,Rotar; Vladimir,7,0,34,27
1657197190566,MATH 193A,A02,083225,Rotar; Vladimir,5,0,34,29
1657197190566,MATH 193A,A03,083781,Rotar; Vladimir,1,0,34,33
1657197190566,MATH 193A,A04,083782,Rotar; Vladimir,8,0,34,26
1657197190566,MATH 193A,A05,093482,Rotar; Vladimir,6,0,34,28
1657197196595,MATH 197,001,091859,McAuley; Julian John,9999,0,9999,0
1657197196595,MATH 197,002,095566,Kedlaya; Kiran S.,9997,0,9999,2
1657197196595,MATH 197,003,095567,Xiao; Ming,9999,0,9999,0
1657197196595,MATH 197,004,095571,Perols; Johan Lars,9998,0,9999,1
1657197203667,COGS 9,A01,083615,Shannon; Kyle Michael,7,0,75,68
1657197209690,COGS 11,A01,083617,Boyle; Mary E. T.,22,0,48,26
1657197215719,COGS 13,A01,083071,Bastos; Amalia Pinkusfeld,9,0,71,62
1657197221745,COGS 14A,A01,092681,Semenuks; Arturs,1,1,100,99
1657197227771,COGS 14B,A01,083073,Cheng; Tzu-Han,6,0,63,57
1657197233797,COGS 17,A01,092677,Semenuks; Arturs,4,0,81,77
1657197239820,COGS 100,A01,083619,Allen; Michael Gordon,15,0,70,55
1657197245847,COGS 101A,A01,083621,Davis; Joshua Daniel,9,0,68,59
1657197251880,COGS 101B,A01,091572,Allen; Michael Gordon,9,0,65,56
1657197257904,COGS 101C,A01,083625,Delgado; Tania,17,0,35,18
1657197263933,COGS 107A,A01,083627,Boyle; Mary E. T.,13,0,60,47
1657197269957,COGS 118A,A01,083075,Gupta; Anjum,16,0,76,60
1657197275988,CSE 3,A50,083646,Miranda; Gregory Joseph,24,0,50,26
1657197282020,CSE 8A,A50,083650,Miranda; Gregory Joseph,17,1,56,39
1657197288050,CSE 11,A01,083080,Cao; Yingjun,5,15,40,35
1657197294078,CSE 12,A01,083652,Krause-Levy; Sophia Louisa,24,1,120,96
1657197300109,CSE 15L,A01,083654,Morris; Justin Loren,9,0,50,41
1657197300109,CSE 15L,A02,083655,Morris; Justin Loren,9,0,50,41
1657197306133,CSE 20,A01,083657,Tran; Khoa Dang,38,0,80,42
1657197312163,CSE 21,A01,095574,Bach; Quang Tran,22,0,48,26
1657197318189,CSE 30,A01,083084,Eldon; John,4,0,80,76
1657197318189,CSE 30,B01,095061,Bhaskar; Nishant,7,0,50,43
1657197324219,CSE 100,A01,083659,Cao; Yingjun,4,4,70,66
1657197330249,CSE 134B,A01,083661,Powell; Thomas Allan,20,0,100,80
1657197336276,CSE 140,A01,083663,Gungor; Onat,13,0,85,72
1657197342302,CSE 140L,A01,083088,Eldon; John,17,0,100,83
1657197348369,CSE 175,A01,083665,Kumar; Rakesh,3,0,25,22
1657197354396,CSE 190,A00,092507,Dubnov; Shlomo,7,0,20,13
1657197360423,ECE 45,A01,083139,Congero; Spencer William,5,0,75,70
1657197366451,ECE 65,A50,083695,Saad; Andrew S,12,0,30,18
1657197366451,ECE 65,A51,095125,Saad; Andrew S,25,0,26,1
1657197372480,ECE 109,A01,091882,Touri; Behrouz,19,0,70,51
1657197378511,ECE 180,A00,083140,Abi Samra; Nicholas Camill,1,0,30,29
1657197378511,ECE 180,B00,083141,Abi Samra; Nicholas Camill,0,0,30,30
1657197384539,MATH 10A,A01,083735,Patchell; Gregory David,2,0,30,28
1657197384539,MATH 10A,A02,083736,Patchell; Gregory David,20,0,30,10
1657197384539,MATH 10A,A03,083737,Patchell; Gregory David,16,0,30,14
1657197390572,MATH 10B,A01,083207,Lim; Seonhee,7,0,34,27
1657197390572,MATH 10B,A02,083208,Lim; Seonhee,9,0,35,26
1657197390572,MATH 10B,A03,093472,Lim; Seonhee,5,0,34,29
1657197390572,MATH 10B,B01,083739,Sinha; Shubham,10,0,30,20
1657197396619,MATH 18,A01,083743,Cinel; Cameron Alexander,6,0,30,24
1657197396619,MATH 18,A02,083744,Cinel; Cameron Alexander,15,0,30,15
1657197396619,MATH 18,A03,083745,Cinel; Cameron Alexander,8,0,30,22
1657197396619,MATH 18,B01,083748,Rideout; David Porter,4,0,37,33
1657197396619,MATH 18,B02,083749,Rideout; David Porter,4,0,36,32
1657197396619,MATH 18,B03,083750,Rideout; David Porter,2,0,37,35
1657197396619,MATH 18,B04,083751,Rideout; David Porter,5,0,36,31
1657197396619,MATH 18,B05,093473,Rideout; David Porter,5,0,36,31
1657197396619,MATH 18,B06,093474,Rideout; David Porter,5,0,36,31
1657197402652,MATH 20A,A01,083754,Zheng; Zequn,13,0,40,27
1657197408678,MATH 20B,A01,083756,Briones; Jor-el Thomas Caparas,1,0,36,35
1657197408678,MATH 20B,A02,083757,Briones; Jor-el Thomas Caparas,1,0,36,35
1657197408678,MATH 20B,A03,093475,Briones; Jor-el Thomas Caparas,1,0,36,35
1657197414717,MATH 20C,A01,083760,Briones; Jor-el Thomas Caparas,1,0,35,34
1657197414717,MATH 20C,A02,083761,Briones; Jor-el Thomas Caparas,8,0,35,27
1657197414717,MATH 20C,A03,093476,Briones; Jor-el Thomas Caparas,0,1,36,36
1657197414717,MATH 20C,B01,083762,Bach; Quang Tran,1,0,30,29
1657197420750,MATH 20D,A01,083765,Tran; Brian Kha,4,0,30,26
1657197420750,MATH 20D,A02,083766,Tran; Brian Kha,5,0,30,25
1657197420750,MATH 20D,A03,083767,Tran; Brian Kha,4,0,30,26
1657197426783,MATH 20E,A01,083771,Ganguly; Soumya,7,0,32,25
1657197426783,MATH 20E,A02,083772,Ganguly; Soumya,7,0,32,25
1657197426783,MATH 20E,B01,083773,Ciotti; Benjamin,19,0,35,16
1657197426783,MATH 20E,B02,083774,Ciotti; Benjamin,17,0,35,18
1657197432819,MATH 103A,A01,083777,Greenfeld; Be'Eri,2,0,36,34
1657197432819,MATH 103A,A02,083778,Greenfeld; Be'Eri,5,0,36,31
1657197432819,MATH 103A,A03,093561,Greenfeld; Be'Eri,4,0,36,32
1657197432819,MATH 103A,B01,083779,Greenfeld; Be'Eri,6,0,36,30
1657197432819,MATH 103A,B02,083780,Greenfeld; Be'Eri,3,0,36,33
1657197432819,MATH 103A,B03,093562,Greenfeld; Be'Eri,3,0,36,33
1657197438844,MATH 105,A01,085443,Carter; Anne Toulson,14,0,35,21
1657197438844,MATH 105,A02,093477,Carter; Anne Toulson,20,0,35,15
1657197444876,MATH 109,A01,083213,Ganzberger; Geoffrey Michael,2,0,34,32
1657197444876,MATH 109,A02,083214,Ganzberger; Geoffrey Michael,4,0,34,30
1657197444876,MATH 109,A03,093478,Ganzberger; Geoffrey Michael,1,0,34,33
1657197444876,MATH 109,B01,083215,Ganzberger; Geoffrey Michael,1,0,32,31
1657197444876,MATH 109,B02,083216,Ganzberger; Geoffrey Michael,1,0,32,31
1657197444876,MATH 109,B03,093479,Ganzberger; Geoffrey Michael,7,0,32,25
1657197450904,MATH 142A,A01,083219,Chow; Bennett,6,0,32,26
1657197450904,MATH 142A,A02,083220,Chow; Bennett,10,0,32,22
1657197450904,MATH 142A,A03,093480,Chow; Bennett,7,0,32,25
1657197450904,MATH 142A,B03,093481,Chow; Bennett,8,0,32,24
1657197450904,MATH 142A,B04,093558,Chow; Bennett,11,0,32,21
1657197450904,MATH 142A,B05,093559,Chow; Bennett,6,0,32,26
1657197456932,MATH 193A,A01,083224,Rotar; Vladimir,7,0,34,27
1657197456932,MATH 193A,A02,083225,Rotar; Vladimir,5,0,34,29
1657197456932,MATH 193A,A03,083781,Rotar; Vladimir,1,0,34,33
1657197456932,MATH 193A,A04,083782,Rotar; Vladimir,8,0,34,26
1657197456932,MATH 193A,A05,093482,Rotar; Vladimir,6,0,34,28
1657197462962,MATH 197,001,091859,McAuley; Julian John,9999,0,9999,0
1657197462962,MATH 197,002,095566,Kedlaya; Kiran S.,9997,0,9999,2
1657197462962,MATH 197,003,095567,Xiao; Ming,9999,0,9999,0
1657197462962,MATH 197,004,095571,Perols; Johan Lars,9998,0,9999,1
1657197470026,COGS 9,A01,083615,Shannon; Kyle Michael,7,0,75,68
1657197476067,COGS 11,A01,083617,Boyle; Mary E. T.,22,0,48,26
1657197482096,COGS 13,A01,083071,Bastos; Amalia Pinkusfeld,9,0,71,62
1657197488126,COGS 14A,A01,092681,Semenuks; Arturs,1,1,100,99
1657197494152,COGS 14B,A01,083073,Cheng; Tzu-Han,6,0,63,57
1657197500179,COGS 17,A01,092677,Semenuks; Arturs,4,0,81,77
1657197506213,COGS 100,A01,083619,Allen; Michael Gordon,15,0,70,55
1657197512242,COGS 101A,A01,083621,Davis; Joshua Daniel,9,0,68,59
1657197518268,COGS 101B,A01,091572,Allen; Michael Gordon,9,0,65,56
1657197524295,COGS 101C,A01,083625,Delgado; Tania,17,0,35,18
1657197530322,COGS 107A,A01,083627,Boyle; Mary E. T.,13,0,60,47
1657197536351,COGS 118A,A01,083075,Gupta; Anjum,16,0,76,60
1657197542379,CSE 3,A50,083646,Miranda; Gregory Joseph,24,0,50,26
1657197548406,CSE 8A,A50,083650,Miranda; Gregory Joseph,17,1,56,39
1657197554433,CSE 11,A01,083080,Cao; Yingjun,5,15,40,35
1657197560460,CSE 12,A01,083652,Krause-Levy; Sophia Louisa,24,1,120,96
1657197566485,CSE 15L,A01,083654,Morris; Justin Loren,9,0,50,41
1657197566485,CSE 15L,A02,083655,Morris; Justin Loren,9,0,50,41
1657197572515,CSE 20,A01,083657,Tran; Khoa Dang,38,0,80,42
1657197578548,CSE 21,A01,095574,Bach; Quang Tran,22,0,48,26
1657197584579,CSE 30,A01,083084,Eldon; John,4,0,80,76
1657197584579,CSE 30,B01,095061,Bhaskar; Nishant,7,0,50,43
1657197590608,CSE 100,A01,083659,Cao; Yingjun,4,4,70,66
1657197596646,CSE 134B,A01,083661,Powell; Thomas Allan,20,0,100,80
1657197602673,CSE 140,A01,083663,Gungor; Onat,13,0,85,72
1657197608711,CSE 140L,A01,083088,Eldon; John,17,0,100,83
1657197614735,CSE 175,A01,083665,Kumar; Rakesh,3,0,25,22
1657197620761,CSE 190,A00,092507,Dubnov; Shlomo,7,0,20,13
1657197626788,ECE 45,A01,083139,Congero; Spencer William,5,0,75,70
1657197632819,ECE 65,A50,083695,Saad; Andrew S,12,0,30,18
1657197632819,ECE 65,A51,095125,Saad; Andrew S,25,0,26,1
1657197638845,ECE 109,A01,091882,Touri; Behrouz,19,0,70,51
1657197644871,ECE 180,A00,083140,Abi Samra; Nicholas Camill,1,0,30,29
1657197644871,ECE 180,B00,083141,Abi Samra; Nicholas Camill,0,0,30,30
1657197650901,MATH 10A,A01,083735,Patchell; Gregory David,2,0,30,28
1657197650901,MATH 10A,A02,083736,Patchell; Gregory David,20,0,30,10
1657197650901,MATH 10A,A03,083737,Patchell; Gregory David,16,0,30,14
1657197656928,MATH 10B,A01,083207,Lim; Seonhee,7,0,34,27
1657197656928,MATH 10B,A02,083208,Lim; Seonhee,9,0,35,26
1657197656928,MATH 10B,A03,093472,Lim; Seonhee,5,0,34,29
1657197656928,MATH 10B,B01,083739,Sinha; Shubham,10,0,30,20
1657197662956,MATH 18,A01,083743,Cinel; Cameron Alexander,6,0,30,24
1657197662956,MATH 18,A02,083744,Cinel; Cameron Alexander,15,0,30,15
1657197662956,MATH 18,A03,083745,Cinel; Cameron Alexander,8,0,30,22
1657197662956,MATH 18,B01,083748,Rideout; David Porter,4,0,37,33
1657197662956,MATH 18,B02,083749,Rideout; David Porter,4,0,36,32
1657197662956,MATH 18,B03,083750,Rideout; David Porter,2,0,37,35
1657197662956,MATH 18,B04,083751,Rideout; David Porter,5,0,36,31
1657197662956,MATH 18,B05,093473,Rideout; David Porter,5,0,36,31
1657197662956,MATH 18,B06,093474,Rideout; David Porter,5,0,36,31
1657197668984,MATH 20A,A01,083754,Zheng; Zequn,13,0,40,27
1657197675013,MATH 20B,A01,083756,Briones; Jor-el Thomas Caparas,1,0,36,35
1657197675013,MATH 20B,A02,083757,Briones; Jor-el Thomas Caparas,1,0,36,35
1657197675013,MATH 20B,A03,093475,Briones; Jor-el Thomas Caparas,1,0,36,35
1657197681045,MATH 20C,A01,083760,Briones; Jor-el Thomas Caparas,1,0,35,34
1657197681045,MATH 20C,A02,083761,Briones; Jor-el Thomas Caparas,8,0,35,27
1657197681045,MATH 20C,A03,093476,Briones; Jor-el Thomas Caparas,0,1,36,36
1657197681045,MATH 20C,B01,083762,Bach; Quang Tran,1,0,30,29
1657197687100,MATH 20D,A01,083765,Tran; Brian Kha,4,0,30,26
1657197687100,MATH 20D,A02,083766,Tran; Brian Kha,5,0,30,25
1657197687100,MATH 20D,A03,083767,Tran; Brian Kha,4,0,30,26
1657197693129,MATH 20E,A01,083771,Ganguly; Soumya,7,0,32,25
1657197693129,MATH 20E,A02,083772,Ganguly; Soumya,7,0,32,25
1657197693129,MATH 20E,B01,083773,Ciotti; Benjamin,19,0,35,16
1657197693129,MATH 20E,B02,083774,Ciotti; Benjamin,17,0,35,18
1657197699159,MATH 103A,A01,083777,Greenfeld; Be'Eri,2,0,36,34
1657197699159,MATH 103A,A02,083778,Greenfeld; Be'Eri,5,0,36,31
1657197699159,MATH 103A,A03,093561,Greenfeld; Be'Eri,4,0,36,32
1657197699159,MATH 103A,B01,083779,Greenfeld; Be'Eri,6,0,36,30
1657197699159,MATH 103A,B02,083780,Greenfeld; Be'Eri,3,0,36,33
1657197699159,MATH 103A,B03,093562,Greenfeld; Be'Eri,3,0,36,33
1657197705267,MATH 105,A01,085443,Carter; Anne Toulson,14,0,35,21
1657197705267,MATH 105,A02,093477,Carter; Anne Toulson,20,0,35,15
1657197711296,MATH 109,A01,083213,Ganzberger; Geoffrey Michael,2,0,34,32
1657197711296,MATH 109,A02,083214,Ganzberger; Geoffrey Michael,4,0,34,30
1657197711296,MATH 109,A03,093478,Ganzberger; Geoffrey Michael,1,0,34,33
1657197711296,MATH 109,B01,083215,Ganzberger; Geoffrey Michael,1,0,32,31
1657197711296,MATH 109,B02,083216,Ganzberger; Geoffrey Michael,1,0,32,31
1657197711296,MATH 109,B03,093479,Ganzberger; Geoffrey Michael,7,0,32,25
1657197717326,MATH 142A,A01,083219,Chow; Bennett,6,0,32,26
1657197717326,MATH 142A,A02,083220,Chow; Bennett,10,0,32,22
1657197717326,MATH 142A,A03,093480,Chow; Bennett,7,0,32,25
1657197717326,MATH 142A,B03,093481,Chow; Bennett,8,0,32,24
1657197717326,MATH 142A,B04,093558,Chow; Bennett,11,0,32,21
1657197717326,MATH 142A,B05,093559,Chow; Bennett,6,0,32,26
1657197723353,MATH 193A,A01,083224,Rotar; Vladimir,7,0,34,27
1657197723353,MATH 193A,A02,083225,Rotar; Vladimir,5,0,34,29
1657197723353,MATH 193A,A03,083781,Rotar; Vladimir,1,0,34,33
1657197723353,MATH 193A,A04,083782,Rotar; Vladimir,8,0,34,26
1657197723353,MATH 193A,A05,093482,Rotar; Vladimir,6,0,34,28
1657197729386,MATH 197,001,091859,McAuley; Julian John,9999,0,9999,0
1657197729386,MATH 197,002,095566,Kedlaya; Kiran S.,9997,0,9999,2
1657197729386,MATH 197,003,095567,Xiao; Ming,9999,0,9999,0
1657197729386,MATH 197,004,095571,Perols; Johan Lars,9998,0,9999,1
1657197736489,COGS 9,A01,083615,Shannon; Kyle Michael,7,0,75,68
1657197742517,COGS 11,A01,083617,Boyle; Mary E. T.,22,0,48,26
1657197748545,COGS 13,A01,083071,Bastos; Amalia Pinkusfeld,9,0,71,62
1657197754572,COGS 14A,A01,092681,Semenuks; Arturs,1,1,100,99
1657197760601,COGS 14B,A01,083073,Cheng; Tzu-Han,6,0,63,57
1657197766625,COGS 17,A01,092677,Semenuks; Arturs,4,0,81,77
1657197772651,COGS 100,A01,083619,Allen; Michael Gordon,15,0,70,55
1657197778684,COGS 101A,A01,083621,Davis; Joshua Daniel,9,0,68,59
1657197784709,COGS 101B,A01,091572,Allen; Michael Gordon,9,0,65,56
1657197790733,COGS 101C,A01,083625,Delgado; Tania,17,0,35,18
1657197796764,COGS 107A,A01,083627,Boyle; Mary E. T.,13,0,60,47
1657197802789,COGS 118A,A01,083075,Gupta; Anjum,16,0,76,60
1657197808831,CSE 3,A50,083646,Miranda; Gregory Joseph,24,0,50,26
1657197814856,CSE 8A,A50,083650,Miranda; Gregory Joseph,17,1,56,39
1657197820885,CSE 11,A01,083080,Cao; Yingjun,5,15,40,35
1657197826919,CSE 12,A01,083652,Krause-Levy; Sophia Louisa,24,1,120,96
1657197832951,CSE 15L,A01,083654,Morris; Justin Loren,9,0,50,41
1657197832951,CSE 15L,A02,083655,Morris; Justin Loren,9,0,50,41
1657197838976,CSE 20,A01,083657,Tran; Khoa Dang,38,0,80,42
1657197845000,CSE 21,A01,095574,Bach; Quang Tran,22,0,48,26
1657197851027,CSE 30,A01,083084,Eldon; John,4,0,80,76
1657197851027,CSE 30,B01,095061,Bhaskar; Nishant,7,0,50,43
1657197857052,CSE 100,A01,083659,Cao; Yingjun,4,4,70,66
1657197863091,CSE 134B,A01,083661,Powell; Thomas Allan,20,0,100,80
1657197869118,CSE 140,A01,083663,Gungor; Onat,13,0,85,72
1657197875165,CSE 140L,A01,083088,Eldon; John,17,0,100,83
1657197881194,CSE 175,A01,083665,Kumar; Rakesh,3,0,25,22
1657197887224,CSE 190,A00,092507,Dubnov; Shlomo,7,0,20,13
1657197893259,ECE 45,A01,083139,Congero; Spencer William,5,0,75,70
1657197899295,ECE 65,A50,083695,Saad; Andrew S,12,0,30,18
1657197899295,ECE 65,A51,095125,Saad; Andrew S,25,0,26,1
1657197905323,ECE 109,A01,091882,Touri; Behrouz,19,0,70,51
1657197911354,ECE 180,A00,083140,Abi Samra; Nicholas Camill,1,0,30,29
1657197911354,ECE 180,B00,083141,Abi Samra; Nicholas Camill,0,0,30,30
1657197917392,MATH 10A,A01,083735,Patchell; Gregory David,2,0,30,28
1657197917392,MATH 10A,A02,083736,Patchell; Gregory David,20,0,30,10
1657197917392,MATH 10A,A03,083737,Patchell; Gregory David,16,0,30,14
1657197923435,MATH 10B,A01,083207,Lim; Seonhee,7,0,34,27
1657197923435,MATH 10B,A02,083208,Lim; Seonhee,9,0,35,26
1657197923435,MATH 10B,A03,093472,Lim; Seonhee,5,0,34,29
1657197923435,MATH 10B,B01,083739,Sinha; Shubham,10,0,30,20
1657197929476,MATH 18,A01,083743,Cinel; Cameron Alexander,6,0,30,24
1657197929476,MATH 18,A02,083744,Cinel; Cameron Alexander,15,0,30,15
1657197929476,MATH 18,A03,083745,Cinel; Cameron Alexander,8,0,30,22
1657197929476,MATH 18,B01,083748,Rideout; David Porter,4,0,37,33
1657197929476,MATH 18,B02,083749,Rideout; David Porter,4,0,36,32
1657197929476,MATH 18,B03,083750,Rideout; David Porter,2,0,37,35
1657197929476,MATH 18,B04,083751,Rideout; David Porter,5,0,36,31
1657197929476,MATH 18,B05,093473,Rideout; David Porter,5,0,36,31
1657197929476,MATH 18,B06,093474,Rideout; David Porter,5,0,36,31
1657197935505,MATH 20A,A01,083754,Zheng; Zequn,13,0,40,27
1657197941543,MATH 20B,A01,083756,Briones; Jor-el Thomas Caparas,1,0,36,35
1657197941543,MATH 20B,A02,083757,Briones; Jor-el Thomas Caparas,1,0,36,35
1657197941543,MATH 20B,A03,093475,Briones; Jor-el Thomas Caparas,1,0,36,35
1657197947572,MATH 20C,A01,083760,Briones; Jor-el Thomas Caparas,1,0,35,34
1657197947572,MATH 20C,A02,083761,Briones; Jor-el Thomas Caparas,8,0,35,27
1657197947572,MATH 20C,A03,093476,Briones; Jor-el Thomas Caparas,0,1,36,36
1657197947572,MATH 20C,B01,083762,Bach; Quang Tran,1,0,30,29
1657197953599,MATH 20D,A01,083765,Tran; Brian Kha,4,0,30,26
1657197953599,MATH 20D,A02,083766,Tran; Brian Kha,5,0,30,25
1657197953599,MATH 20D,A03,083767,Tran; Brian Kha,4,0,30,26
1657197959632,MATH 20E,A01,083771,Ganguly; Soumya,7,0,32,25
1657197959632,MATH 20E,A02,083772,Ganguly; Soumya,7,0,32,25
1657197959632,MATH 20E,B01,083773,Ciotti; Benjamin,19,0,35,16
1657197959632,MATH 20E,B02,083774,Ciotti; Benjamin,17,0,35,18
1657197965668,MATH 103A,A01,083777,Greenfeld; Be'Eri,2,0,36,34
1657197965668,MATH 103A,A02,083778,Greenfeld; Be'Eri,5,0,36,31
1657197965668,MATH 103A,A03,093561,Greenfeld; Be'Eri,4,0,36,32
1657197965668,MATH 103A,B01,083779,Greenfeld; Be'Eri,6,0,36,30
1657197965668,MATH 103A,B02,083780,Greenfeld; Be'Eri,3,0,36,33
1657197965668,MATH 103A,B03,093562,Greenfeld; Be'Eri,3,0,36,33
1657197971706,MATH 105,A01,085443,Carter; Anne Toulson,14,0,35,21
1657197971706,MATH 105,A02,093477,Carter; Anne Toulson,20,0,35,15
1657197977746,MATH 109,A01,083213,Ganzberger; Geoffrey Michael,2,0,34,32
1657197977746,MATH 109,A02,083214,Ganzberger; Geoffrey Michael,4,0,34,30
1657197977746,MATH 109,A03,093478,Ganzberger; Geoffrey Michael,1,0,34,33
1657197977746,MATH 109,B01,083215,Ganzberger; Geoffrey Michael,1,0,32,31
1657197977746,MATH 109,B02,083216,Ganzberger; Geoffrey Michael,1,0,32,31
1657197977746,MATH 109,B03,093479,Ganzberger; Geoffrey Michael,7,0,32,25
1657197983774,MATH 142A,A01,083219,Chow; Bennett,6,0,32,26
1657197983774,MATH 142A,A02,083220,Chow; Bennett,10,0,32,22
1657197983774,MATH 142A,A03,093480,Chow; Bennett,7,0,32,25
1657197983774,MATH 142A,B03,093481,Chow; Bennett,8,0,32,24
1657197983774,MATH 142A,B04,093558,Chow; Bennett,11,0,32,21
1657197983774,MATH 142A,B05,093559,Chow; Bennett,6,0,32,26
1657197989801,MATH 193A,A01,083224,Rotar; Vladimir,7,0,34,27
1657197989801,MATH 193A,A02,083225,Rotar; Vladimir,5,0,34,29
1657197989801,MATH 193A,A03,083781,Rotar; Vladimir,1,0,34,33
1657197989801,MATH 193A,A04,083782,Rotar; Vladimir,8,0,34,26
1657197989801,MATH 193A,A05,093482,Rotar; Vladimir,6,0,34,28
1657197995830,MATH 197,001,091859,McAuley; Julian John,9999,0,9999,0
1657197995830,MATH 197,002,095566,Kedlaya; Kiran S.,9997,0,9999,2
1657197995830,MATH 197,003,095567,Xiao; Ming,9999,0,9999,0
1657197995830,MATH 197,004,095571,Perols; Johan Lars,9998,0,9999,1
1657198002924,COGS 9,A01,083615,Shannon; Kyle Michael,7,0,75,68
1657198008952,COGS 11,A01,083617,Boyle; Mary E. T.,22,0,48,26
1657198014981,COGS 13,A01,083071,Bastos; Amalia Pinkusfeld,9,0,71,62
1657198021007,COGS 14A,A01,092681,Semenuks; Arturs,1,1,100,99
1657198027032,COGS 14B,A01,083073,Cheng; Tzu-Han,6,0,63,57
1657198033060,COGS 17,A01,092677,Semenuks; Arturs,4,0,81,77
1657198039086,COGS 100,A01,083619,Allen; Michael Gordon,15,0,70,55
1657198045115,COGS 101A,A01,083621,Davis; Joshua Daniel,9,0,68,59
1657198051143,COGS 101B,A01,091572,Allen; Michael Gordon,9,0,65,56
1657198057180,COGS 101C,A01,083625,Delgado; Tania,17,0,35,18
1657198063207,COGS 107A,A01,083627,Boyle; Mary E. T.,13,0,60,47
1657198069231,COGS 118A,A01,083075,Gupta; Anjum,16,0,76,60
1657198075260,CSE 3,A50,083646,Miranda; Gregory Joseph,24,0,50,26
1657198081290,CSE 8A,A50,083650,Miranda; Gregory Joseph,17,1,56,39
1657198087316,CSE 11,A01,083080,Cao; Yingjun,5,15,40,35
1657198093356,CSE 12,A01,083652,Krause-Levy; Sophia Louisa,24,1,120,96
1657198099381,CSE 15L,A01,083654,Morris; Justin Loren,9,0,50,41
1657198099381,CSE 15L,A02,083655,Morris; Justin Loren,9,0,50,41
1657198105410,CSE 20,A01,083657,Tran; Khoa Dang,38,0,80,42
1657198111438,CSE 21,A01,095574,Bach; Quang Tran,22,0,48,26
1657198117469,CSE 30,A01,083084,Eldon; John,4,0,80,76
1657198117469,CSE 30,B01,095061,Bhaskar; Nishant,7,0,50,43
1657198123493,CSE 100,A01,083659,Cao; Yingjun,4,4,70,66
1657198129519,CSE 134B,A01,083661,Powell; Thomas Allan,20,0,100,80
1657198135546,CSE 140,A01,083663,Gungor; Onat,13,0,85,72
1657198141574,CSE 140L,A01,083088,Eldon; John,17,0,100,83
1657198147599,CSE 175,A01,083665,Kumar; Rakesh,3,0,25,22
1657198153626,CSE 190,A00,092507,Dubnov; Shlomo,7,0,20,13
1657198159667,ECE 45,A01,083139,Congero; Spencer William,5,0,75,70
1657198165694,ECE 65,A50,083695,Saad; Andrew S,12,0,30,18
1657198165694,ECE 65,A51,095125,Saad; Andrew S,25,0,26,1
1657198171721,ECE 109,A01,091882,Touri; Behrouz,19,0,70,51
1657198177754,ECE 180,A00,083140,Abi Samra; Nicholas Camill,1,0,30,29
1657198177754,ECE 180,B00,083141,Abi Samra; Nicholas Camill,0,0,30,30
1657198183781,MATH 10A,A01,083735,Patchell; Gregory David,2,0,30,28
1657198183781,MATH 10A,A02,083736,Patchell; Gregory David,20,0,30,10
1657198183781,MATH 10A,A03,083737,Patchell; Gregory David,16,0,30,14
1657198189819,MATH 10B,A01,083207,Lim; Seonhee,7,0,34,27
1657198189819,MATH 10B,A02,083208,Lim; Seonhee,9,0,35,26
1657198189819,MATH 10B,A03,093472,Lim; Seonhee,5,0,34,29
1657198189819,MATH 10B,B01,083739,Sinha; Shubham,10,0,30,20
1657198195862,MATH 18,A01,083743,Cinel; Cameron Alexander,6,0,30,24
1657198195862,MATH 18,A02,083744,Cinel; Cameron Alexander,15,0,30,15
1657198195862,MATH 18,A03,083745,Cinel; Cameron Alexander,8,0,30,22
1657198195862,MATH 18,B01,083748,Rideout; David Porter,4,0,37,33
1657198195862,MATH 18,B02,083749,Rideout; David Porter,4,0,36,32
1657198195862,MATH 18,B03,083750,Rideout; David Porter,2,0,37,35
1657198195862,MATH 18,B04,083751,Rideout; David Porter,5,0,36,31
1657198195862,MATH 18,B05,093473,Rideout; David Porter,5,0,36,31
1657198195862,MATH 18,B06,093474,Rideout; David Porter,5,0,36,31
1657198201892,MATH 20A,A01,083754,Zheng; Zequn,13,0,40,27
1657198207919,MATH 20B,A01,083756,Briones; Jor-el Thomas Caparas,1,0,36,35
1657198207919,MATH 20B,A02,083757,Briones; Jor-el Thomas Caparas,1,0,36,35
1657198207919,MATH 20B,A03,093475,Briones; Jor-el Thomas Caparas,1,0,36,35
1657198213948,MATH 20C,A01,083760,Briones; Jor-el Thomas Caparas,1,0,35,34
1657198213948,MATH 20C,A02,083761,Briones; Jor-el Thomas Caparas,8,0,35,27
1657198213948,MATH 20C,A03,093476,Briones; Jor-el Thomas Caparas,0,1,36,36
1657198213948,MATH 20C,B01,083762,Bach; Quang Tran,1,0,30,29
1657198219983,MATH 20D,A01,083765,Tran; Brian Kha,4,0,30,26
1657198219983,MATH 20D,A02,083766,Tran; Brian Kha,5,0,30,25
1657198219983,MATH 20D,A03,083767,Tran; Brian Kha,4,0,30,26
1657198226031,MATH 20E,A01,083771,Ganguly; Soumya,7,0,32,25
1657198226031,MATH 20E,A02,083772,Ganguly; Soumya,7,0,32,25
1657198226031,MATH 20E,B01,083773,Ciotti; Benjamin,19,0,35,16
1657198226031,MATH 20E,B02,083774,Ciotti; Benjamin,17,0,35,18
1657198232068,MATH 103A,A01,083777,Greenfeld; Be'Eri,2,0,36,34
1657198232068,MATH 103A,A02,083778,Greenfeld; Be'Eri,5,0,36,31
1657198232068,MATH 103A,A03,093561,Greenfeld; Be'Eri,4,0,36,32
1657198232068,MATH 103A,B01,083779,Greenfeld; Be'Eri,6,0,36,30
1657198232068,MATH 103A,B02,083780,Greenfeld; Be'Eri,3,0,36,33
1657198232068,MATH 103A,B03,093562,Greenfeld; Be'Eri,3,0,36,33
1657198238097,MATH 105,A01,085443,Carter; Anne Toulson,14,0,35,21
1657198238097,MATH 105,A02,093477,Carter; Anne Toulson,20,0,35,15
1657198244137,MATH 109,A01,083213,Ganzberger; Geoffrey Michael,2,0,34,32
1657198244137,MATH 109,A02,083214,Ganzberger; Geoffrey Michael,4,0,34,30
1657198244137,MATH 109,A03,093478,Ganzberger; Geoffrey Michael,1,0,34,33
1657198244137,MATH 109,B01,083215,Ganzberger; Geoffrey Michael,1,0,32,31
1657198244137,MATH 109,B02,083216,Ganzberger; Geoffrey Michael,1,0,32,31
1657198244137,MATH 109,B03,093479,Ganzberger; Geoffrey Michael,7,0,32,25
1657198250165,MATH 142A,A01,083219,Chow; Bennett,6,0,32,26
1657198250165,MATH 142A,A02,083220,Chow; Bennett,10,0,32,22
1657198250165,MATH 142A,A03,093480,Chow; Bennett,7,0,32,25
1657198250165,MATH 142A,B03,093481,Chow; Bennett,8,0,32,24
1657198250165,MATH 142A,B04,093558,Chow; Bennett,11,0,32,21
1657198250165,MATH 142A,B05,093559,Chow; Bennett,6,0,32,26
1657198256191,MATH 193A,A01,083224,Rotar; Vladimir,7,0,34,27
1657198256191,MATH 193A,A02,083225,Rotar; Vladimir,5,0,34,29
1657198256191,MATH 193A,A03,083781,Rotar; Vladimir,1,0,34,33
1657198256191,MATH 193A,A04,083782,Rotar; Vladimir,8,0,34,26
1657198256191,MATH 193A,A05,093482,Rotar; Vladimir,6,0,34,28
1657198262220,MATH 197,001,091859,McAuley; Julian John,9999,0,9999,0
1657198262220,MATH 197,002,095566,Kedlaya; Kiran S.,9997,0,9999,2
1657198262220,MATH 197,003,095567,Xiao; Ming,9999,0,9999,0
1657198262220,MATH 197,004,095571,Perols; Johan Lars,9998,0,9999,1
1657198269299,COGS 9,A01,083615,Shannon; Kyle Michael,7,0,75,68
1657198275325,COGS 11,A01,083617,Boyle; Mary E. T.,22,0,48,26
1657198281352,COGS 13,A01,083071,Bastos; Amalia Pinkusfeld,9,0,71,62
1657198287382,COGS 14A,A01,092681,Semenuks; Arturs,1,1,100,99
1657198293413,COGS 14B,A01,083073,Cheng; Tzu-Han,6,0,63,57
1657198299512,COGS 17,A01,092677,Semenuks; Arturs,4,0,81,77
1657198305545,COGS 100,A01,083619,Allen; Michael Gordon,15,0,70,55
1657198311570,COGS 101A,A01,083621,Davis; Joshua Daniel,9,0,68,59
1657198317595,COGS 101B,A01,091572,Allen; Michael Gordon,9,0,65,56
1657198323627,COGS 101C,A01,083625,Delgado; Tania,17,0,35,18
1657198329654,COGS 107A,A01,083627,Boyle; Mary E. T.,13,0,60,47
1657198335683,COGS 118A,A01,083075,Gupta; Anjum,16,0,76,60
1657198341707,CSE 3,A50,083646,Miranda; Gregory Joseph,24,0,50,26
1657198347737,CSE 8A,A50,083650,Miranda; Gregory Joseph,17,1,56,39
1657198353767,CSE 11,A01,083080,Cao; Yingjun,5,15,40,35
1657198359801,CSE 12,A01,083652,Krause-Levy; Sophia Louisa,24,1,120,96
1657198365829,CSE 15L,A01,083654,Morris; Justin Loren,9,0,50,41
1657198365829,CSE 15L,A02,083655,Morris; Justin Loren,9,0,50,41
1657198371859,CSE 20,A01,083657,Tran; Khoa Dang,38,0,80,42
1657198377892,CSE 21,A01,095574,Bach; Quang Tran,22,0,48,26
1657198383920,CSE 30,A01,083084,Eldon; John,4,0,80,76
1657198383920,CSE 30,B01,095061,Bhaskar; Nishant,7,0,50,43
1657198389947,CSE 100,A01,083659,Cao; Yingjun,4,4,70,66
1657198395976,CSE 134B,A01,083661,Powell; Thomas Allan,20,0,100,80
1657198402003,CSE 140,A01,083663,Gungor; Onat,13,0,85,72
1657198408039,CSE 140L,A01,083088,Eldon; John,17,0,100,83
1657198414075,CSE 175,A01,083665,Kumar; Rakesh,3,0,25,22
1657198420100,CSE 190,A00,092507,Dubnov; Shlomo,7,0,20,13
1657198426130,ECE 45,A01,083139,Congero; Spencer William,5,0,75,70
1657198432159,ECE 65,A50,083695,Saad; Andrew S,12,0,30,18
1657198432159,ECE 65,A51,095125,Saad; Andrew S,25,0,26,1
1657198438184,ECE 109,A01,091882,Touri; Behrouz,19,0,70,51
1657198444216,ECE 180,A00,083140,Abi Samra; Nicholas Camill,1,0,30,29
1657198444216,ECE 180,B00,083141,Abi Samra; Nicholas Camill,0,0,30,30
1657198450245,MATH 10A,A01,083735,Patchell; Gregory David,2,0,30,28
1657198450245,MATH 10A,A02,083736,Patchell; Gregory David,20,0,30,10
1657198450245,MATH 10A,A03,083737,Patchell; Gregory David,16,0,30,14
1657198456274,MATH 10B,A01,083207,Lim; Seonhee,7,0,34,27
1657198456274,MATH 10B,A02,083208,Lim; Seonhee,9,0,35,26
1657198456274,MATH 10B,A03,093472,Lim; Seonhee,5,0,34,29
1657198456274,MATH 10B,B01,083739,Sinha; Shubham,10,0,30,20
1657198462308,MATH 18,A01,083743,Cinel; Cameron Alexander,6,0,30,24
1657198462308,MATH 18,A02,083744,Cinel; Cameron Alexander,15,0,30,15
1657198462308,MATH 18,A03,083745,Cinel; Cameron Alexander,8,0,30,22
1657198462308,MATH 18,B01,083748,Rideout; David Porter,4,0,37,33
1657198462308,MATH 18,B02,083749,Rideout; David Porter,4,0,36,32
1657198462308,MATH 18,B03,083750,Rideout; David Porter,2,0,37,35
1657198462308,MATH 18,B04,083751,Rideout; David Porter,5,0,36,31
1657198462308,MATH 18,B05,093473,Rideout; David Porter,5,0,36,31
1657198462308,MATH 18,B06,093474,Rideout; David Porter,5,0,36,31
1657198468333,MATH 20A,A01,083754,Zheng; Zequn,13,0,40,27
1657198474363,MATH 20B,A01,083756,Briones; Jor-el Thomas Caparas,1,0,36,35
1657198474363,MATH 20B,A02,083757,Briones; Jor-el Thomas Caparas,1,0,36,35
1657198474363,MATH 20B,A03,093475,Briones; Jor-el Thomas Caparas,1,0,36,35
1657198480400,MATH 20C,A01,083760,Briones; Jor-el Thomas Caparas,1,0,35,34
1657198480400,MATH 20C,A02,083761,Briones; Jor-el Thomas Caparas,8,0,35,27
1657198480400,MATH 20C,A03,093476,Briones; Jor-el Thomas Caparas,0,1,36,36
1657198480400,MATH 20C,B01,083762,Bach; Quang Tran,1,0,30,29
1657198486431,MATH 20D,A01,083765,Tran; Brian Kha,4,0,30,26
1657198486431,MATH 20D,A02,083766,Tran; Brian Kha,5,0,30,25
1657198486431,MATH 20D,A03,083767,Tran; Brian Kha,4,0,30,26
1657198492474,MATH 20E,A01,083771,Ganguly; Soumya,7,0,32,25
1657198492474,MATH 20E,A02,083772,Ganguly; Soumya,7,0,32,25
1657198492474,MATH 20E,B01,083773,Ciotti; Benjamin,19,0,35,16
1657198492474,MATH 20E,B02,083774,Ciotti; Benjamin,17,0,35,18
1657198498507,MATH 103A,A01,083777,Greenfeld; Be'Eri,2,0,36,34
1657198498507,MATH 103A,A02,083778,Greenfeld; Be'Eri,5,0,36,31
1657198498507,MATH 103A,A03,093561,Greenfeld; Be'Eri,4,0,36,32
1657198498507,MATH 103A,B01,083779,Greenfeld; Be'Eri,6,0,36,30
1657198498507,MATH 103A,B02,083780,Greenfeld; Be'Eri,3,0,36,33
1657198498507,MATH 103A,B03,093562,Greenfeld; Be'Eri,3,0,36,33
1657198504541,MATH 105,A01,085443,Carter; Anne Toulson,14,0,35,21
1657198504541,MATH 105,A02,093477,Carter; Anne Toulson,20,0,35,15
1657198510574,MATH 109,A01,083213,Ganzberger; Geoffrey Michael,2,0,34,32
1657198510574,MATH 109,A02,083214,Ganzberger; Geoffrey Michael,4,0,34,30
1657198510574,MATH 109,A03,093478,Ganzberger; Geoffrey Michael,1,0,34,33
1657198510574,MATH 109,B01,083215,Ganzberger; Geoffrey Michael,1,0,32,31
1657198510574,MATH 109,B02,083216,Ganzberger; Geoffrey Michael,1,0,32,31
1657198510574,MATH 109,B03,093479,Ganzberger; Geoffrey Michael,7,0,32,25
1657198516604,MATH 142A,A01,083219,Chow; Bennett,6,0,32,26
1657198516604,MATH 142A,A02,083220,Chow; Bennett,10,0,32,22
1657198516604,MATH 142A,A03,093480,Chow; Bennett,7,0,32,25
1657198516604,MATH 142A,B03,093481,Chow; Bennett,8,0,32,24
1657198516604,MATH 142A,B04,093558,Chow; Bennett,11,0,32,21
1657198516604,MATH 142A,B05,093559,Chow; Bennett,6,0,32,26
1657198522631,MATH 193A,A01,083224,Rotar; Vladimir,7,0,34,27
1657198522631,MATH 193A,A02,083225,Rotar; Vladimir,5,0,34,29
1657198522631,MATH 193A,A03,083781,Rotar; Vladimir,1,0,34,33
1657198522631,MATH 193A,A04,083782,Rotar; Vladimir,8,0,34,26
1657198522631,MATH 193A,A05,093482,Rotar; Vladimir,6,0,34,28
1657198528662,MATH 197,001,091859,McAuley; Julian John,9999,0,9999,0
1657198528662,MATH 197,002,095566,Kedlaya; Kiran S.,9997,0,9999,2
1657198528662,MATH 197,003,095567,Xiao; Ming,9999,0,9999,0
1657198528662,MATH 197,004,095571,Perols; Johan Lars,9998,0,9999,1
1657198535749,COGS 9,A01,083615,Shannon; Kyle Michael,7,0,75,68
1657198541777,COGS 11,A01,083617,Boyle; Mary E. T.,22,0,48,26
1657198547803,COGS 13,A01,083071,Bastos; Amalia Pinkusfeld,9,0,71,62
1657198553832,COGS 14A,A01,092681,Semenuks; Arturs,1,1,100,99
1657198559858,COGS 14B,A01,083073,Cheng; Tzu-Han,6,0,63,57
1657198565883,COGS 17,A01,092677,Semenuks; Arturs,4,0,81,77
1657198571912,COGS 100,A01,083619,Allen; Michael Gordon,15,0,70,55
1657198577943,COGS 101A,A01,083621,Davis; Joshua Daniel,9,0,68,59
1657198583972,COGS 101B,A01,091572,Allen; Michael Gordon,9,0,65,56
1657198589999,COGS 101C,A01,083625,Delgado; Tania,17,0,35,18
1657198596027,COGS 107A,A01,083627,Boyle; Mary E. T.,13,0,60,47
1657198602054,COGS 118A,A01,083075,Gupta; Anjum,16,0,76,60
1657198608080,CSE 3,A50,083646,Miranda; Gregory Joseph,24,0,50,26
1657198614105,CSE 8A,A50,083650,Miranda; Gregory Joseph,17,1,56,39
1657198620135,CSE 11,A01,083080,Cao; Yingjun,5,15,40,35
1657198626170,CSE 12,A01,083652,Krause-Levy; Sophia Louisa,24,1,120,96
1657198632196,CSE 15L,A01,083654,Morris; Justin Loren,9,0,50,41
1657198632196,CSE 15L,A02,083655,Morris; Justin Loren,9,0,50,41
1657198638221,CSE 20,A01,083657,Tran; Khoa Dang,38,0,80,42
1657198644250,CSE 21,A01,095574,Bach; Quang Tran,22,0,48,26
1657198650285,CSE 30,A01,083084,Eldon; John,4,0,80,76
1657198650285,CSE 30,B01,095061,Bhaskar; Nishant,7,0,50,43
1657198656313,CSE 100,A01,083659,Cao; Yingjun,4,4,70,66
1657198662347,CSE 134B,A01,083661,Powell; Thomas Allan,20,0,100,80
1657198668374,CSE 140,A01,083663,Gungor; Onat,13,0,85,72
1657198674400,CSE 140L,A01,083088,Eldon; John,17,0,100,83
1657198680424,CSE 175,A01,083665,Kumar; Rakesh,3,0,25,22
1657198686453,CSE 190,A00,092507,Dubnov; Shlomo,7,0,20,13
1657198692483,ECE 45,A01,083139,Congero; Spencer William,5,0,75,70
1657198698518,ECE 65,A50,083695,Saad; Andrew S,12,0,30,18
1657198698518,ECE 65,A51,095125,Saad; Andrew S,25,0,26,1
1657198704543,ECE 109,A01,091882,Touri; Behrouz,19,0,70,51
1657198710569,ECE 180,A00,083140,Abi Samra; Nicholas Camill,1,0,30,29
1657198710569,ECE 180,B00,083141,Abi Samra; Nicholas Camill,0,0,30,30
1657198716602,MATH 10A,A01,083735,Patchell; Gregory David,2,0,30,28
1657198716602,MATH 10A,A02,083736,Patchell; Gregory David,20,0,30,10
1657198716602,MATH 10A,A03,083737,Patchell; Gregory David,16,0,30,14
1657198722641,MATH 10B,A01,083207,Lim; Seonhee,7,0,34,27
1657198722641,MATH 10B,A02,083208,Lim; Seonhee,9,0,35,26
1657198722641,MATH 10B,A03,093472,Lim; Seonhee,5,0,34,29
1657198722641,MATH 10B,B01,083739,Sinha; Shubham,10,0,30,20
1657198728668,MATH 18,A01,083743,Cinel; Cameron Alexander,6,0,30,24
1657198728668,MATH 18,A02,083744,Cinel; Cameron Alexander,15,0,30,15
1657198728668,MATH 18,A03,083745,Cinel; Cameron Alexander,8,0,30,22
1657198728668,MATH 18,B01,083748,Rideout; David Porter,4,0,37,33
1657198728668,MATH 18,B02,083749,Rideout; David Porter,4,0,36,32
1657198728668,MATH 18,B03,083750,Rideout; David Porter,2,0,37,35
1657198728668,MATH 18,B04,083751,Rideout; David Porter,5,0,36,31
1657198728668,MATH 18,B05,093473,Rideout; David Porter,5,0,36,31
1657198728668,MATH 18,B06,093474,Rideout; David Porter,5,0,36,31
1657198734694,MATH 20A,A01,083754,Zheng; Zequn,13,0,40,27
1657198740724,MATH 20B,A01,083756,Briones; Jor-el Thomas Caparas,1,0,36,35
1657198740724,MATH 20B,A02,083757,Briones; Jor-el Thomas Caparas,1,0,36,35
1657198740724,MATH 20B,A03,093475,Briones; Jor-el Thomas Caparas,1,0,36,35
1657198746757,MATH 20C,A01,083760,Briones; Jor-el Thomas Caparas,1,0,35,34
1657198746757,MATH 20C,A02,083761,Briones; Jor-el Thomas Caparas,8,0,35,27
1657198746757,MATH 20C,A03,093476,Briones; Jor-el Thomas Caparas,0,1,36,36
1657198746757,MATH 20C,B01,083762,Bach; Quang Tran,1,0,30,29
1657198752787,MATH 20D,A01,083765,Tran; Brian Kha,4,0,30,26
1657198752787,MATH 20D,A02,083766,Tran; Brian Kha,5,0,30,25
1657198752787,MATH 20D,A03,083767,Tran; Brian Kha,4,0,30,26
1657198758824,MATH 20E,A01,083771,Ganguly; Soumya,7,0,32,25
1657198758824,MATH 20E,A02,083772,Ganguly; Soumya,7,0,32,25
1657198758824,MATH 20E,B01,083773,Ciotti; Benjamin,19,0,35,16
1657198758824,MATH 20E,B02,083774,Ciotti; Benjamin,17,0,35,18
1657198764857,MATH 103A,A01,083777,Greenfeld; Be'Eri,2,0,36,34
1657198764857,MATH 103A,A02,083778,Greenfeld; Be'Eri,5,0,36,31
1657198764857,MATH 103A,A03,093561,Greenfeld; Be'Eri,4,0,36,32
1657198764857,MATH 103A,B01,083779,Greenfeld; Be'Eri,6,0,36,30
1657198764857,MATH 103A,B02,083780,Greenfeld; Be'Eri,3,0,36,33
1657198764857,MATH 103A,B03,093562,Greenfeld; Be'Eri,3,0,36,33
1657198770889,MATH 105,A01,085443,Carter; Anne Toulson,14,0,35,21
1657198770889,MATH 105,A02,093477,Carter; Anne Toulson,20,0,35,15
1657198776916,MATH 109,A01,083213,Ganzberger; Geoffrey Michael,2,0,34,32
1657198776916,MATH 109,A02,083214,Ganzberger; Geoffrey Michael,4,0,34,30
1657198776916,MATH 109,A03,093478,Ganzberger; Geoffrey Michael,1,0,34,33
1657198776916,MATH 109,B01,083215,Ganzberger; Geoffrey Michael,1,0,32,31
1657198776916,MATH 109,B02,083216,Ganzberger; Geoffrey Michael,1,0,32,31
1657198776916,MATH 109,B03,093479,Ganzberger; Geoffrey Michael,7,0,32,25
1657198782944,MATH 142A,A01,083219,Chow; Bennett,6,0,32,26
1657198782944,MATH 142A,A02,083220,Chow; Bennett,10,0,32,22
1657198782944,MATH 142A,A03,093480,Chow; Bennett,7,0,32,25
1657198782944,MATH 142A,B03,093481,Chow; Bennett,8,0,32,24
1657198782944,MATH 142A,B04,093558,Chow; Bennett,11,0,32,21
1657198782944,MATH 142A,B05,093559,Chow; Bennett,6,0,32,26
1657198788969,MATH 193A,A01,083224,Rotar; Vladimir,7,0,34,27
1657198788969,MATH 193A,A02,083225,Rotar; Vladimir,5,0,34,29
1657198788969,MATH 193A,A03,083781,Rotar; Vladimir,1,0,34,33
1657198788969,MATH 193A,A04,083782,Rotar; Vladimir,8,0,34,26
1657198788969,MATH 193A,A05,093482,Rotar; Vladimir,6,0,34,28
1657198794996,MATH 197,001,091859,McAuley; Julian John,9999,0,9999,0
1657198794996,MATH 197,002,095566,Kedlaya; Kiran S.,9997,0,9999,2
1657198794996,MATH 197,003,095567,Xiao; Ming,9999,0,9999,0
1657198794996,MATH 197,004,095571,Perols; Johan Lars,9998,0,9999,1
1657198802070,COGS 9,A01,083615,Shannon; Kyle Michael,7,0,75,68
1657198808103,COGS 11,A01,083617,Boyle; Mary E. T.,22,0,48,26
1657198814140,COGS 13,A01,083071,Bastos; Amalia Pinkusfeld,9,0,71,62
1657198820165,COGS 14A,A01,092681,Semenuks; Arturs,1,1,100,99
1657198826189,COGS 14B,A01,083073,Cheng; Tzu-Han,6,0,63,57
1657198832215,COGS 17,A01,092677,Semenuks; Arturs,4,0,81,77
1657198838247,COGS 100,A01,083619,Allen; Michael Gordon,15,0,70,55
1657198844279,COGS 101A,A01,083621,Davis; Joshua Daniel,9,0,68,59
1657198850305,COGS 101B,A01,091572,Allen; Michael Gordon,9,0,65,56
1657198856335,COGS 101C,A01,083625,Delgado; Tania,17,0,35,18
1657198862362,COGS 107A,A01,083627,Boyle; Mary E. T.,13,0,60,47
1657198868386,COGS 118A,A01,083075,Gupta; Anjum,16,0,76,60
1657198874420,CSE 3,A50,083646,Miranda; Gregory Joseph,24,0,50,26
1657198880449,CSE 8A,A50,083650,Miranda; Gregory Joseph,17,1,56,39
1657198886481,CSE 11,A01,083080,Cao; Yingjun,5,15,40,35
1657198892508,CSE 12,A01,083652,Krause-Levy; Sophia Louisa,24,1,120,96
1657198898607,CSE 15L,A01,083654,Morris; Justin Loren,9,0,50,41
1657198898607,CSE 15L,A02,083655,Morris; Justin Loren,9,0,50,41
1657198904633,CSE 20,A01,083657,Tran; Khoa Dang,38,0,80,42
1657198910662,CSE 21,A01,095574,Bach; Quang Tran,22,0,48,26
1657198916688,CSE 30,A01,083084,Eldon; John,4,0,80,76
1657198916688,CSE 30,B01,095061,Bhaskar; Nishant,7,0,50,43
1657198922713,CSE 100,A01,083659,Cao; Yingjun,4,4,70,66
1657198928738,CSE 134B,A01,083661,Powell; Thomas Allan,20,0,100,80
1657198934765,CSE 140,A01,083663,Gungor; Onat,13,0,85,72
1657198940792,CSE 140L,A01,083088,Eldon; John,17,0,100,83
1657198946822,CSE 175,A01,083665,Kumar; Rakesh,3,0,25,22
1657198952850,CSE 190,A00,092507,Dubnov; Shlomo,7,0,20,13
1657198958883,ECE 45,A01,083139,Congero; Spencer William,5,0,75,70
1657198964910,ECE 65,A50,083695,Saad; Andrew S,12,0,30,18
1657198964910,ECE 65,A51,095125,Saad; Andrew S,25,0,26,1
1657198970939,ECE 109,A01,091882,Touri; Behrouz,19,0,70,51
1657198976964,ECE 180,A00,083140,Abi Samra; Nicholas Camill,1,0,30,29
1657198976964,ECE 180,B00,083141,Abi Samra; Nicholas Camill,0,0,30,30
1657198982999,MATH 10A,A01,083735,Patchell; Gregory David,2,0,30,28
1657198982999,MATH 10A,A02,083736,Patchell; Gregory David,20,0,30,10
1657198982999,MATH 10A,A03,083737,Patchell; Gregory David,16,0,30,14
1657198989028,MATH 10B,A01,083207,Lim; Seonhee,7,0,34,27
1657198989028,MATH 10B,A02,083208,Lim; Seonhee,9,0,35,26
1657198989028,MATH 10B,A03,093472,Lim; Seonhee,5,0,34,29
1657198989028,MATH 10B,B01,083739,Sinha; Shubham,10,0,30,20
1657198995059,MATH 18,A01,083743,Cinel; Cameron Alexander,6,0,30,24
1657198995059,MATH 18,A02,083744,Cinel; Cameron Alexander,15,0,30,15
1657198995059,MATH 18,A03,083745,Cinel; Cameron Alexander,8,0,30,22
1657198995059,MATH 18,B01,083748,Rideout; David Porter,4,0,37,33
1657198995059,MATH 18,B02,083749,Rideout; David Porter,4,0,36,32
1657198995059,MATH 18,B03,083750,Rideout; David Porter,2,0,37,35
1657198995059,MATH 18,B04,083751,Rideout; David Porter,5,0,36,31
1657198995059,MATH 18,B05,093473,Rideout; David Porter,5,0,36,31
1657198995059,MATH 18,B06,093474,Rideout; David Porter,5,0,36,31
1657199001084,MATH 20A,A01,083754,Zheng; Zequn,13,0,40,27
1657199007112,MATH 20B,A01,083756,Briones; Jor-el Thomas Caparas,1,0,36,35
1657199007112,MATH 20B,A02,083757,Briones; Jor-el Thomas Caparas,1,0,36,35
1657199007112,MATH 20B,A03,093475,Briones; Jor-el Thomas Caparas,1,0,36,35
1657199013137,MATH 20C,A01,083760,Briones; Jor-el Thomas Caparas,1,0,35,34
1657199013137,MATH 20C,A02,083761,Briones; Jor-el Thomas Caparas,8,0,35,27
1657199013137,MATH 20C,A03,093476,Briones; Jor-el Thomas Caparas,0,1,36,36
1657199013137,MATH 20C,B01,083762,Bach; Quang Tran,1,0,30,29
1657199019171,MATH 20D,A01,083765,Tran; Brian Kha,4,0,30,26
1657199019171,MATH 20D,A02,083766,Tran; Brian Kha,5,0,30,25
1657199019171,MATH 20D,A03,083767,Tran; Brian Kha,4,0,30,26
1657199025208,MATH 20E,A01,083771,Ganguly; Soumya,7,0,32,25
1657199025208,MATH 20E,A02,083772,Ganguly; Soumya,7,0,32,25
1657199025208,MATH 20E,B01,083773,Ciotti; Benjamin,19,0,35,16
1657199025208,MATH 20E,B02,083774,Ciotti; Benjamin,17,0,35,18
1657199031236,MATH 103A,A01,083777,Greenfeld; Be'Eri,2,0,36,34
1657199031236,MATH 103A,A02,083778,Greenfeld; Be'Eri,5,0,36,31
1657199031236,MATH 103A,A03,093561,Greenfeld; Be'Eri,4,0,36,32
1657199031236,MATH 103A,B01,083779,Greenfeld; Be'Eri,6,0,36,30
1657199031236,MATH 103A,B02,083780,Greenfeld; Be'Eri,3,0,36,33
1657199031236,MATH 103A,B03,093562,Greenfeld; Be'Eri,3,0,36,33
1657199037267,MATH 105,A01,085443,Carter; Anne Toulson,14,0,35,21
1657199037267,MATH 105,A02,093477,Carter; Anne Toulson,20,0,35,15
1657199043295,MATH 109,A01,083213,Ganzberger; Geoffrey Michael,2,0,34,32
1657199043295,MATH 109,A02,083214,Ganzberger; Geoffrey Michael,4,0,34,30
1657199043295,MATH 109,A03,093478,Ganzberger; Geoffrey Michael,1,0,34,33
1657199043295,MATH 109,B01,083215,Ganzberger; Geoffrey Michael,1,0,32,31
1657199043295,MATH 109,B02,083216,Ganzberger; Geoffrey Michael,1,0,32,31
1657199043295,MATH 109,B03,093479,Ganzberger; Geoffrey Michael,7,0,32,25
1657199049332,MATH 142A,A01,083219,Chow; Bennett,6,0,32,26
1657199049332,MATH 142A,A02,083220,Chow; Bennett,10,0,32,22
1657199049332,MATH 142A,A03,093480,Chow; Bennett,7,0,32,25
1657199049332,MATH 142A,B03,093481,Chow; Bennett,8,0,32,24
1657199049332,MATH 142A,B04,093558,Chow; Bennett,11,0,32,21
1657199049332,MATH 142A,B05,093559,Chow; Bennett,6,0,32,26
1657199055360,MATH 193A,A01,083224,Rotar; Vladimir,7,0,34,27
1657199055360,MATH 193A,A02,083225,Rotar; Vladimir,5,0,34,29
1657199055360,MATH 193A,A03,083781,Rotar; Vladimir,1,0,34,33
1657199055360,MATH 193A,A04,083782,Rotar; Vladimir,8,0,34,26
1657199055360,MATH 193A,A05,093482,Rotar; Vladimir,6,0,34,28
1657199061391,MATH 197,001,091859,McAuley; Julian John,9999,0,9999,0
1657199061391,MATH 197,002,095566,Kedlaya; Kiran S.,9997,0,9999,2
1657199061391,MATH 197,003,095567,Xiao; Ming,9999,0,9999,0
1657199061391,MATH 197,004,095571,Perols; Johan Lars,9998,0,9999,1
1657199068466,COGS 9,A01,083615,Shannon; Kyle Michael,7,0,75,68
1657199074491,COGS 11,A01,083617,Boyle; Mary E. T.,22,0,48,26
1657199080532,COGS 13,A01,083071,Bastos; Amalia Pinkusfeld,9,0,71,62
1657199086567,COGS 14A,A01,092681,Semenuks; Arturs,1,1,100,99
1657199092599,COGS 14B,A01,083073,Cheng; Tzu-Han,6,0,63,57
1657199098622,COGS 17,A01,092677,Semenuks; Arturs,4,0,81,77
1657199104655,COGS 100,A01,083619,Allen; Michael Gordon,15,0,70,55
1657199110680,COGS 101A,A01,083621,Davis; Joshua Daniel,9,0,68,59
1657199116706,COGS 101B,A01,091572,Allen; Michael Gordon,9,0,65,56
1657199122733,COGS 101C,A01,083625,Delgado; Tania,17,0,35,18
1657199128760,COGS 107A,A01,083627,Boyle; Mary E. T.,13,0,60,47
1657199134782,COGS 118A,A01,083075,Gupta; Anjum,16,0,76,60
1657199140813,CSE 3,A50,083646,Miranda; Gregory Joseph,24,0,50,26
1657199146843,CSE 8A,A50,083650,Miranda; Gregory Joseph,17,1,56,39
1657199152866,CSE 11,A01,083080,Cao; Yingjun,5,15,40,35
1657199158895,CSE 12,A01,083652,Krause-Levy; Sophia Louisa,24,1,120,96
1657199164922,CSE 15L,A01,083654,Morris; Justin Loren,9,0,50,41
1657199164922,CSE 15L,A02,083655,Morris; Justin Loren,9,0,50,41
1657199170949,CSE 20,A01,083657,Tran; Khoa Dang,38,0,80,42
1657199176981,CSE 21,A01,095574,Bach; Quang Tran,22,0,48,26
1657199183016,CSE 30,A01,083084,Eldon; John,4,0,80,76
1657199183016,CSE 30,B01,095061,Bhaskar; Nishant,7,0,50,43
1657199189052,CSE 100,A01,083659,Cao; Yingjun,4,4,70,66
1657199195077,CSE 134B,A01,083661,Powell; Thomas Allan,20,0,100,80
1657199201103,CSE 140,A01,083663,Gungor; Onat,13,0,85,72
1657199207134,CSE 140L,A01,083088,Eldon; John,17,0,100,83
1657199213166,CSE 175,A01,083665,Kumar; Rakesh,3,0,25,22
1657199219193,CSE 190,A00,092507,Dubnov; Shlomo,7,0,20,13
1657199225226,ECE 45,A01,083139,Congero; Spencer William,5,0,75,70
1657199231263,ECE 65,A50,083695,Saad; Andrew S,12,0,30,18
1657199231263,ECE 65,A51,095125,Saad; Andrew S,25,0,26,1
1657199237296,ECE 109,A01,091882,Touri; Behrouz,19,0,70,51
1657199243323,ECE 180,A00,083140,Abi Samra; Nicholas Camill,1,0,30,29
1657199243323,ECE 180,B00,083141,Abi Samra; Nicholas Camill,0,0,30,30
1657199249354,MATH 10A,A01,083735,Patchell; Gregory David,2,0,30,28
1657199249354,MATH 10A,A02,083736,Patchell; Gregory David,20,0,30,10
1657199249354,MATH 10A,A03,083737,Patchell; Gregory David,16,0,30,14
1657199255397,MATH 10B,A01,083207,Lim; Seonhee,7,0,34,27
1657199255397,MATH 10B,A02,083208,Lim; Seonhee,9,0,35,26
1657199255397,MATH 10B,A03,093472,Lim; Seonhee,5,0,34,29
1657199255397,MATH 10B,B01,083739,Sinha; Shubham,10,0,30,20
1657199261442,MATH 18,A01,083743,Cinel; Cameron Alexander,6,0,30,24
1657199261442,MATH 18,A02,083744,Cinel; Cameron Alexander,15,0,30,15
1657199261442,MATH 18,A03,083745,Cinel; Cameron Alexander,8,0,30,22
1657199261442,MATH 18,B01,083748,Rideout; David Porter,4,0,37,33
1657199261442,MATH 18,B02,083749,Rideout; David Porter,4,0,36,32
1657199261442,MATH 18,B03,083750,Rideout; David Porter,2,0,37,35
1657199261442,MATH 18,B04,083751,Rideout; David Porter,5,0,36,31
1657199261442,MATH 18,B05,093473,Rideout; David Porter,5,0,36,31
1657199261442,MATH 18,B06,093474,Rideout; David Porter,5,0,36,31
1657199267473,MATH 20A,A01,083754,Zheng; Zequn,13,0,40,27
1657199273501,MATH 20B,A01,083756,Briones; Jor-el Thomas Caparas,1,0,36,35
1657199273501,MATH 20B,A02,083757,Briones; Jor-el Thomas Caparas,1,0,36,35
1657199273501,MATH 20B,A03,093475,Briones; Jor-el Thomas Caparas,1,0,36,35
1657199279529,MATH 20C,A01,083760,Briones; Jor-el Thomas Caparas,1,0,35,34
1657199279529,MATH 20C,A02,083761,Briones; Jor-el Thomas Caparas,8,0,35,27
1657199279529,MATH 20C,A03,093476,Briones; Jor-el Thomas Caparas,0,1,36,36
1657199279529,MATH 20C,B01,083762,Bach; Quang Tran,1,0,30,29
1657199285566,MATH 20D,A01,083765,Tran; Brian Kha,4,0,30,26
1657199285566,MATH 20D,A02,083766,Tran; Brian Kha,5,0,30,25
1657199285566,MATH 20D,A03,083767,Tran; Brian Kha,4,0,30,26
1657199291600,MATH 20E,A01,083771,Ganguly; Soumya,7,0,32,25
1657199291600,MATH 20E,A02,083772,Ganguly; Soumya,7,0,32,25
1657199291600,MATH 20E,B01,083773,Ciotti; Benjamin,19,0,35,16
1657199291600,MATH 20E,B02,083774,Ciotti; Benjamin,17,0,35,18
1657199297640,MATH 103A,A01,083777,Greenfeld; Be'Eri,2,0,36,34
1657199297640,MATH 103A,A02,083778,Greenfeld; Be'Eri,5,0,36,31
1657199297640,MATH 103A,A03,093561,Greenfeld; Be'Eri,4,0,36,32
1657199297640,MATH 103A,B01,083779,Greenfeld; Be'Eri,6,0,36,30
1657199297640,MATH 103A,B02,083780,Greenfeld; Be'Eri,3,0,36,33
1657199297640,MATH 103A,B03,093562,Greenfeld; Be'Eri,3,0,36,33
1657199303665,MATH 105,A01,085443,Carter; Anne Toulson,14,0,35,21
1657199303665,MATH 105,A02,093477,Carter; Anne Toulson,20,0,35,15
1657199309696,MATH 109,A01,083213,Ganzberger; Geoffrey Michael,2,0,34,32
1657199309696,MATH 109,A02,083214,Ganzberger; Geoffrey Michael,4,0,34,30
1657199309696,MATH 109,A03,093478,Ganzberger; Geoffrey Michael,1,0,34,33
1657199309696,MATH 109,B01,083215,Ganzberger; Geoffrey Michael,1,0,32,31
1657199309696,MATH 109,B02,083216,Ganzberger; Geoffrey Michael,1,0,32,31
1657199309696,MATH 109,B03,093479,Ganzberger; Geoffrey Michael,7,0,32,25
1657199315735,MATH 142A,A01,083219,Chow; Bennett,6,0,32,26
1657199315735,MATH 142A,A02,083220,Chow; Bennett,10,0,32,22
1657199315735,MATH 142A,A03,093480,Chow; Bennett,7,0,32,25
1657199315735,MATH 142A,B03,093481,Chow; Bennett,8,0,32,24
1657199315735,MATH 142A,B04,093558,Chow; Bennett,11,0,32,21
1657199315735,MATH 142A,B05,093559,Chow; Bennett,6,0,32,26
1657199321766,MATH 193A,A01,083224,Rotar; Vladimir,7,0,34,27
1657199321766,MATH 193A,A02,083225,Rotar; Vladimir,5,0,34,29
1657199321766,MATH 193A,A03,083781,Rotar; Vladimir,1,0,34,33
1657199321766,MATH 193A,A04,083782,Rotar; Vladimir,8,0,34,26
1657199321766,MATH 193A,A05,093482,Rotar; Vladimir,6,0,34,28
1657199327799,MATH 197,001,091859,McAuley; Julian John,9999,0,9999,0
1657199327799,MATH 197,002,095566,Kedlaya; Kiran S.,9997,0,9999,2
1657199327799,MATH 197,003,095567,Xiao; Ming,9999,0,9999,0
1657199327799,MATH 197,004,095571,Perols; Johan Lars,9998,0,9999,1
1657199334873,COGS 9,A01,083615,Shannon; Kyle Michael,7,0,75,68
1657199340900,COGS 11,A01,083617,Boyle; Mary E. T.,22,0,48,26
1657199346944,COGS 13,A01,083071,Bastos; Amalia Pinkusfeld,9,0,71,62
1657199352976,COGS 14A,A01,092681,Semenuks; Arturs,1,1,100,99
1657199359016,COGS 14B,A01,083073,Cheng; Tzu-Han,6,0,63,57
1657199365046,COGS 17,A01,092677,Semenuks; Arturs,4,0,81,77
1657199371078,COGS 100,A01,083619,Allen; Michael Gordon,15,0,70,55
1657199377113,COGS 101A,A01,083621,Davis; Joshua Daniel,9,0,68,59
1657199383150,COGS 101B,A01,091572,Allen; Michael Gordon,9,0,65,56
1657199389177,COGS 101C,A01,083625,Delgado; Tania,17,0,35,18
1657199395201,COGS 107A,A01,083627,Boyle; Mary E. T.,13,0,60,47
1657199401231,COGS 118A,A01,083075,Gupta; Anjum,16,0,76,60
1657199407259,CSE 3,A50,083646,Miranda; Gregory Joseph,24,0,50,26
1657199413287,CSE 8A,A50,083650,Miranda; Gregory Joseph,17,1,56,39
1657199419322,CSE 11,A01,083080,Cao; Yingjun,5,15,40,35
1657199425349,CSE 12,A01,083652,Krause-Levy; Sophia Louisa,24,1,120,96
1657199431377,CSE 15L,A01,083654,Morris; Justin Loren,9,0,50,41
1657199431377,CSE 15L,A02,083655,Morris; Justin Loren,9,0,50,41
1657199437403,CSE 20,A01,083657,Tran; Khoa Dang,38,0,80,42
1657199443430,CSE 21,A01,095574,Bach; Quang Tran,22,0,48,26
1657199449468,CSE 30,A01,083084,Eldon; John,4,0,80,76
1657199449468,CSE 30,B01,095061,Bhaskar; Nishant,7,0,50,43
1657199455504,CSE 100,A01,083659,Cao; Yingjun,4,4,70,66
1657199461550,CSE 134B,A01,083661,Powell; Thomas Allan,20,0,100,80
1657199467578,CSE 140,A01,083663,Gungor; Onat,13,0,85,72
1657199473606,CSE 140L,A01,083088,Eldon; John,17,0,100,83
1657199479634,CSE 175,A01,083665,Kumar; Rakesh,3,0,25,22
1657199485662,CSE 190,A00,092507,Dubnov; Shlomo,7,0,20,13
1657199491697,ECE 45,A01,083139,Congero; Spencer William,5,0,75,70
1657199497795,ECE 65,A50,083695,Saad; Andrew S,12,0,30,18
1657199497795,ECE 65,A51,095125,Saad; Andrew S,25,0,26,1
1657199503823,ECE 109,A01,091882,Touri; Behrouz,19,0,70,51
1657199509848,ECE 180,A00,083140,Abi Samra; Nicholas Camill,1,0,30,29
1657199509848,ECE 180,B00,083141,Abi Samra; Nicholas Camill,0,0,30,30
1657199515873,MATH 10A,A01,083735,Patchell; Gregory David,2,0,30,28
1657199515873,MATH 10A,A02,083736,Patchell; Gregory David,20,0,30,10
1657199515873,MATH 10A,A03,083737,Patchell; Gregory David,16,0,30,14
1657199521905,MATH 10B,A01,083207,Lim; Seonhee,7,0,34,27
1657199521905,MATH 10B,A02,083208,Lim; Seonhee,9,0,35,26
1657199521905,MATH 10B,A03,093472,Lim; Seonhee,5,0,34,29
1657199521905,MATH 10B,B01,083739,Sinha; Shubham,10,0,30,20
1657199527941,MATH 18,A01,083743,Cinel; Cameron Alexander,6,0,30,24
1657199527941,MATH 18,A02,083744,Cinel; Cameron Alexander,15,0,30,15
1657199527941,MATH 18,A03,083745,Cinel; Cameron Alexander,8,0,30,22
1657199527941,MATH 18,B01,083748,Rideout; David Porter,4,0,37,33
1657199527941,MATH 18,B02,083749,Rideout; David Porter,4,0,36,32
1657199527941,MATH 18,B03,083750,Rideout; David Porter,2,0,37,35
1657199527941,MATH 18,B04,083751,Rideout; David Porter,5,0,36,31
1657199527941,MATH 18,B05,093473,Rideout; David Porter,5,0,36,31
1657199527941,MATH 18,B06,093474,Rideout; David Porter,5,0,36,31
1657199533967,MATH 20A,A01,083754,Zheng; Zequn,13,0,40,27
1657199539994,MATH 20B,A01,083756,Briones; Jor-el Thomas Caparas,1,0,36,35
1657199539994,MATH 20B,A02,083757,Briones; Jor-el Thomas Caparas,1,0,36,35
1657199539994,MATH 20B,A03,093475,Briones; Jor-el Thomas Caparas,1,0,36,35
1657199546025,MATH 20C,A01,083760,Briones; Jor-el Thomas Caparas,1,0,35,34
1657199546025,MATH 20C,A02,083761,Briones; Jor-el Thomas Caparas,8,0,35,27
1657199546025,MATH 20C,A03,093476,Briones; Jor-el Thomas Caparas,0,1,36,36
1657199546025,MATH 20C,B01,083762,Bach; Quang Tran,1,0,30,29
1657199552060,MATH 20D,A01,083765,Tran; Brian Kha,4,0,30,26
1657199552060,MATH 20D,A02,083766,Tran; Brian Kha,5,0,30,25
1657199552060,MATH 20D,A03,083767,Tran; Brian Kha,4,0,30,26
1657199558092,MATH 20E,A01,083771,Ganguly; Soumya,7,0,32,25
1657199558092,MATH 20E,A02,083772,Ganguly; Soumya,7,0,32,25
1657199558092,MATH 20E,B01,083773,Ciotti; Benjamin,19,0,35,16
1657199558092,MATH 20E,B02,083774,Ciotti; Benjamin,17,0,35,18
1657199564132,MATH 103A,A01,083777,Greenfeld; Be'Eri,2,0,36,34
1657199564132,MATH 103A,A02,083778,Greenfeld; Be'Eri,5,0,36,31
1657199564132,MATH 103A,A03,093561,Greenfeld; Be'Eri,4,0,36,32
1657199564132,MATH 103A,B01,083779,Greenfeld; Be'Eri,6,0,36,30
1657199564132,MATH 103A,B02,083780,Greenfeld; Be'Eri,3,0,36,33
1657199564132,MATH 103A,B03,093562,Greenfeld; Be'Eri,3,0,36,33
1657199570163,MATH 105,A01,085443,Carter; Anne Toulson,14,0,35,21
1657199570163,MATH 105,A02,093477,Carter; Anne Toulson,20,0,35,15
1657199576193,MATH 109,A01,083213,Ganzberger; Geoffrey Michael,2,0,34,32
1657199576193,MATH 109,A02,083214,Ganzberger; Geoffrey Michael,4,0,34,30
1657199576193,MATH 109,A03,093478,Ganzberger; Geoffrey Michael,1,0,34,33
1657199576193,MATH 109,B01,083215,Ganzberger; Geoffrey Michael,1,0,32,31
1657199576193,MATH 109,B02,083216,Ganzberger; Geoffrey Michael,1,0,32,31
1657199576193,MATH 109,B03,093479,Ganzberger; Geoffrey Michael,7,0,32,25
1657199582256,MATH 142A,A01,083219,Chow; Bennett,6,0,32,26
1657199582256,MATH 142A,A02,083220,Chow; Bennett,10,0,32,22
1657199582256,MATH 142A,A03,093480,Chow; Bennett,7,0,32,25
1657199582256,MATH 142A,B03,093481,Chow; Bennett,8,0,32,24
1657199582256,MATH 142A,B04,093558,Chow; Bennett,11,0,32,21
1657199582256,MATH 142A,B05,093559,Chow; Bennett,6,0,32,26
1657199588284,MATH 193A,A01,083224,Rotar; Vladimir,7,0,34,27
1657199588284,MATH 193A,A02,083225,Rotar; Vladimir,5,0,34,29
1657199588284,MATH 193A,A03,083781,Rotar; Vladimir,1,0,34,33
1657199588284,MATH 193A,A04,083782,Rotar; Vladimir,8,0,34,26
1657199588284,MATH 193A,A05,093482,Rotar; Vladimir,6,0,34,28
1657199594312,MATH 197,001,091859,McAuley; Julian John,9999,0,9999,0
1657199594312,MATH 197,002,095566,Kedlaya; Kiran S.,9997,0,9999,2
1657199594312,MATH 197,003,095567,Xiao; Ming,9999,0,9999,0
1657199594312,MATH 197,004,095571,Perols; Johan Lars,9998,0,9999,1
1657199601392,COGS 9,A01,083615,Shannon; Kyle Michael,7,0,75,68
1657199607422,COGS 11,A01,083617,Boyle; Mary E. T.,22,0,48,26
1657199613455,COGS 13,A01,083071,Bastos; Amalia Pinkusfeld,9,0,71,62
1657199619485,COGS 14A,A01,092681,Semenuks; Arturs,1,1,100,99
1657199625511,COGS 14B,A01,083073,Cheng; Tzu-Han,6,0,63,57
1657199631538,COGS 17,A01,092677,Semenuks; Arturs,4,0,81,77
1657199637576,COGS 100,A01,083619,Allen; Michael Gordon,15,0,70,55
1657199643608,COGS 101A,A01,083621,Davis; Joshua Daniel,9,0,68,59
1657199649639,COGS 101B,A01,091572,Allen; Michael Gordon,9,0,65,56
1657199655667,COGS 101C,A01,083625,Delgado; Tania,17,0,35,18
1657199661693,COGS 107A,A01,083627,Boyle; Mary E. T.,13,0,60,47
1657199667719,COGS 118A,A01,083075,Gupta; Anjum,16,0,76,60
1657199673757,CSE 3,A50,083646,Miranda; Gregory Joseph,24,0,50,26
1657199679783,CSE 8A,A50,083650,Miranda; Gregory Joseph,17,1,56,39
1657199685820,CSE 11,A01,083080,Cao; Yingjun,5,15,40,35
1657199691846,CSE 12,A01,083652,Krause-Levy; Sophia Louisa,24,1,120,96
1657199697876,CSE 15L,A01,083654,Morris; Justin Loren,9,0,50,41
1657199697876,CSE 15L,A02,083655,Morris; Justin Loren,9,0,50,41
1657199703906,CSE 20,A01,083657,Tran; Khoa Dang,38,0,80,42
1657199709942,CSE 21,A01,095574,Bach; Quang Tran,22,0,48,26
1657199715973,CSE 30,A01,083084,Eldon; John,4,0,80,76
1657199715973,CSE 30,B01,095061,Bhaskar; Nishant,7,0,50,43
1657199722015,CSE 100,A01,083659,Cao; Yingjun,4,4,70,66
1657199728047,CSE 134B,A01,083661,Powell; Thomas Allan,20,0,100,80
1657199734075,CSE 140,A01,083663,Gungor; Onat,13,0,85,72
1657199740109,CSE 140L,A01,083088,Eldon; John,17,0,100,83
1657199746141,CSE 175,A01,083665,Kumar; Rakesh,3,0,25,22
1657199752170,CSE 190,A00,092507,Dubnov; Shlomo,7,0,20,13
1657199758199,ECE 45,A01,083139,Congero; Spencer William,5,0,75,70
1657199764235,ECE 65,A50,083695,Saad; Andrew S,12,0,30,18
1657199764235,ECE 65,A51,095125,Saad; Andrew S,25,0,26,1
1657199770268,ECE 109,A01,091882,Touri; Behrouz,19,0,70,51
1657199776295,ECE 180,A00,083140,Abi Samra; Nicholas Camill,1,0,30,29
1657199776295,ECE 180,B00,083141,Abi Samra; Nicholas Camill,0,0,30,30
1657199782352,MATH 10A,A01,083735,Patchell; Gregory David,2,0,30,28
1657199782352,MATH 10A,A02,083736,Patchell; Gregory David,20,0,30,10
1657199782352,MATH 10A,A03,083737,Patchell; Gregory David,16,0,30,14
1657199788381,MATH 10B,A01,083207,Lim; Seonhee,7,0,34,27
1657199788381,MATH 10B,A02,083208,Lim; Seonhee,9,0,35,26
1657199788381,MATH 10B,A03,093472,Lim; Seonhee,5,0,34,29
1657199788381,MATH 10B,B01,083739,Sinha; Shubham,10,0,30,20
1657199794408,MATH 18,A01,083743,Cinel; Cameron Alexander,6,0,30,24
1657199794408,MATH 18,A02,083744,Cinel; Cameron Alexander,15,0,30,15
1657199794408,MATH 18,A03,083745,Cinel; Cameron Alexander,8,0,30,22
1657199794408,MATH 18,B01,083748,Rideout; David Porter,4,0,37,33
1657199794408,MATH 18,B02,083749,Rideout; David Porter,4,0,36,32
1657199794408,MATH 18,B03,083750,Rideout; David Porter,2,0,37,35
1657199794408,MATH 18,B04,083751,Rideout; David Porter,5,0,36,31
1657199794408,MATH 18,B05,093473,Rideout; David Porter,5,0,36,31
1657199794408,MATH 18,B06,093474,Rideout; David Porter,5,0,36,31
1657199800438,MATH 20A,A01,083754,Zheng; Zequn,13,0,40,27
1657199806466,MATH 20B,A01,083756,Briones; Jor-el Thomas Caparas,1,0,36,35
1657199806466,MATH 20B,A02,083757,Briones; Jor-el Thomas Caparas,1,0,36,35
1657199806466,MATH 20B,A03,093475,Briones; Jor-el Thomas Caparas,1,0,36,35
1657199812499,MATH 20C,A01,083760,Briones; Jor-el Thomas Caparas,1,0,35,34
1657199812499,MATH 20C,A02,083761,Briones; Jor-el Thomas Caparas,8,0,35,27
1657199812499,MATH 20C,A03,093476,Briones; Jor-el Thomas Caparas,0,1,36,36
1657199812499,MATH 20C,B01,083762,Bach; Quang Tran,1,0,30,29
1657199818541,MATH 20D,A01,083765,Tran; Brian Kha,4,0,30,26
1657199818541,MATH 20D,A02,083766,Tran; Brian Kha,5,0,30,25
1657199818541,MATH 20D,A03,083767,Tran; Brian Kha,4,0,30,26
1657199824580,MATH 20E,A01,083771,Ganguly; Soumya,7,0,32,25
1657199824580,MATH 20E,A02,083772,Ganguly; Soumya,7,0,32,25
1657199824580,MATH 20E,B01,083773,Ciotti; Benjamin,19,0,35,16
1657199824580,MATH 20E,B02,083774,Ciotti; Benjamin,17,0,35,18
1657199830608,MATH 103A,A01,083777,Greenfeld; Be'Eri,2,0,36,34
1657199830608,MATH 103A,A02,083778,Greenfeld; Be'Eri,5,0,36,31
1657199830608,MATH 103A,A03,093561,Greenfeld; Be'Eri,4,0,36,32
1657199830608,MATH 103A,B01,083779,Greenfeld; Be'Eri,6,0,36,30
1657199830608,MATH 103A,B02,083780,Greenfeld; Be'Eri,3,0,36,33
1657199830608,MATH 103A,B03,093562,Greenfeld; Be'Eri,3,0,36,33
1657199836644,MATH 105,A01,085443,Carter; Anne Toulson,14,0,35,21
1657199836644,MATH 105,A02,093477,Carter; Anne Toulson,20,0,35,15
1657199842686,MATH 109,A01,083213,Ganzberger; Geoffrey Michael,2,0,34,32
1657199842686,MATH 109,A02,083214,Ganzberger; Geoffrey Michael,4,0,34,30
1657199842686,MATH 109,A03,093478,Ganzberger; Geoffrey Michael,1,0,34,33
1657199842686,MATH 109,B01,083215,Ganzberger; Geoffrey Michael,1,0,32,31
1657199842686,MATH 109,B02,083216,Ganzberger; Geoffrey Michael,1,0,32,31
1657199842686,MATH 109,B03,093479,Ganzberger; Geoffrey Michael,7,0,32,25
1657199848746,MATH 142A,A01,083219,Chow; Bennett,6,0,32,26
1657199848746,MATH 142A,A02,083220,Chow; Bennett,10,0,32,22
1657199848746,MATH 142A,A03,093480,Chow; Bennett,7,0,32,25
1657199848746,MATH 142A,B03,093481,Chow; Bennett,8,0,32,24
1657199848746,MATH 142A,B04,093558,Chow; Bennett,11,0,32,21
1657199848746,MATH 142A,B05,093559,Chow; Bennett,6,0,32,26
1657199854779,MATH 193A,A01,083224,Rotar; Vladimir,7,0,34,27
1657199854779,MATH 193A,A02,083225,Rotar; Vladimir,5,0,34,29
1657199854779,MATH 193A,A03,083781,Rotar; Vladimir,1,0,34,33
1657199854779,MATH 193A,A04,083782,Rotar; Vladimir,8,0,34,26
1657199854779,MATH 193A,A05,093482,Rotar; Vladimir,6,0,34,28
1657199860811,MATH 197,001,091859,McAuley; Julian John,9999,0,9999,0
1657199860811,MATH 197,002,095566,Kedlaya; Kiran S.,9997,0,9999,2
1657199860811,MATH 197,003,095567,Xiao; Ming,9999,0,9999,0
1657199860811,MATH 197,004,095571,Perols; Johan Lars,9998,0,9999,1
1657199867917,COGS 9,A01,083615,Shannon; Kyle Michael,7,0,75,68
1657199873951,COGS 11,A01,083617,Boyle; Mary E. T.,22,0,48,26
1657199879988,COGS 13,A01,083071,Bastos; Amalia Pinkusfeld,9,0,71,62
1657199886019,COGS 14A,A01,092681,Semenuks; Arturs,1,1,100,99
1657199892045,COGS 14B,A01,083073,Cheng; Tzu-Han,6,0,63,57
1657199898085,COGS 17,A01,092677,Semenuks; Arturs,4,0,81,77
1657199904127,COGS 100,A01,083619,Allen; Michael Gordon,15,0,70,55
1657199910158,COGS 101A,A01,083621,Davis; Joshua Daniel,9,0,68,59
1657199916185,COGS 101B,A01,091572,Allen; Michael Gordon,9,0,65,56
1657199922240,COGS 101C,A01,083625,Delgado; Tania,17,0,35,18
1657199928269,COGS 107A,A01,083627,Boyle; Mary E. T.,13,0,60,47
1657199934302,COGS 118A,A01,083075,Gupta; Anjum,16,0,76,60
1657199940339,CSE 3,A50,083646,Miranda; Gregory Joseph,24,0,50,26
1657199946371,CSE 8A,A50,083650,Miranda; Gregory Joseph,17,1,56,39
1657199952405,CSE 11,A01,083080,Cao; Yingjun,5,15,40,35
1657199958432,CSE 12,A01,083652,Krause-Levy; Sophia Louisa,24,1,120,96
1657199964462,CSE 15L,A01,083654,Morris; Justin Loren,9,0,50,41
1657199964462,CSE 15L,A02,083655,Morris; Justin Loren,9,0,50,41
1657199970488,CSE 20,A01,083657,Tran; Khoa Dang,38,0,80,42
1657199976520,CSE 21,A01,095574,Bach; Quang Tran,22,0,48,26
1657199982550,CSE 30,A01,083084,Eldon; John,4,0,80,76
1657199982550,CSE 30,B01,095061,Bhaskar; Nishant,7,0,50,43
1657199988584,CSE 100,A01,083659,Cao; Yingjun,4,4,70,66
1657199994618,CSE 134B,A01,083661,Powell; Thomas Allan,20,0,100,80
1657200000645,CSE 140,A01,083663,Gungor; Onat,13,0,85,72
1657200006678,CSE 140L,A01,083088,Eldon; John,17,0,100,83
1657200012711,CSE 175,A01,083665,Kumar; Rakesh,3,0,25,22
1657200018743,CSE 190,A00,092507,Dubnov; Shlomo,7,0,20,13
1657200024779,ECE 45,A01,083139,Congero; Spencer William,5,0,75,70
1657200030815,ECE 65,A50,083695,Saad; Andrew S,12,0,30,18
1657200030815,ECE 65,A51,095125,Saad; Andrew S,25,0,26,1
1657200036855,ECE 109,A01,091882,Touri; Behrouz,19,0,70,51
1657200042891,ECE 180,A00,083140,Abi Samra; Nicholas Camill,1,0,30,29
1657200042891,ECE 180,B00,083141,Abi Samra; Nicholas Camill,0,0,30,30
1657200048921,MATH 10A,A01,083735,Patchell; Gregory David,2,0,30,28
1657200048921,MATH 10A,A02,083736,Patchell; Gregory David,20,0,30,10
1657200048921,MATH 10A,A03,083737,Patchell; Gregory David,16,0,30,14
1657200054967,MATH 10B,A01,083207,Lim; Seonhee,7,0,34,27
1657200054967,MATH 10B,A02,083208,Lim; Seonhee,9,0,35,26
1657200054967,MATH 10B,A03,093472,Lim; Seonhee,5,0,34,29
1657200054967,MATH 10B,B01,083739,Sinha; Shubham,10,0,30,20
1657200061012,MATH 18,A01,083743,Cinel; Cameron Alexander,6,0,30,24
1657200061012,MATH 18,A02,083744,Cinel; Cameron Alexander,15,0,30,15
1657200061012,MATH 18,A03,083745,Cinel; Cameron Alexander,8,0,30,22
1657200061012,MATH 18,B01,083748,Rideout; David Porter,4,0,37,33
1657200061012,MATH 18,B02,083749,Rideout; David Porter,4,0,36,32
1657200061012,MATH 18,B03,083750,Rideout; David Porter,2,0,37,35
1657200061012,MATH 18,B04,083751,Rideout; David Porter,5,0,36,31
1657200061012,MATH 18,B05,093473,Rideout; David Porter,5,0,36,31
1657200061012,MATH 18,B06,093474,Rideout; David Porter,5,0,36,31
1657200067044,MATH 20A,A01,083754,Zheng; Zequn,13,0,40,27
1657200073081,MATH 20B,A01,083756,Briones; Jor-el Thomas Caparas,1,0,36,35
1657200073081,MATH 20B,A02,083757,Briones; Jor-el Thomas Caparas,1,0,36,35
1657200073081,MATH 20B,A03,093475,Briones; Jor-el Thomas Caparas,1,0,36,35
1657200079125,MATH 20C,A01,083760,Briones; Jor-el Thomas Caparas,1,0,35,34
1657200079125,MATH 20C,A02,083761,Briones; Jor-el Thomas Caparas,8,0,35,27
1657200079125,MATH 20C,A03,093476,Briones; Jor-el Thomas Caparas,0,1,36,36
1657200079125,MATH 20C,B01,083762,Bach; Quang Tran,1,0,30,29
1657200085159,MATH 20D,A01,083765,Tran; Brian Kha,4,0,30,26
1657200085159,MATH 20D,A02,083766,Tran; Brian Kha,5,0,30,25
1657200085159,MATH 20D,A03,083767,Tran; Brian Kha,4,0,30,26
1657200091197,MATH 20E,A01,083771,Ganguly; Soumya,7,0,32,25
1657200091197,MATH 20E,A02,083772,Ganguly; Soumya,7,0,32,25
1657200091197,MATH 20E,B01,083773,Ciotti; Benjamin,19,0,35,16
1657200091197,MATH 20E,B02,083774,Ciotti; Benjamin,17,0,35,18
1657200097322,MATH 103A,A01,083777,Greenfeld; Be'Eri,2,0,36,34
1657200097322,MATH 103A,A02,083778,Greenfeld; Be'Eri,5,0,36,31
1657200097322,MATH 103A,A03,093561,Greenfeld; Be'Eri,4,0,36,32
1657200097322,MATH 103A,B01,083779,Greenfeld; Be'Eri,6,0,36,30
1657200097322,MATH 103A,B02,083780,Greenfeld; Be'Eri,3,0,36,33
1657200097322,MATH 103A,B03,093562,Greenfeld; Be'Eri,3,0,36,33
1657200103353,MATH 105,A01,085443,Carter; Anne Toulson,14,0,35,21
1657200103353,MATH 105,A02,093477,Carter; Anne Toulson,20,0,35,15
1657200109383,MATH 109,A01,083213,Ganzberger; Geoffrey Michael,2,0,34,32
1657200109383,MATH 109,A02,083214,Ganzberger; Geoffrey Michael,4,0,34,30
1657200109383,MATH 109,A03,093478,Ganzberger; Geoffrey Michael,1,0,34,33
1657200109383,MATH 109,B01,083215,Ganzberger; Geoffrey Michael,1,0,32,31
1657200109383,MATH 109,B02,083216,Ganzberger; Geoffrey Michael,1,0,32,31
1657200109383,MATH 109,B03,093479,Ganzberger; Geoffrey Michael,7,0,32,25
1657200115413,MATH 142A,A01,083219,Chow; Bennett,6,0,32,26
1657200115413,MATH 142A,A02,083220,Chow; Bennett,10,0,32,22
1657200115413,MATH 142A,A03,093480,Chow; Bennett,7,0,32,25
1657200115413,MATH 142A,B03,093481,Chow; Bennett,8,0,32,24
1657200115413,MATH 142A,B04,093558,Chow; Bennett,11,0,32,21
1657200115413,MATH 142A,B05,093559,Chow; Bennett,6,0,32,26
1657200121450,MATH 193A,A01,083224,Rotar; Vladimir,7,0,34,27
1657200121450,MATH 193A,A02,083225,Rotar; Vladimir,5,0,34,29
1657200121450,MATH 193A,A03,083781,Rotar; Vladimir,1,0,34,33
1657200121450,MATH 193A,A04,083782,Rotar; Vladimir,8,0,34,26
1657200121450,MATH 193A,A05,093482,Rotar; Vladimir,6,0,34,28
1657200127488,MATH 197,001,091859,McAuley; Julian John,9999,0,9999,0
1657200127488,MATH 197,002,095566,Kedlaya; Kiran S.,9997,0,9999,2
1657200127488,MATH 197,003,095567,Xiao; Ming,9999,0,9999,0
1657200127488,MATH 197,004,095571,Perols; Johan Lars,9998,0,9999,1
1657200134575,COGS 9,A01,083615,Shannon; Kyle Michael,7,0,75,68
1657200140605,COGS 11,A01,083617,Boyle; Mary E. T.,22,0,48,26
1657200146633,COGS 13,A01,083071,Bastos; Amalia Pinkusfeld,9,0,71,62
1657200152668,COGS 14A,A01,092681,Semenuks; Arturs,1,1,100,99
1657200158701,COGS 14B,A01,083073,Cheng; Tzu-Han,6,0,63,57
1657200164737,COGS 17,A01,092677,Semenuks; Arturs,4,0,81,77
1657200170770,COGS 100,A01,083619,Allen; Michael Gordon,15,0,70,55
1657200176804,COGS 101A,A01,083621,Davis; Joshua Daniel,9,0,68,59
1657200182836,COGS 101B,A01,091572,Allen; Michael Gordon,9,0,65,56
1657200188864,COGS 101C,A01,083625,Delgado; Tania,17,0,35,18
1657200194899,COGS 107A,A01,083627,Boyle; Mary E. T.,13,0,60,47
1657200200931,COGS 118A,A01,083075,Gupta; Anjum,16,0,76,60
1657200206977,CSE 3,A50,083646,Miranda; Gregory Joseph,24,0,50,26
1657200213004,CSE 8A,A50,083650,Miranda; Gregory Joseph,17,1,56,39
1657200219031,CSE 11,A01,083080,Cao; Yingjun,5,15,40,35
1657200225065,CSE 12,A01,083652,Krause-Levy; Sophia Louisa,24,1,120,96
1657200231110,CSE 15L,A01,083654,Morris; Justin Loren,9,0,50,41
1657200231110,CSE 15L,A02,083655,Morris; Justin Loren,9,0,50,41
1657200237146,CSE 20,A01,083657,Tran; Khoa Dang,38,0,80,42
1657200243172,CSE 21,A01,095574,Bach; Quang Tran,22,0,48,26
1657200249201,CSE 30,A01,083084,Eldon; John,4,0,80,76
1657200249201,CSE 30,B01,095061,Bhaskar; Nishant,7,0,50,43
1657200255241,CSE 100,A01,083659,Cao; Yingjun,4,4,70,66
1657200261275,CSE 134B,A01,083661,Powell; Thomas Allan,20,0,100,80
1657200267301,CSE 140,A01,083663,Gungor; Onat,13,0,85,72
1657200273327,CSE 140L,A01,083088,Eldon; John,17,0,100,83
1657200279361,CSE 175,A01,083665,Kumar; Rakesh,3,0,25,22
1657200285389,CSE 190,A00,092507,Dubnov; Shlomo,7,0,20,13
1657200291433,ECE 45,A01,083139,Congero; Spencer William,5,0,75,70
1657200297469,ECE 65,A50,083695,Saad; Andrew S,12,0,30,18
1657200297469,ECE 65,A51,095125,Saad; Andrew S,25,0,26,1
1657200303495,ECE 109,A01,091882,Touri; Behrouz,19,0,70,51
1657200309520,ECE 180,A00,083140,Abi Samra; Nicholas Camill,1,0,30,29
1657200309520,ECE 180,B00,083141,Abi Samra; Nicholas Camill,0,0,30,30
1657200315555,MATH 10A,A01,083735,Patchell; Gregory David,2,0,30,28
1657200315555,MATH 10A,A02,083736,Patchell; Gregory David,20,0,30,10
1657200315555,MATH 10A,A03,083737,Patchell; Gregory David,16,0,30,14
1657200321586,MATH 10B,A01,083207,Lim; Seonhee,7,0,34,27
1657200321586,MATH 10B,A02,083208,Lim; Seonhee,9,0,35,26
1657200321586,MATH 10B,A03,093472,Lim; Seonhee,5,0,34,29
1657200321586,MATH 10B,B01,083739,Sinha; Shubham,10,0,30,20
1657200327634,MATH 18,A01,083743,Cinel; Cameron Alexander,6,0,30,24
1657200327634,MATH 18,A02,083744,Cinel; Cameron Alexander,15,0,30,15
1657200327634,MATH 18,A03,083745,Cinel; Cameron Alexander,8,0,30,22
1657200327634,MATH 18,B01,083748,Rideout; David Porter,4,0,37,33
1657200327634,MATH 18,B02,083749,Rideout; David Porter,4,0,36,32
1657200327634,MATH 18,B03,083750,Rideout; David Porter,2,0,37,35
1657200327634,MATH 18,B04,083751,Rideout; David Porter,5,0,36,31
1657200327634,MATH 18,B05,093473,Rideout; David Porter,5,0,36,31
1657200327634,MATH 18,B06,093474,Rideout; David Porter,5,0,36,31
1657200333664,MATH 20A,A01,083754,Zheng; Zequn,13,0,40,27
1657200339698,MATH 20B,A01,083756,Briones; Jor-el Thomas Caparas,1,0,36,35
1657200339698,MATH 20B,A02,083757,Briones; Jor-el Thomas Caparas,1,0,36,35
1657200339698,MATH 20B,A03,093475,Briones; Jor-el Thomas Caparas,1,0,36,35
1657200345730,MATH 20C,A01,083760,Briones; Jor-el Thomas Caparas,1,0,35,34
1657200345730,MATH 20C,A02,083761,Briones; Jor-el Thomas Caparas,8,0,35,27
1657200345730,MATH 20C,A03,093476,Briones; Jor-el Thomas Caparas,0,1,36,36
1657200345730,MATH 20C,B01,083762,Bach; Quang Tran,1,0,30,29
1657200351769,MATH 20D,A01,083765,Tran; Brian Kha,4,0,30,26
1657200351769,MATH 20D,A02,083766,Tran; Brian Kha,5,0,30,25
1657200351769,MATH 20D,A03,083767,Tran; Brian Kha,4,0,30,26
1657200357813,MATH 20E,A01,083771,Ganguly; Soumya,7,0,32,25
1657200357813,MATH 20E,A02,083772,Ganguly; Soumya,7,0,32,25
1657200357813,MATH 20E,B01,083773,Ciotti; Benjamin,19,0,35,16
1657200357813,MATH 20E,B02,083774,Ciotti; Benjamin,17,0,35,18
1657200363865,MATH 103A,A01,083777,Greenfeld; Be'Eri,2,0,36,34
1657200363865,MATH 103A,A02,083778,Greenfeld; Be'Eri,5,0,36,31
1657200363865,MATH 103A,A03,093561,Greenfeld; Be'Eri,4,0,36,32
1657200363865,MATH 103A,B01,083779,Greenfeld; Be'Eri,6,0,36,30
1657200363865,MATH 103A,B02,083780,Greenfeld; Be'Eri,3,0,36,33
1657200363865,MATH 103A,B03,093562,Greenfeld; Be'Eri,3,0,36,33
1657200369895,MATH 105,A01,085443,Carter; Anne Toulson,14,0,35,21
1657200369895,MATH 105,A02,093477,Carter; Anne Toulson,20,0,35,15
1657200375933,MATH 109,A01,083213,Ganzberger; Geoffrey Michael,2,0,34,32
1657200375933,MATH 109,A02,083214,Ganzberger; Geoffrey Michael,4,0,34,30
1657200375933,MATH 109,A03,093478,Ganzberger; Geoffrey Michael,1,0,34,33
1657200375933,MATH 109,B01,083215,Ganzberger; Geoffrey Michael,1,0,32,31
1657200375933,MATH 109,B02,083216,Ganzberger; Geoffrey Michael,1,0,32,31
1657200375933,MATH 109,B03,093479,Ganzberger; Geoffrey Michael,7,0,32,25
1657200381962,MATH 142A,A01,083219,Chow; Bennett,6,0,32,26
1657200381962,MATH 142A,A02,083220,Chow; Bennett,10,0,32,22
1657200381962,MATH 142A,A03,093480,Chow; Bennett,7,0,32,25
1657200381962,MATH 142A,B03,093481,Chow; Bennett,8,0,32,24
1657200381962,MATH 142A,B04,093558,Chow; Bennett,11,0,32,21
1657200381962,MATH 142A,B05,093559,Chow; Bennett,6,0,32,26
1657200388004,MATH 193A,A01,083224,Rotar; Vladimir,7,0,34,27
1657200388004,MATH 193A,A02,083225,Rotar; Vladimir,5,0,34,29
1657200388004,MATH 193A,A03,083781,Rotar; Vladimir,1,0,34,33
1657200388004,MATH 193A,A04,083782,Rotar; Vladimir,8,0,34,26
1657200388004,MATH 193A,A05,093482,Rotar; Vladimir,6,0,34,28
1657200394032,MATH 197,001,091859,McAuley; Julian John,9999,0,9999,0
1657200394032,MATH 197,002,095566,Kedlaya; Kiran S.,9997,0,9999,2
1657200394032,MATH 197,003,095567,Xiao; Ming,9999,0,9999,0
1657200394032,MATH 197,004,095571,Perols; Johan Lars,9998,0,9999,1
1657200401116,COGS 9,A01,083615,Shannon; Kyle Michael,7,0,75,68
1657200407143,COGS 11,A01,083617,Boyle; Mary E. T.,22,0,48,26
1657200413180,COGS 13,A01,083071,Bastos; Amalia Pinkusfeld,9,0,71,62
1657200419205,COGS 14A,A01,092681,Semenuks; Arturs,1,1,100,99
1657200425239,COGS 14B,A01,083073,Cheng; Tzu-Han,6,0,63,57
1657200431265,COGS 17,A01,092677,Semenuks; Arturs,4,0,81,77
1657200437293,COGS 100,A01,083619,Allen; Michael Gordon,15,0,70,55
1657200443321,COGS 101A,A01,083621,Davis; Joshua Daniel,9,0,68,59
1657200449353,COGS 101B,A01,091572,Allen; Michael Gordon,9,0,65,56
1657200455388,COGS 101C,A01,083625,Delgado; Tania,17,0,35,18
1657200461419,COGS 107A,A01,083627,Boyle; Mary E. T.,13,0,60,47
1657200467446,COGS 118A,A01,083075,Gupta; Anjum,16,0,76,60
1657200473484,CSE 3,A50,083646,Miranda; Gregory Joseph,24,0,50,26
1657200479511,CSE 8A,A50,083650,Miranda; Gregory Joseph,17,1,56,39
1657200485545,CSE 11,A01,083080,Cao; Yingjun,5,15,40,35
1657200491577,CSE 12,A01,083652,Krause-Levy; Sophia Louisa,24,1,120,96
1657200497606,CSE 15L,A01,083654,Morris; Justin Loren,9,0,50,41
1657200497606,CSE 15L,A02,083655,Morris; Justin Loren,9,0,50,41
1657200503636,CSE 20,A01,083657,Tran; Khoa Dang,38,0,80,42
1657200509660,CSE 21,A01,095574,Bach; Quang Tran,22,0,48,26
1657200515692,CSE 30,A01,083084,Eldon; John,4,0,80,76
1657200515692,CSE 30,B01,095061,Bhaskar; Nishant,7,0,50,43
1657200521720,CSE 100,A01,083659,Cao; Yingjun,4,4,70,66
1657200527751,CSE 134B,A01,083661,Powell; Thomas Allan,20,0,100,80
1657200533776,CSE 140,A01,083663,Gungor; Onat,13,0,85,72
1657200539801,CSE 140L,A01,083088,Eldon; John,17,0,100,83
1657200545831,CSE 175,A01,083665,Kumar; Rakesh,3,0,25,22
1657200551863,CSE 190,A00,092507,Dubnov; Shlomo,7,0,20,13
1657200557900,ECE 45,A01,083139,Congero; Spencer William,5,0,75,70
1657200563933,ECE 65,A50,083695,Saad; Andrew S,12,0,30,18
1657200563933,ECE 65,A51,095125,Saad; Andrew S,25,0,26,1
1657200569960,ECE 109,A01,091882,Touri; Behrouz,19,0,70,51
1657200575987,ECE 180,A00,083140,Abi Samra; Nicholas Camill,1,0,30,29
1657200575987,ECE 180,B00,083141,Abi Samra; Nicholas Camill,0,0,30,30
1657200582014,MATH 10A,A01,083735,Patchell; Gregory David,2,0,30,28
1657200582014,MATH 10A,A02,083736,Patchell; Gregory David,20,0,30,10
1657200582014,MATH 10A,A03,083737,Patchell; Gregory David,16,0,30,14
1657200588045,MATH 10B,A01,083207,Lim; Seonhee,7,0,34,27
1657200588045,MATH 10B,A02,083208,Lim; Seonhee,9,0,35,26
1657200588045,MATH 10B,A03,093472,Lim; Seonhee,5,0,34,29
1657200588045,MATH 10B,B01,083739,Sinha; Shubham,10,0,30,20
1657200594084,MATH 18,A01,083743,Cinel; Cameron Alexander,6,0,30,24
1657200594084,MATH 18,A02,083744,Cinel; Cameron Alexander,15,0,30,15
1657200594084,MATH 18,A03,083745,Cinel; Cameron Alexander,8,0,30,22
1657200594084,MATH 18,B01,083748,Rideout; David Porter,4,0,37,33
1657200594084,MATH 18,B02,083749,Rideout; David Porter,4,0,36,32
1657200594084,MATH 18,B03,083750,Rideout; David Porter,2,0,37,35
1657200594084,MATH 18,B04,083751,Rideout; David Porter,5,0,36,31
1657200594084,MATH 18,B05,093473,Rideout; David Porter,5,0,36,31
1657200594084,MATH 18,B06,093474,Rideout; David Porter,5,0,36,31
1657200600115,MATH 20A,A01,083754,Zheng; Zequn,13,0,40,27
1657200606141,MATH 20B,A01,083756,Briones; Jor-el Thomas Caparas,1,0,36,35
1657200606141,MATH 20B,A02,083757,Briones; Jor-el Thomas Caparas,1,0,36,35
1657200606141,MATH 20B,A03,093475,Briones; Jor-el Thomas Caparas,1,0,36,35
1657200612168,MATH 20C,A01,083760,Briones; Jor-el Thomas Caparas,1,0,35,34
1657200612168,MATH 20C,A02,083761,Briones; Jor-el Thomas Caparas,8,0,35,27
1657200612168,MATH 20C,A03,093476,Briones; Jor-el Thomas Caparas,0,1,36,36
1657200612168,MATH 20C,B01,083762,Bach; Quang Tran,1,0,30,29
1657200618192,MATH 20D,A01,083765,Tran; Brian Kha,4,0,30,26
1657200618192,MATH 20D,A02,083766,Tran; Brian Kha,5,0,30,25
1657200618192,MATH 20D,A03,083767,Tran; Brian Kha,4,0,30,26
1657200624237,MATH 20E,A01,083771,Ganguly; Soumya,7,0,32,25
1657200624237,MATH 20E,A02,083772,Ganguly; Soumya,7,0,32,25
1657200624237,MATH 20E,B01,083773,Ciotti; Benjamin,19,0,35,16
1657200624237,MATH 20E,B02,083774,Ciotti; Benjamin,17,0,35,18
1657200630273,MATH 103A,A01,083777,Greenfeld; Be'Eri,2,0,36,34
1657200630273,MATH 103A,A02,083778,Greenfeld; Be'Eri,5,0,36,31
1657200630273,MATH 103A,A03,093561,Greenfeld; Be'Eri,4,0,36,32
1657200630273,MATH 103A,B01,083779,Greenfeld; Be'Eri,6,0,36,30
1657200630273,MATH 103A,B02,083780,Greenfeld; Be'Eri,3,0,36,33
1657200630273,MATH 103A,B03,093562,Greenfeld; Be'Eri,3,0,36,33
1657200636306,MATH 105,A01,085443,Carter; Anne Toulson,14,0,35,21
1657200636306,MATH 105,A02,093477,Carter; Anne Toulson,20,0,35,15
1657200642331,MATH 109,A01,083213,Ganzberger; Geoffrey Michael,2,0,34,32
1657200642331,MATH 109,A02,083214,Ganzberger; Geoffrey Michael,4,0,34,30
1657200642331,MATH 109,A03,093478,Ganzberger; Geoffrey Michael,1,0,34,33
1657200642331,MATH 109,B01,083215,Ganzberger; Geoffrey Michael,1,0,32,31
1657200642331,MATH 109,B02,083216,Ganzberger; Geoffrey Michael,1,0,32,31
1657200642331,MATH 109,B03,093479,Ganzberger; Geoffrey Michael,7,0,32,25
1657200648370,MATH 142A,A01,083219,Chow; Bennett,6,0,32,26
1657200648370,MATH 142A,A02,083220,Chow; Bennett,10,0,32,22
1657200648370,MATH 142A,A03,093480,Chow; Bennett,7,0,32,25
1657200648370,MATH 142A,B03,093481,Chow; Bennett,8,0,32,24
1657200648370,MATH 142A,B04,093558,Chow; Bennett,11,0,32,21
1657200648370,MATH 142A,B05,093559,Chow; Bennett,6,0,32,26
1657200654406,MATH 193A,A01,083224,Rotar; Vladimir,7,0,34,27
1657200654406,MATH 193A,A02,083225,Rotar; Vladimir,5,0,34,29
1657200654406,MATH 193A,A03,083781,Rotar; Vladimir,1,0,34,33
1657200654406,MATH 193A,A04,083782,Rotar; Vladimir,8,0,34,26
1657200654406,MATH 193A,A05,093482,Rotar; Vladimir,6,0,34,28
1657200660439,MATH 197,001,091859,McAuley; Julian John,9999,0,9999,0
1657200660439,MATH 197,002,095566,Kedlaya; Kiran S.,9997,0,9999,2
1657200660439,MATH 197,003,095567,Xiao; Ming,9999,0,9999,0
1657200660439,MATH 197,004,095571,Perols; Johan Lars,9998,0,9999,1
1657200667523,COGS 9,A01,083615,Shannon; Kyle Michael,7,0,75,68
1657200673550,COGS 11,A01,083617,Boyle; Mary E. T.,22,0,48,26
1657200679578,COGS 13,A01,083071,Bastos; Amalia Pinkusfeld,9,0,71,62
1657200685606,COGS 14A,A01,092681,Semenuks; Arturs,1,1,100,99
1657200691708,COGS 14B,A01,083073,Cheng; Tzu-Han,6,0,63,57
1657200697749,COGS 17,A01,092677,Semenuks; Arturs,4,0,81,77
1657200703782,COGS 100,A01,083619,Allen; Michael Gordon,15,0,70,55
1657200709813,COGS 101A,A01,083621,Davis; Joshua Daniel,9,0,68,59
1657200715838,COGS 101B,A01,091572,Allen; Michael Gordon,9,0,65,56
1657200721863,COGS 101C,A01,083625,Delgado; Tania,17,0,35,18
1657200727887,COGS 107A,A01,083627,Boyle; Mary E. T.,13,0,60,47
1657200733914,COGS 118A,A01,083075,Gupta; Anjum,16,0,76,60
1657200739945,CSE 3,A50,083646,Miranda; Gregory Joseph,24,0,50,26
1657200745976,CSE 8A,A50,083650,Miranda; Gregory Joseph,17,1,56,39
1657200752007,CSE 11,A01,083080,Cao; Yingjun,5,15,40,35
1657200758036,CSE 12,A01,083652,Krause-Levy; Sophia Louisa,24,1,120,96
1657200764072,CSE 15L,A01,083654,Morris; Justin Loren,9,0,50,41
1657200764072,CSE 15L,A02,083655,Morris; Justin Loren,9,0,50,41
1657200770110,CSE 20,A01,083657,Tran; Khoa Dang,38,0,80,42
1657200776142,CSE 21,A01,095574,Bach; Quang Tran,22,0,48,26
1657200782234,CSE 30,A01,083084,Eldon; John,4,0,80,76
1657200782234,CSE 30,B01,095061,Bhaskar; Nishant,7,0,50,43
1657200788285,CSE 100,A01,083659,Cao; Yingjun,4,4,70,66
1657200794312,CSE 134B,A01,083661,Powell; Thomas Allan,20,0,100,80
1657200800338,CSE 140,A01,083663,Gungor; Onat,13,0,85,72
1657200806373,CSE 140L,A01,083088,Eldon; John,17,0,100,83
1657200812401,CSE 175,A01,083665,Kumar; Rakesh,3,0,25,22
1657200818432,CSE 190,A00,092507,Dubnov; Shlomo,7,0,20,13
1657200824469,ECE 45,A01,083139,Congero; Spencer William,5,0,75,70
1657200830499,ECE 65,A50,083695,Saad; Andrew S,12,0,30,18
1657200830499,ECE 65,A51,095125,Saad; Andrew S,25,0,26,1
1657200836539,ECE 109,A01,091882,Touri; Behrouz,19,0,70,51
1657200842580,ECE 180,A00,083140,Abi Samra; Nicholas Camill,1,0,30,29
1657200842580,ECE 180,B00,083141,Abi Samra; Nicholas Camill,0,0,30,30
1657200848608,MATH 10A,A01,083735,Patchell; Gregory David,2,0,30,28
1657200848608,MATH 10A,A02,083736,Patchell; Gregory David,20,0,30,10
1657200848608,MATH 10A,A03,083737,Patchell; Gregory David,16,0,30,14
1657200854658,MATH 10B,A01,083207,Lim; Seonhee,7,0,34,27
1657200854658,MATH 10B,A02,083208,Lim; Seonhee,9,0,35,26
1657200854658,MATH 10B,A03,093472,Lim; Seonhee,5,0,34,29
1657200854658,MATH 10B,B01,083739,Sinha; Shubham,10,0,30,20
1657200860703,MATH 18,A01,083743,Cinel; Cameron Alexander,6,0,30,24
1657200860703,MATH 18,A02,083744,Cinel; Cameron Alexander,15,0,30,15
1657200860703,MATH 18,A03,083745,Cinel; Cameron Alexander,8,0,30,22
1657200860703,MATH 18,B01,083748,Rideout; David Porter,4,0,37,33
1657200860703,MATH 18,B02,083749,Rideout; David Porter,4,0,36,32
1657200860703,MATH 18,B03,083750,Rideout; David Porter,2,0,37,35
1657200860703,MATH 18,B04,083751,Rideout; David Porter,5,0,36,31
1657200860703,MATH 18,B05,093473,Rideout; David Porter,5,0,36,31
1657200860703,MATH 18,B06,093474,Rideout; David Porter,5,0,36,31
1657200866741,MATH 20A,A01,083754,Zheng; Zequn,13,0,40,27
1657200872780,MATH 20B,A01,083756,Briones; Jor-el Thomas Caparas,1,0,36,35
1657200872780,MATH 20B,A02,083757,Briones; Jor-el Thomas Caparas,1,0,36,35
1657200872780,MATH 20B,A03,093475,Briones; Jor-el Thomas Caparas,1,0,36,35
1657200878810,MATH 20C,A01,083760,Briones; Jor-el Thomas Caparas,1,0,35,34
1657200878810,MATH 20C,A02,083761,Briones; Jor-el Thomas Caparas,8,0,35,27
1657200878810,MATH 20C,A03,093476,Briones; Jor-el Thomas Caparas,0,1,36,36
1657200878810,MATH 20C,B01,083762,Bach; Quang Tran,1,0,30,29
1657200884851,MATH 20D,A01,083765,Tran; Brian Kha,4,0,30,26
1657200884851,MATH 20D,A02,083766,Tran; Brian Kha,5,0,30,25
1657200884851,MATH 20D,A03,083767,Tran; Brian Kha,4,0,30,26
1657200890896,MATH 20E,A01,083771,Ganguly; Soumya,7,0,32,25
1657200890896,MATH 20E,A02,083772,Ganguly; Soumya,7,0,32,25
1657200890896,MATH 20E,B01,083773,Ciotti; Benjamin,19,0,35,16
1657200890896,MATH 20E,B02,083774,Ciotti; Benjamin,17,0,35,18
1657200896954,MATH 103A,A01,083777,Greenfeld; Be'Eri,2,0,36,34
1657200896954,MATH 103A,A02,083778,Greenfeld; Be'Eri,5,0,36,31
1657200896954,MATH 103A,A03,093561,Greenfeld; Be'Eri,4,0,36,32
1657200896954,MATH 103A,B01,083779,Greenfeld; Be'Eri,6,0,36,30
1657200896954,MATH 103A,B02,083780,Greenfeld; Be'Eri,3,0,36,33
1657200896954,MATH 103A,B03,093562,Greenfeld; Be'Eri,3,0,36,33
1657200902982,MATH 105,A01,085443,Carter; Anne Toulson,14,0,35,21
1657200902982,MATH 105,A02,093477,Carter; Anne Toulson,20,0,35,15
1657200909019,MATH 109,A01,083213,Ganzberger; Geoffrey Michael,2,0,34,32
1657200909019,MATH 109,A02,083214,Ganzberger; Geoffrey Michael,4,0,34,30
1657200909019,MATH 109,A03,093478,Ganzberger; Geoffrey Michael,1,0,34,33
1657200909019,MATH 109,B01,083215,Ganzberger; Geoffrey Michael,1,0,32,31
1657200909019,MATH 109,B02,083216,Ganzberger; Geoffrey Michael,1,0,32,31
1657200909019,MATH 109,B03,093479,Ganzberger; Geoffrey Michael,7,0,32,25
1657200915055,MATH 142A,A01,083219,Chow; Bennett,6,0,32,26
1657200915055,MATH 142A,A02,083220,Chow; Bennett,10,0,32,22
1657200915055,MATH 142A,A03,093480,Chow; Bennett,7,0,32,25
1657200915055,MATH 142A,B03,093481,Chow; Bennett,8,0,32,24
1657200915055,MATH 142A,B04,093558,Chow; Bennett,11,0,32,21
1657200915055,MATH 142A,B05,093559,Chow; Bennett,6,0,32,26
1657200921088,MATH 193A,A01,083224,Rotar; Vladimir,7,0,34,27
1657200921088,MATH 193A,A02,083225,Rotar; Vladimir,5,0,34,29
1657200921088,MATH 193A,A03,083781,Rotar; Vladimir,1,0,34,33
1657200921088,MATH 193A,A04,083782,Rotar; Vladimir,8,0,34,26
1657200921088,MATH 193A,A05,093482,Rotar; Vladimir,6,0,34,28
1657200927115,MATH 197,001,091859,McAuley; Julian John,9999,0,9999,0
1657200927115,MATH 197,002,095566,Kedlaya; Kiran S.,9997,0,9999,2
1657200927115,MATH 197,003,095567,Xiao; Ming,9999,0,9999,0
1657200927115,MATH 197,004,095571,Perols; Johan Lars,9998,0,9999,1
1657200934190,COGS 9,A01,083615,Shannon; Kyle Michael,7,0,75,68
1657200940217,COGS 11,A01,083617,Boyle; Mary E. T.,22,0,48,26
1657200946256,COGS 13,A01,083071,Bastos; Amalia Pinkusfeld,9,0,71,62
1657200952284,COGS 14A,A01,092681,Semenuks; Arturs,1,1,100,99
1657200958317,COGS 14B,A01,083073,Cheng; Tzu-Han,6,0,63,57
1657200964344,COGS 17,A01,092677,Semenuks; Arturs,4,0,81,77
1657200970370,COGS 100,A01,083619,Allen; Michael Gordon,15,0,70,55
1657200976397,COGS 101A,A01,083621,Davis; Joshua Daniel,9,0,68,59
1657200982428,COGS 101B,A01,091572,Allen; Michael Gordon,9,0,65,56
1657200988454,COGS 101C,A01,083625,Delgado; Tania,17,0,35,18
1657200994480,COGS 107A,A01,083627,Boyle; Mary E. T.,13,0,60,47
1657201000506,COGS 118A,A01,083075,Gupta; Anjum,16,0,76,60
1657201006535,CSE 3,A50,083646,Miranda; Gregory Joseph,24,0,50,26
1657201012567,CSE 8A,A50,083650,Miranda; Gregory Joseph,17,1,56,39
1657201018597,CSE 11,A01,083080,Cao; Yingjun,5,15,40,35
1657201024622,CSE 12,A01,083652,Krause-Levy; Sophia Louisa,24,1,120,96
1657201030653,CSE 15L,A01,083654,Morris; Justin Loren,9,0,50,41
1657201030653,CSE 15L,A02,083655,Morris; Justin Loren,9,0,50,41
1657201036686,CSE 20,A01,083657,Tran; Khoa Dang,38,0,80,42
1657201042717,CSE 21,A01,095574,Bach; Quang Tran,22,0,48,26
1657201048748,CSE 30,A01,083084,Eldon; John,4,0,80,76
1657201048748,CSE 30,B01,095061,Bhaskar; Nishant,7,0,50,43
1657201054774,CSE 100,A01,083659,Cao; Yingjun,4,4,70,66
1657201060807,CSE 134B,A01,083661,Powell; Thomas Allan,20,0,100,80
1657201066838,CSE 140,A01,083663,Gungor; Onat,13,0,85,72
1657201072863,CSE 140L,A01,083088,Eldon; John,17,0,100,83
1657201078889,CSE 175,A01,083665,Kumar; Rakesh,3,0,25,22
1657201084915,CSE 190,A00,092507,Dubnov; Shlomo,7,0,20,13
1657201090950,ECE 45,A01,083139,Congero; Spencer William,5,0,75,70
1657201096977,ECE 65,A50,083695,Saad; Andrew S,12,0,30,18
1657201096977,ECE 65,A51,095125,Saad; Andrew S,25,0,26,1
1657201103010,ECE 109,A01,091882,Touri; Behrouz,19,0,70,51
1657201109061,ECE 180,A00,083140,Abi Samra; Nicholas Camill,1,0,30,29
1657201109061,ECE 180,B00,083141,Abi Samra; Nicholas Camill,0,0,30,30
1657201115090,MATH 10A,A01,083735,Patchell; Gregory David,2,0,30,28
1657201115090,MATH 10A,A02,083736,Patchell; Gregory David,20,0,30,10
1657201115090,MATH 10A,A03,083737,Patchell; Gregory David,16,0,30,14
1657201121119,MATH 10B,A01,083207,Lim; Seonhee,7,0,34,27
1657201121119,MATH 10B,A02,083208,Lim; Seonhee,9,0,35,26
1657201121119,MATH 10B,A03,093472,Lim; Seonhee,5,0,34,29
1657201121119,MATH 10B,B01,083739,Sinha; Shubham,10,0,30,20
1657201127148,MATH 18,A01,083743,Cinel; Cameron Alexander,6,0,30,24
1657201127148,MATH 18,A02,083744,Cinel; Cameron Alexander,15,0,30,15
1657201127148,MATH 18,A03,083745,Cinel; Cameron Alexander,8,0,30,22
1657201127148,MATH 18,B01,083748,Rideout; David Porter,4,0,37,33
1657201127148,MATH 18,B02,083749,Rideout; David Porter,4,0,36,32
1657201127148,MATH 18,B03,083750,Rideout; David Porter,2,0,37,35
1657201127148,MATH 18,B04,083751,Rideout; David Porter,5,0,36,31
1657201127148,MATH 18,B05,093473,Rideout; David Porter,5,0,36,31
1657201127148,MATH 18,B06,093474,Rideout; David Porter,5,0,36,31
1657201133178,MATH 20A,A01,083754,Zheng; Zequn,13,0,40,27
1657201139222,MATH 20B,A01,083756,Briones; Jor-el Thomas Caparas,1,0,36,35
1657201139222,MATH 20B,A02,083757,Briones; Jor-el Thomas Caparas,1,0,36,35
1657201139222,MATH 20B,A03,093475,Briones; Jor-el Thomas Caparas,1,0,36,35
1657201145258,MATH 20C,A01,083760,Briones; Jor-el Thomas Caparas,1,0,35,34
1657201145258,MATH 20C,A02,083761,Briones; Jor-el Thomas Caparas,8,0,35,27
1657201145258,MATH 20C,A03,093476,Briones; Jor-el Thomas Caparas,0,1,36,36
1657201145258,MATH 20C,B01,083762,Bach; Quang Tran,1,0,30,29
1657201151287,MATH 20D,A01,083765,Tran; Brian Kha,4,0,30,26
1657201151287,MATH 20D,A02,083766,Tran; Brian Kha,5,0,30,25
1657201151287,MATH 20D,A03,083767,Tran; Brian Kha,4,0,30,26
1657201157315,MATH 20E,A01,083771,Ganguly; Soumya,7,0,32,25
1657201157315,MATH 20E,A02,083772,Ganguly; Soumya,7,0,32,25
1657201157315,MATH 20E,B01,083773,Ciotti; Benjamin,19,0,35,16
1657201157315,MATH 20E,B02,083774,Ciotti; Benjamin,17,0,35,18
1657201163345,MATH 103A,A01,083777,Greenfeld; Be'Eri,2,0,36,34
1657201163345,MATH 103A,A02,083778,Greenfeld; Be'Eri,5,0,36,31
1657201163345,MATH 103A,A03,093561,Greenfeld; Be'Eri,4,0,36,32
1657201163345,MATH 103A,B01,083779,Greenfeld; Be'Eri,6,0,36,30
1657201163345,MATH 103A,B02,083780,Greenfeld; Be'Eri,3,0,36,33
1657201163345,MATH 103A,B03,093562,Greenfeld; Be'Eri,3,0,36,33
1657201169371,MATH 105,A01,085443,Carter; Anne Toulson,14,0,35,21
1657201169371,MATH 105,A02,093477,Carter; Anne Toulson,20,0,35,15
1657201175399,MATH 109,A01,083213,Ganzberger; Geoffrey Michael,2,0,34,32
1657201175399,MATH 109,A02,083214,Ganzberger; Geoffrey Michael,4,0,34,30
1657201175399,MATH 109,A03,093478,Ganzberger; Geoffrey Michael,1,0,34,33
1657201175399,MATH 109,B01,083215,Ganzberger; Geoffrey Michael,1,0,32,31
1657201175399,MATH 109,B02,083216,Ganzberger; Geoffrey Michael,1,0,32,31
1657201175399,MATH 109,B03,093479,Ganzberger; Geoffrey Michael,7,0,32,25
1657201181440,MATH 142A,A01,083219,Chow; Bennett,6,0,32,26
1657201181440,MATH 142A,A02,083220,Chow; Bennett,10,0,32,22
1657201181440,MATH 142A,A03,093480,Chow; Bennett,7,0,32,25
1657201181440,MATH 142A,B03,093481,Chow; Bennett,8,0,32,24
1657201181440,MATH 142A,B04,093558,Chow; Bennett,11,0,32,21
1657201181440,MATH 142A,B05,093559,Chow; Bennett,6,0,32,26
1657201187466,MATH 193A,A01,083224,Rotar; Vladimir,7,0,34,27
1657201187466,MATH 193A,A02,083225,Rotar; Vladimir,5,0,34,29
1657201187466,MATH 193A,A03,083781,Rotar; Vladimir,1,0,34,33
1657201187466,MATH 193A,A04,083782,Rotar; Vladimir,8,0,34,26
1657201187466,MATH 193A,A05,093482,Rotar; Vladimir,6,0,34,28
1657201193497,MATH 197,001,091859,McAuley; Julian John,9999,0,9999,0
1657201193497,MATH 197,002,095566,Kedlaya; Kiran S.,9997,0,9999,2
1657201193497,MATH 197,003,095567,Xiao; Ming,9999,0,9999,0
1657201193497,MATH 197,004,095571,Perols; Johan Lars,9998,0,9999,1
1657201200578,COGS 9,A01,083615,Shannon; Kyle Michael,7,0,75,68
1657201206602,COGS 11,A01,083617,Boyle; Mary E. T.,22,0,48,26
1657201212627,COGS 13,A01,083071,Bastos; Amalia Pinkusfeld,9,0,71,62
1657201218674,COGS 14A,A01,092681,Semenuks; Arturs,1,1,100,99
1657201224703,COGS 14B,A01,083073,Cheng; Tzu-Han,6,0,63,57
1657201230732,COGS 17,A01,092677,Semenuks; Arturs,4,0,81,77
1657201236763,COGS 100,A01,083619,Allen; Michael Gordon,15,0,70,55
1657201242790,COGS 101A,A01,083621,Davis; Joshua Daniel,9,0,68,59
1657201248814,COGS 101B,A01,091572,Allen; Michael Gordon,9,0,65,56
1657201254851,COGS 101C,A01,083625,Delgado; Tania,17,0,35,18
1657201260877,COGS 107A,A01,083627,Boyle; Mary E. T.,13,0,60,47
1657201266910,COGS 118A,A01,083075,Gupta; Anjum,16,0,76,60
1657201272947,CSE 3,A50,083646,Miranda; Gregory Joseph,24,0,50,26
1657201278974,CSE 8A,A50,083650,Miranda; Gregory Joseph,17,1,56,39
1657201284999,CSE 11,A01,083080,Cao; Yingjun,5,15,40,35
1657201291099,CSE 12,A01,083652,Krause-Levy; Sophia Louisa,24,1,120,96
1657201297130,CSE 15L,A01,083654,Morris; Justin Loren,9,0,50,41
1657201297130,CSE 15L,A02,083655,Morris; Justin Loren,9,0,50,41
1657201303156,CSE 20,A01,083657,Tran; Khoa Dang,38,0,80,42
1657201309190,CSE 21,A01,095574,Bach; Quang Tran,22,0,48,26
1657201315234,CSE 30,A01,083084,Eldon; John,4,0,80,76
1657201315234,CSE 30,B01,095061,Bhaskar; Nishant,7,0,50,43
1657201321271,CSE 100,A01,083659,Cao; Yingjun,4,4,70,66
1657201327296,CSE 134B,A01,083661,Powell; Thomas Allan,20,0,100,80
1657201333322,CSE 140,A01,083663,Gungor; Onat,13,0,85,72
1657201339352,CSE 140L,A01,083088,Eldon; John,17,0,100,83
1657201345380,CSE 175,A01,083665,Kumar; Rakesh,3,0,25,22
1657201351412,CSE 190,A00,092507,Dubnov; Shlomo,7,0,20,13
1657201357441,ECE 45,A01,083139,Congero; Spencer William,5,0,75,70
1657201363471,ECE 65,A50,083695,Saad; Andrew S,12,0,30,18
1657201363471,ECE 65,A51,095125,Saad; Andrew S,25,0,26,1
1657201369499,ECE 109,A01,091882,Touri; Behrouz,19,0,70,51
1657201375530,ECE 180,A00,083140,Abi Samra; Nicholas Camill,1,0,30,29
1657201375530,ECE 180,B00,083141,Abi Samra; Nicholas Camill,0,0,30,30
1657201381560,MATH 10A,A01,083735,Patchell; Gregory David,2,0,30,28
1657201381560,MATH 10A,A02,083736,Patchell; Gregory David,20,0,30,10
1657201381560,MATH 10A,A03,083737,Patchell; Gregory David,16,0,30,14
1657201387602,MATH 10B,A01,083207,Lim; Seonhee,7,0,34,27
1657201387602,MATH 10B,A02,083208,Lim; Seonhee,9,0,35,26
1657201387602,MATH 10B,A03,093472,Lim; Seonhee,5,0,34,29
1657201387602,MATH 10B,B01,083739,Sinha; Shubham,10,0,30,20
1657201393643,MATH 18,A01,083743,Cinel; Cameron Alexander,6,0,30,24
1657201393643,MATH 18,A02,083744,Cinel; Cameron Alexander,15,0,30,15
1657201393643,MATH 18,A03,083745,Cinel; Cameron Alexander,8,0,30,22
1657201393643,MATH 18,B01,083748,Rideout; David Porter,4,0,37,33
1657201393643,MATH 18,B02,083749,Rideout; David Porter,4,0,36,32
1657201393643,MATH 18,B03,083750,Rideout; David Porter,2,0,37,35
1657201393643,MATH 18,B04,083751,Rideout; David Porter,5,0,36,31
1657201393643,MATH 18,B05,093473,Rideout; David Porter,5,0,36,31
1657201393643,MATH 18,B06,093474,Rideout; David Porter,5,0,36,31
1657201399676,MATH 20A,A01,083754,Zheng; Zequn,13,0,40,27
1657201405700,MATH 20B,A01,083756,Briones; Jor-el Thomas Caparas,1,0,36,35
1657201405700,MATH 20B,A02,083757,Briones; Jor-el Thomas Caparas,1,0,36,35
1657201405700,MATH 20B,A03,093475,Briones; Jor-el Thomas Caparas,1,0,36,35
1657201411733,MATH 20C,A01,083760,Briones; Jor-el Thomas Caparas,1,0,35,34
1657201411733,MATH 20C,A02,083761,Briones; Jor-el Thomas Caparas,8,0,35,27
1657201411733,MATH 20C,A03,093476,Briones; Jor-el Thomas Caparas,0,1,36,36
1657201411733,MATH 20C,B01,083762,Bach; Quang Tran,1,0,30,29
1657201417758,MATH 20D,A01,083765,Tran; Brian Kha,4,0,30,26
1657201417758,MATH 20D,A02,083766,Tran; Brian Kha,5,0,30,25
1657201417758,MATH 20D,A03,083767,Tran; Brian Kha,4,0,30,26
1657201423791,MATH 20E,A01,083771,Ganguly; Soumya,7,0,32,25
1657201423791,MATH 20E,A02,083772,Ganguly; Soumya,7,0,32,25
1657201423791,MATH 20E,B01,083773,Ciotti; Benjamin,19,0,35,16
1657201423791,MATH 20E,B02,083774,Ciotti; Benjamin,17,0,35,18
1657201429836,MATH 103A,A01,083777,Greenfeld; Be'Eri,2,0,36,34
1657201429836,MATH 103A,A02,083778,Greenfeld; Be'Eri,5,0,36,31
1657201429836,MATH 103A,A03,093561,Greenfeld; Be'Eri,4,0,36,32
1657201429836,MATH 103A,B01,083779,Greenfeld; Be'Eri,6,0,36,30
1657201429836,MATH 103A,B02,083780,Greenfeld; Be'Eri,3,0,36,33
1657201429836,MATH 103A,B03,093562,Greenfeld; Be'Eri,3,0,36,33
1657201435865,MATH 105,A01,085443,Carter; Anne Toulson,14,0,35,21
1657201435865,MATH 105,A02,093477,Carter; Anne Toulson,20,0,35,15
1657201441893,MATH 109,A01,083213,Ganzberger; Geoffrey Michael,2,0,34,32
1657201441893,MATH 109,A02,083214,Ganzberger; Geoffrey Michael,4,0,34,30
1657201441893,MATH 109,A03,093478,Ganzberger; Geoffrey Michael,1,0,34,33
1657201441893,MATH 109,B01,083215,Ganzberger; Geoffrey Michael,1,0,32,31
1657201441893,MATH 109,B02,083216,Ganzberger; Geoffrey Michael,1,0,32,31
1657201441893,MATH 109,B03,093479,Ganzberger; Geoffrey Michael,7,0,32,25
1657201447928,MATH 142A,A01,083219,Chow; Bennett,6,0,32,26
1657201447928,MATH 142A,A02,083220,Chow; Bennett,10,0,32,22
1657201447928,MATH 142A,A03,093480,Chow; Bennett,7,0,32,25
1657201447928,MATH 142A,B03,093481,Chow; Bennett,8,0,32,24
1657201447928,MATH 142A,B04,093558,Chow; Bennett,11,0,32,21
1657201447928,MATH 142A,B05,093559,Chow; Bennett,6,0,32,26
1657201453955,MATH 193A,A01,083224,Rotar; Vladimir,7,0,34,27
1657201453955,MATH 193A,A02,083225,Rotar; Vladimir,5,0,34,29
1657201453955,MATH 193A,A03,083781,Rotar; Vladimir,1,0,34,33
1657201453955,MATH 193A,A04,083782,Rotar; Vladimir,8,0,34,26
1657201453955,MATH 193A,A05,093482,Rotar; Vladimir,6,0,34,28
1657201459981,MATH 197,001,091859,McAuley; Julian John,9999,0,9999,0
1657201459981,MATH 197,002,095566,Kedlaya; Kiran S.,9997,0,9999,2
1657201459981,MATH 197,003,095567,Xiao; Ming,9999,0,9999,0
1657201459981,MATH 197,004,095571,Perols; Johan Lars,9998,0,9999,1
1657201467048,COGS 9,A01,083615,Shannon; Kyle Michael,7,0,75,68
1657201473074,COGS 11,A01,083617,Boyle; Mary E. T.,22,0,48,26
1657201479103,COGS 13,A01,083071,Bastos; Amalia Pinkusfeld,9,0,71,62
1657201485129,COGS 14A,A01,092681,Semenuks; Arturs,1,1,100,99
1657201491161,COGS 14B,A01,083073,Cheng; Tzu-Han,6,0,63,57
1657201497197,COGS 17,A01,092677,Semenuks; Arturs,4,0,81,77
1657201503223,COGS 100,A01,083619,Allen; Michael Gordon,15,0,70,55
1657201509256,COGS 101A,A01,083621,Davis; Joshua Daniel,9,0,68,59
1657201515288,COGS 101B,A01,091572,Allen; Michael Gordon,9,0,65,56
1657201521315,COGS 101C,A01,083625,Delgado; Tania,17,0,35,18
1657201527341,COGS 107A,A01,083627,Boyle; Mary E. T.,13,0,60,47
1657201533372,COGS 118A,A01,083075,Gupta; Anjum,16,0,76,60
1657201539410,CSE 3,A50,083646,Miranda; Gregory Joseph,24,0,50,26
1657201545439,CSE 8A,A50,083650,Miranda; Gregory Joseph,17,1,56,39
1657201551464,CSE 11,A01,083080,Cao; Yingjun,5,15,40,35
1657201557493,CSE 12,A01,083652,Krause-Levy; Sophia Louisa,24,1,120,96
1657201563525,CSE 15L,A01,083654,Morris; Justin Loren,9,0,50,41
1657201563525,CSE 15L,A02,083655,Morris; Justin Loren,9,0,50,41
1657201569552,CSE 20,A01,083657,Tran; Khoa Dang,38,0,80,42
1657201575579,CSE 21,A01,095574,Bach; Quang Tran,22,0,48,26
1657201581617,CSE 30,A01,083084,Eldon; John,4,0,80,76
1657201581617,CSE 30,B01,095061,Bhaskar; Nishant,7,0,50,43
1657201587646,CSE 100,A01,083659,Cao; Yingjun,4,4,70,66
1657201593677,CSE 134B,A01,083661,Powell; Thomas Allan,20,0,100,80
1657201599704,CSE 140,A01,083663,Gungor; Onat,13,0,85,72
1657201605730,CSE 140L,A01,083088,Eldon; John,17,0,100,83
1657201611758,CSE 175,A01,083665,Kumar; Rakesh,3,0,25,22
1657201617801,CSE 190,A00,092507,Dubnov; Shlomo,7,0,20,13
1657201623830,ECE 45,A01,083139,Congero; Spencer William,5,0,75,70
1657201629857,ECE 65,A50,083695,Saad; Andrew S,12,0,30,18
1657201629857,ECE 65,A51,095125,Saad; Andrew S,25,0,26,1
1657201635918,ECE 109,A01,091882,Touri; Behrouz,19,0,70,51
1657201641945,ECE 180,A00,083140,Abi Samra; Nicholas Camill,1,0,30,29
1657201641945,ECE 180,B00,083141,Abi Samra; Nicholas Camill,0,0,30,30
1657201647985,MATH 10A,A01,083735,Patchell; Gregory David,2,0,30,28
1657201647985,MATH 10A,A02,083736,Patchell; Gregory David,20,0,30,10
1657201647985,MATH 10A,A03,083737,Patchell; Gregory David,16,0,30,14
1657201654027,MATH 10B,A01,083207,Lim; Seonhee,7,0,34,27
1657201654027,MATH 10B,A02,083208,Lim; Seonhee,9,0,35,26
1657201654027,MATH 10B,A03,093472,Lim; Seonhee,5,0,34,29
1657201654027,MATH 10B,B01,083739,Sinha; Shubham,10,0,30,20
1657201660094,MATH 18,A01,083743,Cinel; Cameron Alexander,6,0,30,24
1657201660094,MATH 18,A02,083744,Cinel; Cameron Alexander,15,0,30,15
1657201660094,MATH 18,A03,083745,Cinel; Cameron Alexander,8,0,30,22
1657201660094,MATH 18,B01,083748,Rideout; David Porter,4,0,37,33
1657201660094,MATH 18,B02,083749,Rideout; David Porter,4,0,36,32
1657201660094,MATH 18,B03,083750,Rideout; David Porter,2,0,37,35
1657201660094,MATH 18,B04,083751,Rideout; David Porter,5,0,36,31
1657201660094,MATH 18,B05,093473,Rideout; David Porter,5,0,36,31
1657201660094,MATH 18,B06,093474,Rideout; David Porter,5,0,36,31
1657201666128,MATH 20A,A01,083754,Zheng; Zequn,13,0,40,27
1657201672164,MATH 20B,A01,083756,Briones; Jor-el Thomas Caparas,1,0,36,35
1657201672164,MATH 20B,A02,083757,Briones; Jor-el Thomas Caparas,1,0,36,35
1657201672164,MATH 20B,A03,093475,Briones; Jor-el Thomas Caparas,1,0,36,35
1657201678195,MATH 20C,A01,083760,Briones; Jor-el Thomas Caparas,1,0,35,34
1657201678195,MATH 20C,A02,083761,Briones; Jor-el Thomas Caparas,8,0,35,27
1657201678195,MATH 20C,A03,093476,Briones; Jor-el Thomas Caparas,0,1,36,36
1657201678195,MATH 20C,B01,083762,Bach; Quang Tran,1,0,30,29
1657201684226,MATH 20D,A01,083765,Tran; Brian Kha,4,0,30,26
1657201684226,MATH 20D,A02,083766,Tran; Brian Kha,5,0,30,25
1657201684226,MATH 20D,A03,083767,Tran; Brian Kha,4,0,30,26
1657201690255,MATH 20E,A01,083771,Ganguly; Soumya,7,0,32,25
1657201690255,MATH 20E,A02,083772,Ganguly; Soumya,7,0,32,25
1657201690255,MATH 20E,B01,083773,Ciotti; Benjamin,19,0,35,16
1657201690255,MATH 20E,B02,083774,Ciotti; Benjamin,17,0,35,18
1657201696294,MATH 103A,A01,083777,Greenfeld; Be'Eri,2,0,36,34
1657201696294,MATH 103A,A02,083778,Greenfeld; Be'Eri,5,0,36,31
1657201696294,MATH 103A,A03,093561,Greenfeld; Be'Eri,4,0,36,32
1657201696294,MATH 103A,B01,083779,Greenfeld; Be'Eri,6,0,36,30
1657201696294,MATH 103A,B02,083780,Greenfeld; Be'Eri,3,0,36,33
1657201696294,MATH 103A,B03,093562,Greenfeld; Be'Eri,3,0,36,33
1657201702327,MATH 105,A01,085443,Carter; Anne Toulson,14,0,35,21
1657201702327,MATH 105,A02,093477,Carter; Anne Toulson,20,0,35,15
1657201708359,MATH 109,A01,083213,Ganzberger; Geoffrey Michael,2,0,34,32
1657201708359,MATH 109,A02,083214,Ganzberger; Geoffrey Michael,4,0,34,30
1657201708359,MATH 109,A03,093478,Ganzberger; Geoffrey Michael,1,0,34,33
1657201708359,MATH 109,B01,083215,Ganzberger; Geoffrey Michael,1,0,32,31
1657201708359,MATH 109,B02,083216,Ganzberger; Geoffrey Michael,1,0,32,31
1657201708359,MATH 109,B03,093479,Ganzberger; Geoffrey Michael,7,0,32,25
1657201714400,MATH 142A,A01,083219,Chow; Bennett,6,0,32,26
1657201714400,MATH 142A,A02,083220,Chow; Bennett,10,0,32,22
1657201714400,MATH 142A,A03,093480,Chow; Bennett,7,0,32,25
1657201714400,MATH 142A,B03,093481,Chow; Bennett,8,0,32,24
1657201714400,MATH 142A,B04,093558,Chow; Bennett,11,0,32,21
1657201714400,MATH 142A,B05,093559,Chow; Bennett,6,0,32,26
1657201720442,MATH 193A,A01,083224,Rotar; Vladimir,7,0,34,27
1657201720442,MATH 193A,A02,083225,Rotar; Vladimir,5,0,34,29
1657201720442,MATH 193A,A03,083781,Rotar; Vladimir,1,0,34,33
1657201720442,MATH 193A,A04,083782,Rotar; Vladimir,8,0,34,26
1657201720442,MATH 193A,A05,093482,Rotar; Vladimir,6,0,34,28
1657201726471,MATH 197,001,091859,McAuley; Julian John,9999,0,9999,0
1657201726471,MATH 197,002,095566,Kedlaya; Kiran S.,9997,0,9999,2
1657201726471,MATH 197,003,095567,Xiao; Ming,9999,0,9999,0
1657201726471,MATH 197,004,095571,Perols; Johan Lars,9998,0,9999,1
1657201733560,COGS 9,A01,083615,Shannon; Kyle Michael,7,0,75,68
1657201739589,COGS 11,A01,083617,Boyle; Mary E. T.,22,0,48,26
1657201745622,COGS 13,A01,083071,Bastos; Amalia Pinkusfeld,9,0,71,62
1657201751666,COGS 14A,A01,092681,Semenuks; Arturs,1,1,100,99
1657201757704,COGS 14B,A01,083073,Cheng; Tzu-Han,6,0,63,57
1657201763732,COGS 17,A01,092677,Semenuks; Arturs,4,0,81,77
1657201769764,COGS 100,A01,083619,Allen; Michael Gordon,15,0,70,55
1657201775792,COGS 101A,A01,083621,Davis; Joshua Daniel,9,0,68,59
1657201781833,COGS 101B,A01,091572,Allen; Michael Gordon,9,0,65,56
1657201787863,COGS 101C,A01,083625,Delgado; Tania,17,0,35,18
1657201793917,COGS 107A,A01,083627,Boyle; Mary E. T.,13,0,60,47
1657201799953,COGS 118A,A01,083075,Gupta; Anjum,16,0,76,60
1657201805981,CSE 3,A50,083646,Miranda; Gregory Joseph,24,0,50,26
1657201812012,CSE 8A,A50,083650,Miranda; Gregory Joseph,17,1,56,39
1657201818039,CSE 11,A01,083080,Cao; Yingjun,5,15,40,35
1657201824078,CSE 12,A01,083652,Krause-Levy; Sophia Louisa,24,1,120,96
1657201830108,CSE 15L,A01,083654,Morris; Justin Loren,9,0,50,41
1657201830108,CSE 15L,A02,083655,Morris; Justin Loren,9,0,50,41
1657201836135,CSE 20,A01,083657,Tran; Khoa Dang,38,0,80,42
1657201842162,CSE 21,A01,095574,Bach; Quang Tran,22,0,48,26
1657201848202,CSE 30,A01,083084,Eldon; John,4,0,80,76
1657201848202,CSE 30,B01,095061,Bhaskar; Nishant,7,0,50,43
1657201854233,CSE 100,A01,083659,Cao; Yingjun,4,4,70,66
1657201860262,CSE 134B,A01,083661,Powell; Thomas Allan,20,0,100,80
1657201866295,CSE 140,A01,083663,Gungor; Onat,13,0,85,72
1657201872329,CSE 140L,A01,083088,Eldon; John,17,0,100,83
1657201878359,CSE 175,A01,083665,Kumar; Rakesh,3,0,25,22
1657201884390,CSE 190,A00,092507,Dubnov; Shlomo,7,0,20,13
1657201890492,ECE 45,A01,083139,Congero; Spencer William,5,0,75,70
1657201896530,ECE 65,A50,083695,Saad; Andrew S,12,0,30,18
1657201896530,ECE 65,A51,095125,Saad; Andrew S,25,0,26,1
1657201902557,ECE 109,A01,091882,Touri; Behrouz,19,0,70,51
1657201908592,ECE 180,A00,083140,Abi Samra; Nicholas Camill,1,0,30,29
1657201908592,ECE 180,B00,083141,Abi Samra; Nicholas Camill,0,0,30,30
1657201914625,MATH 10A,A01,083735,Patchell; Gregory David,2,0,30,28
1657201914625,MATH 10A,A02,083736,Patchell; Gregory David,20,0,30,10
1657201914625,MATH 10A,A03,083737,Patchell; Gregory David,16,0,30,14
1657201920657,MATH 10B,A01,083207,Lim; Seonhee,7,0,34,27
1657201920657,MATH 10B,A02,083208,Lim; Seonhee,9,0,35,26
1657201920657,MATH 10B,A03,093472,Lim; Seonhee,5,0,34,29
1657201920657,MATH 10B,B01,083739,Sinha; Shubham,10,0,30,20
1657201926690,MATH 18,A01,083743,Cinel; Cameron Alexander,6,0,30,24
1657201926690,MATH 18,A02,083744,Cinel; Cameron Alexander,15,0,30,15
1657201926690,MATH 18,A03,083745,Cinel; Cameron Alexander,8,0,30,22
1657201926690,MATH 18,B01,083748,Rideout; David Porter,4,0,37,33
1657201926690,MATH 18,B02,083749,Rideout; David Porter,4,0,36,32
1657201926690,MATH 18,B03,083750,Rideout; David Porter,2,0,37,35
1657201926690,MATH 18,B04,083751,Rideout; David Porter,5,0,36,31
1657201926690,MATH 18,B05,093473,Rideout; David Porter,5,0,36,31
1657201926690,MATH 18,B06,093474,Rideout; David Porter,5,0,36,31
1657201932724,MATH 20A,A01,083754,Zheng; Zequn,13,0,40,27
1657201938752,MATH 20B,A01,083756,Briones; Jor-el Thomas Caparas,1,0,36,35
1657201938752,MATH 20B,A02,083757,Briones; Jor-el Thomas Caparas,1,0,36,35
1657201938752,MATH 20B,A03,093475,Briones; Jor-el Thomas Caparas,1,0,36,35
1657201944788,MATH 20C,A01,083760,Briones; Jor-el Thomas Caparas,1,0,35,34
1657201944788,MATH 20C,A02,083761,Briones; Jor-el Thomas Caparas,8,0,35,27
1657201944788,MATH 20C,A03,093476,Briones; Jor-el Thomas Caparas,0,1,36,36
1657201944788,MATH 20C,B01,083762,Bach; Quang Tran,1,0,30,29
1657201950820,MATH 20D,A01,083765,Tran; Brian Kha,4,0,30,26
1657201950820,MATH 20D,A02,083766,Tran; Brian Kha,5,0,30,25
1657201950820,MATH 20D,A03,083767,Tran; Brian Kha,4,0,30,26
1657201956847,MATH 20E,A01,083771,Ganguly; Soumya,7,0,32,25
1657201956847,MATH 20E,A02,083772,Ganguly; Soumya,7,0,32,25
1657201956847,MATH 20E,B01,083773,Ciotti; Benjamin,19,0,35,16
1657201956847,MATH 20E,B02,083774,Ciotti; Benjamin,17,0,35,18
1657201962893,MATH 103A,A01,083777,Greenfeld; Be'Eri,2,0,36,34
1657201962893,MATH 103A,A02,083778,Greenfeld; Be'Eri,5,0,36,31
1657201962893,MATH 103A,A03,093561,Greenfeld; Be'Eri,4,0,36,32
1657201962893,MATH 103A,B01,083779,Greenfeld; Be'Eri,6,0,36,30
1657201962893,MATH 103A,B02,083780,Greenfeld; Be'Eri,3,0,36,33
1657201962893,MATH 103A,B03,093562,Greenfeld; Be'Eri,3,0,36,33
1657201968924,MATH 105,A01,085443,Carter; Anne Toulson,14,0,35,21
1657201968924,MATH 105,A02,093477,Carter; Anne Toulson,20,0,35,15
1657201974966,MATH 109,A01,083213,Ganzberger; Geoffrey Michael,2,0,34,32
1657201974966,MATH 109,A02,083214,Ganzberger; Geoffrey Michael,4,0,34,30
1657201974966,MATH 109,A03,093478,Ganzberger; Geoffrey Michael,1,0,34,33
1657201974966,MATH 109,B01,083215,Ganzberger; Geoffrey Michael,1,0,32,31
1657201974966,MATH 109,B02,083216,Ganzberger; Geoffrey Michael,1,0,32,31
1657201974966,MATH 109,B03,093479,Ganzberger; Geoffrey Michael,7,0,32,25
1657201980992,MATH 142A,A01,083219,Chow; Bennett,6,0,32,26
1657201980992,MATH 142A,A02,083220,Chow; Bennett,10,0,32,22
1657201980992,MATH 142A,A03,093480,Chow; Bennett,7,0,32,25
1657201980992,MATH 142A,B03,093481,Chow; Bennett,8,0,32,24
1657201980992,MATH 142A,B04,093558,Chow; Bennett,11,0,32,21
1657201980992,MATH 142A,B05,093559,Chow; Bennett,6,0,32,26
1657201987022,MATH 193A,A01,083224,Rotar; Vladimir,7,0,34,27
1657201987022,MATH 193A,A02,083225,Rotar; Vladimir,5,0,34,29
1657201987022,MATH 193A,A03,083781,Rotar; Vladimir,1,0,34,33
1657201987022,MATH 193A,A04,083782,Rotar; Vladimir,8,0,34,26
1657201987022,MATH 193A,A05,093482,Rotar; Vladimir,6,0,34,28
1657201993049,MATH 197,001,091859,McAuley; Julian John,9999,0,9999,0
1657201993049,MATH 197,002,095566,Kedlaya; Kiran S.,9997,0,9999,2
1657201993049,MATH 197,003,095567,Xiao; Ming,9999,0,9999,0
1657201993049,MATH 197,004,095571,Perols; Johan Lars,9998,0,9999,1
1657202000118,COGS 9,A01,083615,Shannon; Kyle Michael,7,0,75,68
1657202006149,COGS 11,A01,083617,Boyle; Mary E. T.,22,0,48,26
1657202012176,COGS 13,A01,083071,Bastos; Amalia Pinkusfeld,9,0,71,62
1657202018204,COGS 14A,A01,092681,Semenuks; Arturs,1,1,100,99
1657202024237,COGS 14B,A01,083073,Cheng; Tzu-Han,6,0,63,57
1657202030294,COGS 17,A01,092677,Semenuks; Arturs,4,0,81,77
1657202036322,COGS 100,A01,083619,Allen; Michael Gordon,15,0,70,55
1657202042364,COGS 101A,A01,083621,Davis; Joshua Daniel,9,0,68,59
1657202048390,COGS 101B,A01,091572,Allen; Michael Gordon,9,0,65,56
1657202054421,COGS 101C,A01,083625,Delgado; Tania,17,0,35,18
1657202060453,COGS 107A,A01,083627,Boyle; Mary E. T.,13,0,60,47
1657202066485,COGS 118A,A01,083075,Gupta; Anjum,16,0,76,60
1657202072513,CSE 3,A50,083646,Miranda; Gregory Joseph,24,0,50,26
1657202078543,CSE 8A,A50,083650,Miranda; Gregory Joseph,17,1,56,39
1657202084568,CSE 11,A01,083080,Cao; Yingjun,5,15,40,35
1657202090604,CSE 12,A01,083652,Krause-Levy; Sophia Louisa,24,1,120,96
1657202096635,CSE 15L,A01,083654,Morris; Justin Loren,9,0,50,41
1657202096635,CSE 15L,A02,083655,Morris; Justin Loren,9,0,50,41
1657202102678,CSE 20,A01,083657,Tran; Khoa Dang,38,0,80,42
1657202108709,CSE 21,A01,095574,Bach; Quang Tran,22,0,48,26
1657202114740,CSE 30,A01,083084,Eldon; John,4,0,80,76
1657202114740,CSE 30,B01,095061,Bhaskar; Nishant,7,0,50,43
1657202120775,CSE 100,A01,083659,Cao; Yingjun,4,4,70,66
1657202126807,CSE 134B,A01,083661,Powell; Thomas Allan,20,0,100,80
1657202132847,CSE 140,A01,083663,Gungor; Onat,13,0,85,72
1657202138875,CSE 140L,A01,083088,Eldon; John,17,0,100,83
1657202144901,CSE 175,A01,083665,Kumar; Rakesh,3,0,25,22
1657202150937,CSE 190,A00,092507,Dubnov; Shlomo,7,0,20,13
1657202156974,ECE 45,A01,083139,Congero; Spencer William,5,0,75,70
1657202163007,ECE 65,A50,083695,Saad; Andrew S,12,0,30,18
1657202163007,ECE 65,A51,095125,Saad; Andrew S,25,0,26,1
1657202169033,ECE 109,A01,091882,Touri; Behrouz,19,0,70,51
1657202175060,ECE 180,A00,083140,Abi Samra; Nicholas Camill,1,0,30,29
1657202175060,ECE 180,B00,083141,Abi Samra; Nicholas Camill,0,0,30,30
1657202181087,MATH 10A,A01,083735,Patchell; Gregory David,2,0,30,28
1657202181087,MATH 10A,A02,083736,Patchell; Gregory David,20,0,30,10
1657202181087,MATH 10A,A03,083737,Patchell; Gregory David,16,0,30,14
1657202187125,MATH 10B,A01,083207,Lim; Seonhee,7,0,34,27
1657202187125,MATH 10B,A02,083208,Lim; Seonhee,9,0,35,26
1657202187125,MATH 10B,A03,093472,Lim; Seonhee,5,0,34,29
1657202187125,MATH 10B,B01,083739,Sinha; Shubham,10,0,30,20
1657202193170,MATH 18,A01,083743,Cinel; Cameron Alexander,6,0,30,24
1657202193170,MATH 18,A02,083744,Cinel; Cameron Alexander,15,0,30,15
1657202193170,MATH 18,A03,083745,Cinel; Cameron Alexander,8,0,30,22
1657202193170,MATH 18,B01,083748,Rideout; David Porter,4,0,37,33
1657202193170,MATH 18,B02,083749,Rideout; David Porter,4,0,36,32
1657202193170,MATH 18,B03,083750,Rideout; David Porter,2,0,37,35
1657202193170,MATH 18,B04,083751,Rideout; David Porter,5,0,36,31
1657202193170,MATH 18,B05,093473,Rideout; David Porter,5,0,36,31
1657202193170,MATH 18,B06,093474,Rideout; David Porter,5,0,36,31
1657202199204,MATH 20A,A01,083754,Zheng; Zequn,13,0,40,27
1657202205237,MATH 20B,A01,083756,Briones; Jor-el Thomas Caparas,1,0,36,35
1657202205237,MATH 20B,A02,083757,Briones; Jor-el Thomas Caparas,1,0,36,35
1657202205237,MATH 20B,A03,093475,Briones; Jor-el Thomas Caparas,1,0,36,35
1657202211295,MATH 20C,A01,083760,Briones; Jor-el Thomas Caparas,1,0,35,34
1657202211295,MATH 20C,A02,083761,Briones; Jor-el Thomas Caparas,8,0,35,27
1657202211295,MATH 20C,A03,093476,Briones; Jor-el Thomas Caparas,0,1,36,36
1657202211295,MATH 20C,B01,083762,Bach; Quang Tran,1,0,30,29
1657202217327,MATH 20D,A01,083765,Tran; Brian Kha,4,0,30,26
1657202217327,MATH 20D,A02,083766,Tran; Brian Kha,5,0,30,25
1657202217327,MATH 20D,A03,083767,Tran; Brian Kha,4,0,30,26
1657202223354,MATH 20E,A01,083771,Ganguly; Soumya,7,0,32,25
1657202223354,MATH 20E,A02,083772,Ganguly; Soumya,7,0,32,25
1657202223354,MATH 20E,B01,083773,Ciotti; Benjamin,19,0,35,16
1657202223354,MATH 20E,B02,083774,Ciotti; Benjamin,17,0,35,18
1657202229392,MATH 103A,A01,083777,Greenfeld; Be'Eri,2,0,36,34
1657202229392,MATH 103A,A02,083778,Greenfeld; Be'Eri,5,0,36,31
1657202229392,MATH 103A,A03,093561,Greenfeld; Be'Eri,4,0,36,32
1657202229392,MATH 103A,B01,083779,Greenfeld; Be'Eri,6,0,36,30
1657202229392,MATH 103A,B02,083780,Greenfeld; Be'Eri,3,0,36,33
1657202229392,MATH 103A,B03,093562,Greenfeld; Be'Eri,3,0,36,33
1657202235418,MATH 105,A01,085443,Carter; Anne Toulson,14,0,35,21
1657202235418,MATH 105,A02,093477,Carter; Anne Toulson,20,0,35,15
1657202241453,MATH 109,A01,083213,Ganzberger; Geoffrey Michael,2,0,34,32
1657202241453,MATH 109,A02,083214,Ganzberger; Geoffrey Michael,4,0,34,30
1657202241453,MATH 109,A03,093478,Ganzberger; Geoffrey Michael,1,0,34,33
1657202241453,MATH 109,B01,083215,Ganzberger; Geoffrey Michael,1,0,32,31
1657202241453,MATH 109,B02,083216,Ganzberger; Geoffrey Michael,1,0,32,31
1657202241453,MATH 109,B03,093479,Ganzberger; Geoffrey Michael,7,0,32,25
1657202247482,MATH 142A,A01,083219,Chow; Bennett,6,0,32,26
1657202247482,MATH 142A,A02,083220,Chow; Bennett,10,0,32,22
1657202247482,MATH 142A,A03,093480,Chow; Bennett,7,0,32,25
1657202247482,MATH 142A,B03,093481,Chow; Bennett,8,0,32,24
1657202247482,MATH 142A,B04,093558,Chow; Bennett,11,0,32,21
1657202247482,MATH 142A,B05,093559,Chow; Bennett,6,0,32,26
1657202253509,MATH 193A,A01,083224,Rotar; Vladimir,7,0,34,27
1657202253509,MATH 193A,A02,083225,Rotar; Vladimir,5,0,34,29
1657202253509,MATH 193A,A03,083781,Rotar; Vladimir,1,0,34,33
1657202253509,MATH 193A,A04,083782,Rotar; Vladimir,8,0,34,26
1657202253509,MATH 193A,A05,093482,Rotar; Vladimir,6,0,34,28
1657202259534,MATH 197,001,091859,McAuley; Julian John,9999,0,9999,0
1657202259534,MATH 197,002,095566,Kedlaya; Kiran S.,9997,0,9999,2
1657202259534,MATH 197,003,095567,Xiao; Ming,9999,0,9999,0
1657202259534,MATH 197,004,095571,Perols; Johan Lars,9998,0,9999,1
1657202266611,COGS 9,A01,083615,Shannon; Kyle Michael,7,0,75,68
1657202272637,COGS 11,A01,083617,Boyle; Mary E. T.,22,0,48,26
1657202278667,COGS 13,A01,083071,Bastos; Amalia Pinkusfeld,9,0,71,62
1657202284698,COGS 14A,A01,092681,Semenuks; Arturs,1,1,100,99
1657202290727,COGS 14B,A01,083073,Cheng; Tzu-Han,6,0,63,57
1657202296752,COGS 17,A01,092677,Semenuks; Arturs,4,0,81,77
1657202302778,COGS 100,A01,083619,Allen; Michael Gordon,15,0,70,55
1657202308804,COGS 101A,A01,083621,Davis; Joshua Daniel,9,0,68,59
1657202314829,COGS 101B,A01,091572,Allen; Michael Gordon,9,0,65,56
1657202320858,COGS 101C,A01,083625,Delgado; Tania,17,0,35,18
1657202326882,COGS 107A,A01,083627,Boyle; Mary E. T.,13,0,60,47
1657202332907,COGS 118A,A01,083075,Gupta; Anjum,16,0,76,60
1657202338938,CSE 3,A50,083646,Miranda; Gregory Joseph,24,0,50,26
1657202344969,CSE 8A,A50,083650,Miranda; Gregory Joseph,17,1,56,39
1657202350995,CSE 11,A01,083080,Cao; Yingjun,5,15,40,35
1657202357023,CSE 12,A01,083652,Krause-Levy; Sophia Louisa,24,1,120,96
1657202363054,CSE 15L,A01,083654,Morris; Justin Loren,9,0,50,41
1657202363054,CSE 15L,A02,083655,Morris; Justin Loren,9,0,50,41
1657202369085,CSE 20,A01,083657,Tran; Khoa Dang,38,0,80,42
1657202375129,CSE 21,A01,095574,Bach; Quang Tran,22,0,48,26
1657202381158,CSE 30,A01,083084,Eldon; John,4,0,80,76
1657202381158,CSE 30,B01,095061,Bhaskar; Nishant,7,0,50,43
1657202387184,CSE 100,A01,083659,Cao; Yingjun,4,4,70,66
1657202393210,CSE 134B,A01,083661,Powell; Thomas Allan,20,0,100,80
1657202399248,CSE 140,A01,083663,Gungor; Onat,13,0,85,72
1657202405275,CSE 140L,A01,083088,Eldon; John,17,0,100,83
1657202411308,CSE 175,A01,083665,Kumar; Rakesh,3,0,25,22
1657202417333,CSE 190,A00,092507,Dubnov; Shlomo,7,0,20,13
1657202423360,ECE 45,A01,083139,Congero; Spencer William,5,0,75,70
1657202429385,ECE 65,A50,083695,Saad; Andrew S,12,0,30,18
1657202429385,ECE 65,A51,095125,Saad; Andrew S,25,0,26,1
1657202435414,ECE 109,A01,091882,Touri; Behrouz,19,0,70,51
1657202441445,ECE 180,A00,083140,Abi Samra; Nicholas Camill,1,0,30,29
1657202441445,ECE 180,B00,083141,Abi Samra; Nicholas Camill,0,0,30,30
1657202447471,MATH 10A,A01,083735,Patchell; Gregory David,2,0,30,28
1657202447471,MATH 10A,A02,083736,Patchell; Gregory David,20,0,30,10
1657202447471,MATH 10A,A03,083737,Patchell; Gregory David,16,0,30,14
1657202453497,MATH 10B,A01,083207,Lim; Seonhee,7,0,34,27
1657202453497,MATH 10B,A02,083208,Lim; Seonhee,9,0,35,26
1657202453497,MATH 10B,A03,093472,Lim; Seonhee,5,0,34,29
1657202453497,MATH 10B,B01,083739,Sinha; Shubham,10,0,30,20
1657202459527,MATH 18,A01,083743,Cinel; Cameron Alexander,6,0,30,24
1657202459527,MATH 18,A02,083744,Cinel; Cameron Alexander,15,0,30,15
1657202459527,MATH 18,A03,083745,Cinel; Cameron Alexander,8,0,30,22
1657202459527,MATH 18,B01,083748,Rideout; David Porter,4,0,37,33
1657202459527,MATH 18,B02,083749,Rideout; David Porter,4,0,36,32
1657202459527,MATH 18,B03,083750,Rideout; David Porter,2,0,37,35
1657202459527,MATH 18,B04,083751,Rideout; David Porter,5,0,36,31
1657202459527,MATH 18,B05,093473,Rideout; David Porter,5,0,36,31
1657202459527,MATH 18,B06,093474,Rideout; David Porter,5,0,36,31
1657202465564,MATH 20A,A01,083754,Zheng; Zequn,13,0,40,27
1657202471591,MATH 20B,A01,083756,Briones; Jor-el Thomas Caparas,1,0,36,35
1657202471591,MATH 20B,A02,083757,Briones; Jor-el Thomas Caparas,1,0,36,35
1657202471591,MATH 20B,A03,093475,Briones; Jor-el Thomas Caparas,1,0,36,35
1657202477635,MATH 20C,A01,083760,Briones; Jor-el Thomas Caparas,1,0,35,34
1657202477635,MATH 20C,A02,083761,Briones; Jor-el Thomas Caparas,8,0,35,27
1657202477635,MATH 20C,A03,093476,Briones; Jor-el Thomas Caparas,0,1,36,36
1657202477635,MATH 20C,B01,083762,Bach; Quang Tran,1,0,30,29
1657202483662,MATH 20D,A01,083765,Tran; Brian Kha,4,0,30,26
1657202483662,MATH 20D,A02,083766,Tran; Brian Kha,5,0,30,25
1657202483662,MATH 20D,A03,083767,Tran; Brian Kha,4,0,30,26
1657202489761,MATH 20E,A01,083771,Ganguly; Soumya,7,0,32,25
1657202489761,MATH 20E,A02,083772,Ganguly; Soumya,7,0,32,25
1657202489761,MATH 20E,B01,083773,Ciotti; Benjamin,19,0,35,16
1657202489761,MATH 20E,B02,083774,Ciotti; Benjamin,17,0,35,18
1657202495789,MATH 103A,A01,083777,Greenfeld; Be'Eri,2,0,36,34
1657202495789,MATH 103A,A02,083778,Greenfeld; Be'Eri,5,0,36,31
1657202495789,MATH 103A,A03,093561,Greenfeld; Be'Eri,4,0,36,32
1657202495789,MATH 103A,B01,083779,Greenfeld; Be'Eri,6,0,36,30
1657202495789,MATH 103A,B02,083780,Greenfeld; Be'Eri,3,0,36,33
1657202495789,MATH 103A,B03,093562,Greenfeld; Be'Eri,3,0,36,33
1657202501828,MATH 105,A01,085443,Carter; Anne Toulson,14,0,35,21
1657202501828,MATH 105,A02,093477,Carter; Anne Toulson,20,0,35,15
1657202507857,MATH 109,A01,083213,Ganzberger; Geoffrey Michael,2,0,34,32
1657202507857,MATH 109,A02,083214,Ganzberger; Geoffrey Michael,4,0,34,30
1657202507857,MATH 109,A03,093478,Ganzberger; Geoffrey Michael,1,0,34,33
1657202507857,MATH 109,B01,083215,Ganzberger; Geoffrey Michael,1,0,32,31
1657202507857,MATH 109,B02,083216,Ganzberger; Geoffrey Michael,1,0,32,31
1657202507857,MATH 109,B03,093479,Ganzberger; Geoffrey Michael,7,0,32,25
1657202513885,MATH 142A,A01,083219,Chow; Bennett,6,0,32,26
1657202513885,MATH 142A,A02,083220,Chow; Bennett,10,0,32,22
1657202513885,MATH 142A,A03,093480,Chow; Bennett,7,0,32,25
1657202513885,MATH 142A,B03,093481,Chow; Bennett,8,0,32,24
1657202513885,MATH 142A,B04,093558,Chow; Bennett,11,0,32,21
1657202513885,MATH 142A,B05,093559,Chow; Bennett,6,0,32,26
1657202519918,MATH 193A,A01,083224,Rotar; Vladimir,7,0,34,27
1657202519918,MATH 193A,A02,083225,Rotar; Vladimir,5,0,34,29
1657202519918,MATH 193A,A03,083781,Rotar; Vladimir,1,0,34,33
1657202519918,MATH 193A,A04,083782,Rotar; Vladimir,8,0,34,26
1657202519918,MATH 193A,A05,093482,Rotar; Vladimir,6,0,34,28
1657202525964,MATH 197,001,091859,McAuley; Julian John,9999,0,9999,0
1657202525964,MATH 197,002,095566,Kedlaya; Kiran S.,9997,0,9999,2
1657202525964,MATH 197,003,095567,Xiao; Ming,9999,0,9999,0
1657202525964,MATH 197,004,095571,Perols; Johan Lars,9998,0,9999,1
1657202533046,COGS 9,A01,083615,Shannon; Kyle Michael,7,0,75,68
1657202539089,COGS 11,A01,083617,Boyle; Mary E. T.,22,0,48,26
1657202545113,COGS 13,A01,083071,Bastos; Amalia Pinkusfeld,9,0,71,62
1657202551139,COGS 14A,A01,092681,Semenuks; Arturs,1,1,100,99
1657202557174,COGS 14B,A01,083073,Cheng; Tzu-Han,6,0,63,57
1657202563200,COGS 17,A01,092677,Semenuks; Arturs,4,0,81,77
1657202569232,COGS 100,A01,083619,Allen; Michael Gordon,15,0,70,55
1657202575266,COGS 101A,A01,083621,Davis; Joshua Daniel,9,0,68,59
1657202581291,COGS 101B,A01,091572,Allen; Michael Gordon,9,0,65,56
1657202587324,COGS 101C,A01,083625,Delgado; Tania,17,0,35,18
1657202593365,COGS 107A,A01,083627,Boyle; Mary E. T.,13,0,60,47
1657202599399,COGS 118A,A01,083075,Gupta; Anjum,16,0,76,60
1657202605436,CSE 3,A50,083646,Miranda; Gregory Joseph,24,0,50,26
1657202611462,CSE 8A,A50,083650,Miranda; Gregory Joseph,17,1,56,39
1657202617487,CSE 11,A01,083080,Cao; Yingjun,5,15,40,35
1657202623521,CSE 12,A01,083652,Krause-Levy; Sophia Louisa,24,1,120,96
1657202629554,CSE 15L,A01,083654,Morris; Justin Loren,9,0,50,41
1657202629554,CSE 15L,A02,083655,Morris; Justin Loren,9,0,50,41
1657202635588,CSE 20,A01,083657,Tran; Khoa Dang,38,0,80,42
1657202641614,CSE 21,A01,095574,Bach; Quang Tran,22,0,48,26
1657202647662,CSE 30,A01,083084,Eldon; John,4,0,80,76
1657202647662,CSE 30,B01,095061,Bhaskar; Nishant,7,0,50,43
1657202653695,CSE 100,A01,083659,Cao; Yingjun,4,4,70,66
1657202659723,CSE 134B,A01,083661,Powell; Thomas Allan,20,0,100,80
1657202665766,CSE 140,A01,083663,Gungor; Onat,13,0,85,72
1657202671796,CSE 140L,A01,083088,Eldon; John,17,0,100,83
1657202677819,CSE 175,A01,083665,Kumar; Rakesh,3,0,25,22
1657202683861,CSE 190,A00,092507,Dubnov; Shlomo,7,0,20,13
1657202689889,ECE 45,A01,083139,Congero; Spencer William,5,0,75,70
1657202695938,ECE 65,A50,083695,Saad; Andrew S,12,0,30,18
1657202695938,ECE 65,A51,095125,Saad; Andrew S,25,0,26,1
1657202701970,ECE 109,A01,091882,Touri; Behrouz,19,0,70,51
1657202708005,ECE 180,A00,083140,Abi Samra; Nicholas Camill,1,0,30,29
1657202708005,ECE 180,B00,083141,Abi Samra; Nicholas Camill,0,0,30,30
1657202714038,MATH 10A,A01,083735,Patchell; Gregory David,2,0,30,28
1657202714038,MATH 10A,A02,083736,Patchell; Gregory David,20,0,30,10
1657202714038,MATH 10A,A03,083737,Patchell; Gregory David,16,0,30,14
1657202720073,MATH 10B,A01,083207,Lim; Seonhee,7,0,34,27
1657202720073,MATH 10B,A02,083208,Lim; Seonhee,9,0,35,26
1657202720073,MATH 10B,A03,093472,Lim; Seonhee,5,0,34,29
1657202720073,MATH 10B,B01,083739,Sinha; Shubham,10,0,30,20
1657202726107,MATH 18,A01,083743,Cinel; Cameron Alexander,6,0,30,24
1657202726107,MATH 18,A02,083744,Cinel; Cameron Alexander,15,0,30,15
1657202726107,MATH 18,A03,083745,Cinel; Cameron Alexander,8,0,30,22
1657202726107,MATH 18,B01,083748,Rideout; David Porter,4,0,37,33
1657202726107,MATH 18,B02,083749,Rideout; David Porter,4,0,36,32
1657202726107,MATH 18,B03,083750,Rideout; David Porter,2,0,37,35
1657202726107,MATH 18,B04,083751,Rideout; David Porter,5,0,36,31
1657202726107,MATH 18,B05,093473,Rideout; David Porter,5,0,36,31
1657202726107,MATH 18,B06,093474,Rideout; David Porter,5,0,36,31
1657202732143,MATH 20A,A01,083754,Zheng; Zequn,13,0,40,27
1657202738170,MATH 20B,A01,083756,Briones; Jor-el Thomas Caparas,1,0,36,35
1657202738170,MATH 20B,A02,083757,Briones; Jor-el Thomas Caparas,1,0,36,35
1657202738170,MATH 20B,A03,093475,Briones; Jor-el Thomas Caparas,1,0,36,35
1657202744202,MATH 20C,A01,083760,Briones; Jor-el Thomas Caparas,1,0,35,34
1657202744202,MATH 20C,A02,083761,Briones; Jor-el Thomas Caparas,8,0,35,27
1657202744202,MATH 20C,A03,093476,Briones; Jor-el Thomas Caparas,0,1,36,36
1657202744202,MATH 20C,B01,083762,Bach; Quang Tran,1,0,30,29
1657202750227,MATH 20D,A01,083765,Tran; Brian Kha,4,0,30,26
1657202750227,MATH 20D,A02,083766,Tran; Brian Kha,5,0,30,25
1657202750227,MATH 20D,A03,083767,Tran; Brian Kha,4,0,30,26
1657202756261,MATH 20E,A01,083771,Ganguly; Soumya,7,0,32,25
1657202756261,MATH 20E,A02,083772,Ganguly; Soumya,7,0,32,25
1657202756261,MATH 20E,B01,083773,Ciotti; Benjamin,19,0,35,16
1657202756261,MATH 20E,B02,083774,Ciotti; Benjamin,17,0,35,18
1657202762288,MATH 103A,A01,083777,Greenfeld; Be'Eri,2,0,36,34
1657202762288,MATH 103A,A02,083778,Greenfeld; Be'Eri,5,0,36,31
1657202762288,MATH 103A,A03,093561,Greenfeld; Be'Eri,4,0,36,32
1657202762288,MATH 103A,B01,083779,Greenfeld; Be'Eri,6,0,36,30
1657202762288,MATH 103A,B02,083780,Greenfeld; Be'Eri,3,0,36,33
1657202762288,MATH 103A,B03,093562,Greenfeld; Be'Eri,3,0,36,33
1657202768313,MATH 105,A01,085443,Carter; Anne Toulson,14,0,35,21
1657202768313,MATH 105,A02,093477,Carter; Anne Toulson,20,0,35,15
1657202774337,MATH 109,A01,083213,Ganzberger; Geoffrey Michael,2,0,34,32
1657202774337,MATH 109,A02,083214,Ganzberger; Geoffrey Michael,4,0,34,30
1657202774337,MATH 109,A03,093478,Ganzberger; Geoffrey Michael,1,0,34,33
1657202774337,MATH 109,B01,083215,Ganzberger; Geoffrey Michael,1,0,32,31
1657202774337,MATH 109,B02,083216,Ganzberger; Geoffrey Michael,1,0,32,31
1657202774337,MATH 109,B03,093479,Ganzberger; Geoffrey Michael,7,0,32,25
1657202780367,MATH 142A,A01,083219,Chow; Bennett,6,0,32,26
1657202780367,MATH 142A,A02,083220,Chow; Bennett,10,0,32,22
1657202780367,MATH 142A,A03,093480,Chow; Bennett,7,0,32,25
1657202780367,MATH 142A,B03,093481,Chow; Bennett,8,0,32,24
1657202780367,MATH 142A,B04,093558,Chow; Bennett,11,0,32,21
1657202780367,MATH 142A,B05,093559,Chow; Bennett,6,0,32,26
1657202786392,MATH 193A,A01,083224,Rotar; Vladimir,7,0,34,27
1657202786392,MATH 193A,A02,083225,Rotar; Vladimir,5,0,34,29
1657202786392,MATH 193A,A03,083781,Rotar; Vladimir,1,0,34,33
1657202786392,MATH 193A,A04,083782,Rotar; Vladimir,8,0,34,26
1657202786392,MATH 193A,A05,093482,Rotar; Vladimir,6,0,34,28
1657202792421,MATH 197,001,091859,McAuley; Julian John,9999,0,9999,0
1657202792421,MATH 197,002,095566,Kedlaya; Kiran S.,9997,0,9999,2
1657202792421,MATH 197,003,095567,Xiao; Ming,9999,0,9999,0
1657202792421,MATH 197,004,095571,Perols; Johan Lars,9998,0,9999,1
1657202799518,COGS 9,A01,083615,Shannon; Kyle Michael,7,0,75,68
1657202805548,COGS 11,A01,083617,Boyle; Mary E. T.,22,0,48,26
1657202811575,COGS 13,A01,083071,Bastos; Amalia Pinkusfeld,9,0,71,62
1657202817609,COGS 14A,A01,092681,Semenuks; Arturs,1,1,100,99
1657202823635,COGS 14B,A01,083073,Cheng; Tzu-Han,6,0,63,57
1657202829661,COGS 17,A01,092677,Semenuks; Arturs,4,0,81,77
1657202835690,COGS 100,A01,083619,Allen; Michael Gordon,15,0,70,55
1657202841723,COGS 101A,A01,083621,Davis; Joshua Daniel,9,0,68,59
1657202847760,COGS 101B,A01,091572,Allen; Michael Gordon,9,0,65,56
1657202853794,COGS 101C,A01,083625,Delgado; Tania,17,0,35,18
1657202859834,COGS 107A,A01,083627,Boyle; Mary E. T.,13,0,60,47
1657202865864,COGS 118A,A01,083075,Gupta; Anjum,16,0,76,60
1657202871899,CSE 3,A50,083646,Miranda; Gregory Joseph,24,0,50,26
1657202877939,CSE 8A,A50,083650,Miranda; Gregory Joseph,17,1,56,39
1657202883963,CSE 11,A01,083080,Cao; Yingjun,5,15,40,35
1657202889996,CSE 12,A01,083652,Krause-Levy; Sophia Louisa,24,1,120,96
1657202896028,CSE 15L,A01,083654,Morris; Justin Loren,9,0,50,41
1657202896028,CSE 15L,A02,083655,Morris; Justin Loren,9,0,50,41
1657202902058,CSE 20,A01,083657,Tran; Khoa Dang,38,0,80,42
1657202908090,CSE 21,A01,095574,Bach; Quang Tran,22,0,48,26
1657202914120,CSE 30,A01,083084,Eldon; John,4,0,80,76
1657202914120,CSE 30,B01,095061,Bhaskar; Nishant,7,0,50,43
1657202920143,CSE 100,A01,083659,Cao; Yingjun,4,4,70,66
1657202926173,CSE 134B,A01,083661,Powell; Thomas Allan,20,0,100,80
1657202932200,CSE 140,A01,083663,Gungor; Onat,13,0,85,72
1657202938227,CSE 140L,A01,083088,Eldon; John,17,0,100,83
1657202944260,CSE 175,A01,083665,Kumar; Rakesh,3,0,25,22
1657202950284,CSE 190,A00,092507,Dubnov; Shlomo,7,0,20,13
1657202956311,ECE 45,A01,083139,Congero; Spencer William,5,0,75,70
1657202962338,ECE 65,A50,083695,Saad; Andrew S,12,0,30,18
1657202962338,ECE 65,A51,095125,Saad; Andrew S,25,0,26,1
1657202968364,ECE 109,A01,091882,Touri; Behrouz,19,0,70,51
1657202974390,ECE 180,A00,083140,Abi Samra; Nicholas Camill,1,0,30,29
1657202974390,ECE 180,B00,083141,Abi Samra; Nicholas Camill,0,0,30,30
1657202980426,MATH 10A,A01,083735,Patchell; Gregory David,2,0,30,28
1657202980426,MATH 10A,A02,083736,Patchell; Gregory David,20,0,30,10
1657202980426,MATH 10A,A03,083737,Patchell; Gregory David,16,0,30,14
1657202986474,MATH 10B,A01,083207,Lim; Seonhee,7,0,34,27
1657202986474,MATH 10B,A02,083208,Lim; Seonhee,9,0,35,26
1657202986474,MATH 10B,A03,093472,Lim; Seonhee,5,0,34,29
1657202986474,MATH 10B,B01,083739,Sinha; Shubham,10,0,30,20
1657202992504,MATH 18,A01,083743,Cinel; Cameron Alexander,6,0,30,24
1657202992504,MATH 18,A02,083744,Cinel; Cameron Alexander,15,0,30,15
1657202992504,MATH 18,A03,083745,Cinel; Cameron Alexander,8,0,30,22
1657202992504,MATH 18,B01,083748,Rideout; David Porter,4,0,37,33
1657202992504,MATH 18,B02,083749,Rideout; David Porter,4,0,36,32
1657202992504,MATH 18,B03,083750,Rideout; David Porter,2,0,37,35
1657202992504,MATH 18,B04,083751,Rideout; David Porter,5,0,36,31
1657202992504,MATH 18,B05,093473,Rideout; David Porter,5,0,36,31
1657202992504,MATH 18,B06,093474,Rideout; David Porter,5,0,36,31
1657202998529,MATH 20A,A01,083754,Zheng; Zequn,13,0,40,27
1657203004556,MATH 20B,A01,083756,Briones; Jor-el Thomas Caparas,1,0,36,35
1657203004556,MATH 20B,A02,083757,Briones; Jor-el Thomas Caparas,1,0,36,35
1657203004556,MATH 20B,A03,093475,Briones; Jor-el Thomas Caparas,1,0,36,35
1657203010584,MATH 20C,A01,083760,Briones; Jor-el Thomas Caparas,1,0,35,34
1657203010584,MATH 20C,A02,083761,Briones; Jor-el Thomas Caparas,8,0,35,27
1657203010584,MATH 20C,A03,093476,Briones; Jor-el Thomas Caparas,0,1,36,36
1657203010584,MATH 20C,B01,083762,Bach; Quang Tran,1,0,30,29
1657203016616,MATH 20D,A01,083765,Tran; Brian Kha,4,0,30,26
1657203016616,MATH 20D,A02,083766,Tran; Brian Kha,5,0,30,25
1657203016616,MATH 20D,A03,083767,Tran; Brian Kha,4,0,30,26
1657203022658,MATH 20E,A01,083771,Ganguly; Soumya,7,0,32,25
1657203022658,MATH 20E,A02,083772,Ganguly; Soumya,7,0,32,25
1657203022658,MATH 20E,B01,083773,Ciotti; Benjamin,19,0,35,16
1657203022658,MATH 20E,B02,083774,Ciotti; Benjamin,17,0,35,18
1657203028685,MATH 103A,A01,083777,Greenfeld; Be'Eri,2,0,36,34
1657203028685,MATH 103A,A02,083778,Greenfeld; Be'Eri,5,0,36,31
1657203028685,MATH 103A,A03,093561,Greenfeld; Be'Eri,4,0,36,32
1657203028685,MATH 103A,B01,083779,Greenfeld; Be'Eri,6,0,36,30
1657203028685,MATH 103A,B02,083780,Greenfeld; Be'Eri,3,0,36,33
1657203028685,MATH 103A,B03,093562,Greenfeld; Be'Eri,3,0,36,33
1657203034713,MATH 105,A01,085443,Carter; Anne Toulson,14,0,35,21
1657203034713,MATH 105,A02,093477,Carter; Anne Toulson,20,0,35,15
1657203040745,MATH 109,A01,083213,Ganzberger; Geoffrey Michael,2,0,34,32
1657203040745,MATH 109,A02,083214,Ganzberger; Geoffrey Michael,4,0,34,30
1657203040745,MATH 109,A03,093478,Ganzberger; Geoffrey Michael,1,0,34,33
1657203040745,MATH 109,B01,083215,Ganzberger; Geoffrey Michael,1,0,32,31
1657203040745,MATH 109,B02,083216,Ganzberger; Geoffrey Michael,1,0,32,31
1657203040745,MATH 109,B03,093479,Ganzberger; Geoffrey Michael,7,0,32,25
1657203046782,MATH 142A,A01,083219,Chow; Bennett,6,0,32,26
1657203046782,MATH 142A,A02,083220,Chow; Bennett,10,0,32,22
1657203046782,MATH 142A,A03,093480,Chow; Bennett,7,0,32,25
1657203046782,MATH 142A,B03,093481,Chow; Bennett,8,0,32,24
1657203046782,MATH 142A,B04,093558,Chow; Bennett,11,0,32,21
1657203046782,MATH 142A,B05,093559,Chow; Bennett,6,0,32,26
1657203052814,MATH 193A,A01,083224,Rotar; Vladimir,7,0,34,27
1657203052814,MATH 193A,A02,083225,Rotar; Vladimir,5,0,34,29
1657203052814,MATH 193A,A03,083781,Rotar; Vladimir,1,0,34,33
1657203052814,MATH 193A,A04,083782,Rotar; Vladimir,8,0,34,26
1657203052814,MATH 193A,A05,093482,Rotar; Vladimir,6,0,34,28
1657203058840,MATH 197,001,091859,McAuley; Julian John,9999,0,9999,0
1657203058840,MATH 197,002,095566,Kedlaya; Kiran S.,9997,0,9999,2
1657203058840,MATH 197,003,095567,Xiao; Ming,9999,0,9999,0
1657203058840,MATH 197,004,095571,Perols; Johan Lars,9998,0,9999,1
1657203065909,COGS 9,A01,083615,Shannon; Kyle Michael,7,0,75,68
1657203071939,COGS 11,A01,083617,Boyle; Mary E. T.,22,0,48,26
1657203077978,COGS 13,A01,083071,Bastos; Amalia Pinkusfeld,9,0,71,62
1657203084079,COGS 14A,A01,092681,Semenuks; Arturs,1,1,100,99
1657203090104,COGS 14B,A01,083073,Cheng; Tzu-Han,6,0,63,57
1657203096129,COGS 17,A01,092677,Semenuks; Arturs,4,0,81,77
1657203102161,COGS 100,A01,083619,Allen; Michael Gordon,15,0,70,55
1657203108194,COGS 101A,A01,083621,Davis; Joshua Daniel,9,0,68,59
1657203114223,COGS 101B,A01,091572,Allen; Michael Gordon,9,0,65,56
1657203120254,COGS 101C,A01,083625,Delgado; Tania,17,0,35,18
1657203126280,COGS 107A,A01,083627,Boyle; Mary E. T.,13,0,60,47
1657203132311,COGS 118A,A01,083075,Gupta; Anjum,16,0,76,60
1657203138338,CSE 3,A50,083646,Miranda; Gregory Joseph,24,0,50,26
1657203144374,CSE 8A,A50,083650,Miranda; Gregory Joseph,17,1,56,39
1657203150398,CSE 11,A01,083080,Cao; Yingjun,5,15,40,35
1657203156433,CSE 12,A01,083652,Krause-Levy; Sophia Louisa,24,1,120,96
1657203162458,CSE 15L,A01,083654,Morris; Justin Loren,9,0,50,41
1657203162458,CSE 15L,A02,083655,Morris; Justin Loren,9,0,50,41
1657203168482,CSE 20,A01,083657,Tran; Khoa Dang,38,0,80,42
1657203174511,CSE 21,A01,095574,Bach; Quang Tran,22,0,48,26
1657203180537,CSE 30,A01,083084,Eldon; John,4,0,80,76
1657203180537,CSE 30,B01,095061,Bhaskar; Nishant,7,0,50,43
1657203186562,CSE 100,A01,083659,Cao; Yingjun,4,4,70,66
1657203192587,CSE 134B,A01,083661,Powell; Thomas Allan,20,0,100,80
1657203198611,CSE 140,A01,083663,Gungor; Onat,13,0,85,72
1657203204640,CSE 140L,A01,083088,Eldon; John,17,0,100,83
1657203210670,CSE 175,A01,083665,Kumar; Rakesh,3,0,25,22
1657203216696,CSE 190,A00,092507,Dubnov; Shlomo,7,0,20,13
1657203222724,ECE 45,A01,083139,Congero; Spencer William,5,0,75,70
1657203228755,ECE 65,A50,083695,Saad; Andrew S,12,0,30,18
1657203228755,ECE 65,A51,095125,Saad; Andrew S,25,0,26,1
1657203234785,ECE 109,A01,091882,Touri; Behrouz,19,0,70,51
1657203240822,ECE 180,A00,083140,Abi Samra; Nicholas Camill,1,0,30,29
1657203240822,ECE 180,B00,083141,Abi Samra; Nicholas Camill,0,0,30,30
1657203246850,MATH 10A,A01,083735,Patchell; Gregory David,2,0,30,28
1657203246850,MATH 10A,A02,083736,Patchell; Gregory David,20,0,30,10
1657203246850,MATH 10A,A03,083737,Patchell; Gregory David,16,0,30,14
1657203252876,MATH 10B,A01,083207,Lim; Seonhee,7,0,34,27
1657203252876,MATH 10B,A02,083208,Lim; Seonhee,9,0,35,26
1657203252876,MATH 10B,A03,093472,Lim; Seonhee,5,0,34,29
1657203252876,MATH 10B,B01,083739,Sinha; Shubham,10,0,30,20
1657203258950,MATH 18,A01,083743,Cinel; Cameron Alexander,6,0,30,24
1657203258950,MATH 18,A02,083744,Cinel; Cameron Alexander,15,0,30,15
1657203258950,MATH 18,A03,083745,Cinel; Cameron Alexander,8,0,30,22
1657203258950,MATH 18,B01,083748,Rideout; David Porter,4,0,37,33
1657203258950,MATH 18,B02,083749,Rideout; David Porter,4,0,36,32
1657203258950,MATH 18,B03,083750,Rideout; David Porter,2,0,37,35
1657203258950,MATH 18,B04,083751,Rideout; David Porter,5,0,36,31
1657203258950,MATH 18,B05,093473,Rideout; David Porter,5,0,36,31
1657203258950,MATH 18,B06,093474,Rideout; David Porter,5,0,36,31
1657203264974,MATH 20A,A01,083754,Zheng; Zequn,13,0,40,27
1657203271009,MATH 20B,A01,083756,Briones; Jor-el Thomas Caparas,1,0,36,35
1657203271009,MATH 20B,A02,083757,Briones; Jor-el Thomas Caparas,1,0,36,35
1657203271009,MATH 20B,A03,093475,Briones; Jor-el Thomas Caparas,1,0,36,35
1657203277039,MATH 20C,A01,083760,Briones; Jor-el Thomas Caparas,1,0,35,34
1657203277039,MATH 20C,A02,083761,Briones; Jor-el Thomas Caparas,8,0,35,27
1657203277039,MATH 20C,A03,093476,Briones; Jor-el Thomas Caparas,0,1,36,36
1657203277039,MATH 20C,B01,083762,Bach; Quang Tran,1,0,30,29
1657203283065,MATH 20D,A01,083765,Tran; Brian Kha,4,0,30,26
1657203283065,MATH 20D,A02,083766,Tran; Brian Kha,5,0,30,25
1657203283065,MATH 20D,A03,083767,Tran; Brian Kha,4,0,30,26
1657203289098,MATH 20E,A01,083771,Ganguly; Soumya,7,0,32,25
1657203289098,MATH 20E,A02,083772,Ganguly; Soumya,7,0,32,25
1657203289098,MATH 20E,B01,083773,Ciotti; Benjamin,19,0,35,16
1657203289098,MATH 20E,B02,083774,Ciotti; Benjamin,17,0,35,18
1657203295138,MATH 103A,A01,083777,Greenfeld; Be'Eri,2,0,36,34
1657203295138,MATH 103A,A02,083778,Greenfeld; Be'Eri,5,0,36,31
1657203295138,MATH 103A,A03,093561,Greenfeld; Be'Eri,4,0,36,32
1657203295138,MATH 103A,B01,083779,Greenfeld; Be'Eri,6,0,36,30
1657203295138,MATH 103A,B02,083780,Greenfeld; Be'Eri,3,0,36,33
1657203295138,MATH 103A,B03,093562,Greenfeld; Be'Eri,3,0,36,33
1657203301168,MATH 105,A01,085443,Carter; Anne Toulson,14,0,35,21
1657203301168,MATH 105,A02,093477,Carter; Anne Toulson,20,0,35,15
1657203307201,MATH 109,A01,083213,Ganzberger; Geoffrey Michael,2,0,34,32
1657203307201,MATH 109,A02,083214,Ganzberger; Geoffrey Michael,4,0,34,30
1657203307201,MATH 109,A03,093478,Ganzberger; Geoffrey Michael,1,0,34,33
1657203307201,MATH 109,B01,083215,Ganzberger; Geoffrey Michael,1,0,32,31
1657203307201,MATH 109,B02,083216,Ganzberger; Geoffrey Michael,1,0,32,31
1657203307201,MATH 109,B03,093479,Ganzberger; Geoffrey Michael,7,0,32,25
1657203313236,MATH 142A,A01,083219,Chow; Bennett,6,0,32,26
1657203313236,MATH 142A,A02,083220,Chow; Bennett,10,0,32,22
1657203313236,MATH 142A,A03,093480,Chow; Bennett,7,0,32,25
1657203313236,MATH 142A,B03,093481,Chow; Bennett,8,0,32,24
1657203313236,MATH 142A,B04,093558,Chow; Bennett,11,0,32,21
1657203313236,MATH 142A,B05,093559,Chow; Bennett,6,0,32,26
1657203319269,MATH 193A,A01,083224,Rotar; Vladimir,7,0,34,27
1657203319269,MATH 193A,A02,083225,Rotar; Vladimir,5,0,34,29
1657203319269,MATH 193A,A03,083781,Rotar; Vladimir,1,0,34,33
1657203319269,MATH 193A,A04,083782,Rotar; Vladimir,8,0,34,26
1657203319269,MATH 193A,A05,093482,Rotar; Vladimir,6,0,34,28
1657203325303,MATH 197,001,091859,McAuley; Julian John,9999,0,9999,0
1657203325303,MATH 197,002,095566,Kedlaya; Kiran S.,9997,0,9999,2
1657203325303,MATH 197,003,095567,Xiao; Ming,9999,0,9999,0
1657203325303,MATH 197,004,095571,Perols; Johan Lars,9998,0,9999,1
1657203332367,COGS 9,A01,083615,Shannon; Kyle Michael,7,0,75,68
1657203338393,COGS 11,A01,083617,Boyle; Mary E. T.,22,0,48,26
1657203344419,COGS 13,A01,083071,Bastos; Amalia Pinkusfeld,9,0,71,62
1657203350444,COGS 14A,A01,092681,Semenuks; Arturs,1,1,100,99
1657203356469,COGS 14B,A01,083073,Cheng; Tzu-Han,6,0,63,57
1657203362498,COGS 17,A01,092677,Semenuks; Arturs,4,0,81,77
1657203368525,COGS 100,A01,083619,Allen; Michael Gordon,15,0,70,55
1657203374551,COGS 101A,A01,083621,Davis; Joshua Daniel,9,0,68,59
1657203380580,COGS 101B,A01,091572,Allen; Michael Gordon,9,0,65,56
1657203386604,COGS 101C,A01,083625,Delgado; Tania,17,0,35,18
1657203392629,COGS 107A,A01,083627,Boyle; Mary E. T.,13,0,60,47
1657203398668,COGS 118A,A01,083075,Gupta; Anjum,16,0,76,60
1657203404696,CSE 3,A50,083646,Miranda; Gregory Joseph,24,0,50,26
1657203410728,CSE 8A,A50,083650,Miranda; Gregory Joseph,17,1,56,39
1657203416759,CSE 11,A01,083080,Cao; Yingjun,5,15,40,35
1657203422797,CSE 12,A01,083652,Krause-Levy; Sophia Louisa,24,1,120,96
1657203428823,CSE 15L,A01,083654,Morris; Justin Loren,9,0,50,41
1657203428823,CSE 15L,A02,083655,Morris; Justin Loren,9,0,50,41
1657203434849,CSE 20,A01,083657,Tran; Khoa Dang,38,0,80,42
1657203440875,CSE 21,A01,095574,Bach; Quang Tran,22,0,48,26
1657203446902,CSE 30,A01,083084,Eldon; John,4,0,80,76
1657203446902,CSE 30,B01,095061,Bhaskar; Nishant,7,0,50,43
1657203452935,CSE 100,A01,083659,Cao; Yingjun,4,4,70,66
1657203458960,CSE 134B,A01,083661,Powell; Thomas Allan,20,0,100,80
1657203464984,CSE 140,A01,083663,Gungor; Onat,13,0,85,72
1657203471012,CSE 140L,A01,083088,Eldon; John,17,0,100,83
1657203477037,CSE 175,A01,083665,Kumar; Rakesh,3,0,25,22
1657203483063,CSE 190,A00,092507,Dubnov; Shlomo,7,0,20,13
1657203489100,ECE 45,A01,083139,Congero; Spencer William,5,0,75,70
1657203495134,ECE 65,A50,083695,Saad; Andrew S,12,0,30,18
1657203495134,ECE 65,A51,095125,Saad; Andrew S,25,0,26,1
1657203501166,ECE 109,A01,091882,Touri; Behrouz,19,0,70,51
1657203507190,ECE 180,A00,083140,Abi Samra; Nicholas Camill,1,0,30,29
1657203507190,ECE 180,B00,083141,Abi Samra; Nicholas Camill,0,0,30,30
1657203513230,MATH 10A,A01,083735,Patchell; Gregory David,2,0,30,28
1657203513230,MATH 10A,A02,083736,Patchell; Gregory David,20,0,30,10
1657203513230,MATH 10A,A03,083737,Patchell; Gregory David,16,0,30,14
1657203519267,MATH 10B,A01,083207,Lim; Seonhee,7,0,34,27
1657203519267,MATH 10B,A02,083208,Lim; Seonhee,9,0,35,26
1657203519267,MATH 10B,A03,093472,Lim; Seonhee,5,0,34,29
1657203519267,MATH 10B,B01,083739,Sinha; Shubham,10,0,30,20
1657203525318,MATH 18,A01,083743,Cinel; Cameron Alexander,6,0,30,24
1657203525318,MATH 18,A02,083744,Cinel; Cameron Alexander,15,0,30,15
1657203525318,MATH 18,A03,083745,Cinel; Cameron Alexander,8,0,30,22
1657203525318,MATH 18,B01,083748,Rideout; David Porter,4,0,37,33
1657203525318,MATH 18,B02,083749,Rideout; David Porter,4,0,36,32
1657203525318,MATH 18,B03,083750,Rideout; David Porter,2,0,37,35
1657203525318,MATH 18,B04,083751,Rideout; David Porter,5,0,36,31
1657203525318,MATH 18,B05,093473,Rideout; David Porter,5,0,36,31
1657203525318,MATH 18,B06,093474,Rideout; David Porter,5,0,36,31
1657203531343,MATH 20A,A01,083754,Zheng; Zequn,13,0,40,27
1657203537408,MATH 20B,A01,083756,Briones; Jor-el Thomas Caparas,1,0,36,35
1657203537408,MATH 20B,A02,083757,Briones; Jor-el Thomas Caparas,1,0,36,35
1657203537408,MATH 20B,A03,093475,Briones; Jor-el Thomas Caparas,1,0,36,35
1657203543448,MATH 20C,A01,083760,Briones; Jor-el Thomas Caparas,1,0,35,34
1657203543448,MATH 20C,A02,083761,Briones; Jor-el Thomas Caparas,8,0,35,27
1657203543448,MATH 20C,A03,093476,Briones; Jor-el Thomas Caparas,0,1,36,36
1657203543448,MATH 20C,B01,083762,Bach; Quang Tran,1,0,30,29
1657203549480,MATH 20D,A01,083765,Tran; Brian Kha,4,0,30,26
1657203549480,MATH 20D,A02,083766,Tran; Brian Kha,5,0,30,25
1657203549480,MATH 20D,A03,083767,Tran; Brian Kha,4,0,30,26
1657203555513,MATH 20E,A01,083771,Ganguly; Soumya,7,0,32,25
1657203555513,MATH 20E,A02,083772,Ganguly; Soumya,7,0,32,25
1657203555513,MATH 20E,B01,083773,Ciotti; Benjamin,19,0,35,16
1657203555513,MATH 20E,B02,083774,Ciotti; Benjamin,17,0,35,18
1657203561574,MATH 103A,A01,083777,Greenfeld; Be'Eri,2,0,36,34
1657203561574,MATH 103A,A02,083778,Greenfeld; Be'Eri,5,0,36,31
1657203561574,MATH 103A,A03,093561,Greenfeld; Be'Eri,4,0,36,32
1657203561574,MATH 103A,B01,083779,Greenfeld; Be'Eri,6,0,36,30
1657203561574,MATH 103A,B02,083780,Greenfeld; Be'Eri,3,0,36,33
1657203561574,MATH 103A,B03,093562,Greenfeld; Be'Eri,3,0,36,33
1657203567624,MATH 105,A01,085443,Carter; Anne Toulson,14,0,35,21
1657203567624,MATH 105,A02,093477,Carter; Anne Toulson,20,0,35,15
1657203573651,MATH 109,A01,083213,Ganzberger; Geoffrey Michael,2,0,34,32
1657203573651,MATH 109,A02,083214,Ganzberger; Geoffrey Michael,4,0,34,30
1657203573651,MATH 109,A03,093478,Ganzberger; Geoffrey Michael,1,0,34,33
1657203573651,MATH 109,B01,083215,Ganzberger; Geoffrey Michael,1,0,32,31
1657203573651,MATH 109,B02,083216,Ganzberger; Geoffrey Michael,1,0,32,31
1657203573651,MATH 109,B03,093479,Ganzberger; Geoffrey Michael,7,0,32,25
1657203579688,MATH 142A,A01,083219,Chow; Bennett,6,0,32,26
1657203579688,MATH 142A,A02,083220,Chow; Bennett,10,0,32,22
1657203579688,MATH 142A,A03,093480,Chow; Bennett,7,0,32,25
1657203579688,MATH 142A,B03,093481,Chow; Bennett,8,0,32,24
1657203579688,MATH 142A,B04,093558,Chow; Bennett,11,0,32,21
1657203579688,MATH 142A,B05,093559,Chow; Bennett,6,0,32,26
1657203585719,MATH 193A,A01,083224,Rotar; Vladimir,7,0,34,27
1657203585719,MATH 193A,A02,083225,Rotar; Vladimir,5,0,34,29
1657203585719,MATH 193A,A03,083781,Rotar; Vladimir,1,0,34,33
1657203585719,MATH 193A,A04,083782,Rotar; Vladimir,8,0,34,26
1657203585719,MATH 193A,A05,093482,Rotar; Vladimir,6,0,34,28
1657203591747,MATH 197,001,091859,McAuley; Julian John,9999,0,9999,0
1657203591747,MATH 197,002,095566,Kedlaya; Kiran S.,9997,0,9999,2
1657203591747,MATH 197,003,095567,Xiao; Ming,9999,0,9999,0
1657203591747,MATH 197,004,095571,Perols; Johan Lars,9998,0,9999,1
1657203598814,COGS 9,A01,083615,Shannon; Kyle Michael,7,0,75,68
1657203604844,COGS 11,A01,083617,Boyle; Mary E. T.,22,0,48,26
1657203610876,COGS 13,A01,083071,Bastos; Amalia Pinkusfeld,9,0,71,62
1657203616901,COGS 14A,A01,092681,Semenuks; Arturs,1,1,100,99
1657203622940,COGS 14B,A01,083073,Cheng; Tzu-Han,6,0,63,57
1657203628971,COGS 17,A01,092677,Semenuks; Arturs,4,0,81,77
1657203635000,COGS 100,A01,083619,Allen; Michael Gordon,15,0,70,55
1657203641024,COGS 101A,A01,083621,Davis; Joshua Daniel,9,0,68,59
1657203647054,COGS 101B,A01,091572,Allen; Michael Gordon,9,0,65,56
1657203653083,COGS 101C,A01,083625,Delgado; Tania,17,0,35,18
1657203659109,COGS 107A,A01,083627,Boyle; Mary E. T.,13,0,60,47
1657203665137,COGS 118A,A01,083075,Gupta; Anjum,16,0,76,60
1657203671173,CSE 3,A50,083646,Miranda; Gregory Joseph,24,0,50,26
1657203677218,CSE 8A,A50,083650,Miranda; Gregory Joseph,17,1,56,39
1657203683319,CSE 11,A01,083080,Cao; Yingjun,5,15,40,35
1657203689344,CSE 12,A01,083652,Krause-Levy; Sophia Louisa,24,1,120,96
1657203695370,CSE 15L,A01,083654,Morris; Justin Loren,9,0,50,41
1657203695370,CSE 15L,A02,083655,Morris; Justin Loren,9,0,50,41
1657203701405,CSE 20,A01,083657,Tran; Khoa Dang,38,0,80,42
1657203707432,CSE 21,A01,095574,Bach; Quang Tran,22,0,48,26
1657203713477,CSE 30,A01,083084,Eldon; John,4,0,80,76
1657203713477,CSE 30,B01,095061,Bhaskar; Nishant,7,0,50,43
1657203719512,CSE 100,A01,083659,Cao; Yingjun,4,4,70,66
1657203725544,CSE 134B,A01,083661,Powell; Thomas Allan,20,0,100,80
1657203731569,CSE 140,A01,083663,Gungor; Onat,13,0,85,72
1657203737600,CSE 140L,A01,083088,Eldon; John,17,0,100,83
1657203743631,CSE 175,A01,083665,Kumar; Rakesh,3,0,25,22
1657203749677,CSE 190,A00,092507,Dubnov; Shlomo,7,0,20,13
1657203755704,ECE 45,A01,083139,Congero; Spencer William,5,0,75,70
1657203761735,ECE 65,A50,083695,Saad; Andrew S,12,0,30,18
1657203761735,ECE 65,A51,095125,Saad; Andrew S,25,0,26,1
1657203767764,ECE 109,A01,091882,Touri; Behrouz,19,0,70,51
1657203773800,ECE 180,A00,083140,Abi Samra; Nicholas Camill,1,0,30,29
1657203773800,ECE 180,B00,083141,Abi Samra; Nicholas Camill,0,0,30,30
1657203779830,MATH 10A,A01,083735,Patchell; Gregory David,2,0,30,28
1657203779830,MATH 10A,A02,083736,Patchell; Gregory David,20,0,30,10
1657203779830,MATH 10A,A03,083737,Patchell; Gregory David,16,0,30,14
1657203785866,MATH 10B,A01,083207,Lim; Seonhee,7,0,34,27
1657203785866,MATH 10B,A02,083208,Lim; Seonhee,9,0,35,26
1657203785866,MATH 10B,A03,093472,Lim; Seonhee,5,0,34,29
1657203785866,MATH 10B,B01,083739,Sinha; Shubham,10,0,30,20
1657203791897,MATH 18,A01,083743,Cinel; Cameron Alexander,6,0,30,24
1657203791897,MATH 18,A02,083744,Cinel; Cameron Alexander,15,0,30,15
1657203791897,MATH 18,A03,083745,Cinel; Cameron Alexander,8,0,30,22
1657203791897,MATH 18,B01,083748,Rideout; David Porter,4,0,37,33
1657203791897,MATH 18,B02,083749,Rideout; David Porter,4,0,36,32
1657203791897,MATH 18,B03,083750,Rideout; David Porter,2,0,37,35
1657203791897,MATH 18,B04,083751,Rideout; David Porter,5,0,36,31
1657203791897,MATH 18,B05,093473,Rideout; David Porter,5,0,36,31
1657203791897,MATH 18,B06,093474,Rideout; David Porter,5,0,36,31
1657203797928,MATH 20A,A01,083754,Zheng; Zequn,13,0,40,27
1657203803956,MATH 20B,A01,083756,Briones; Jor-el Thomas Caparas,1,0,36,35
1657203803956,MATH 20B,A02,083757,Briones; Jor-el Thomas Caparas,1,0,36,35
1657203803956,MATH 20B,A03,093475,Briones; Jor-el Thomas Caparas,1,0,36,35
1657203809992,MATH 20C,A01,083760,Briones; Jor-el Thomas Caparas,1,0,35,34
1657203809992,MATH 20C,A02,083761,Briones; Jor-el Thomas Caparas,8,0,35,27
1657203809992,MATH 20C,A03,093476,Briones; Jor-el Thomas Caparas,0,1,36,36
1657203809992,MATH 20C,B01,083762,Bach; Quang Tran,1,0,30,29
1657203816022,MATH 20D,A01,083765,Tran; Brian Kha,4,0,30,26
1657203816022,MATH 20D,A02,083766,Tran; Brian Kha,5,0,30,25
1657203816022,MATH 20D,A03,083767,Tran; Brian Kha,4,0,30,26
1657203822048,MATH 20E,A01,083771,Ganguly; Soumya,7,0,32,25
1657203822048,MATH 20E,A02,083772,Ganguly; Soumya,7,0,32,25
1657203822048,MATH 20E,B01,083773,Ciotti; Benjamin,19,0,35,16
1657203822048,MATH 20E,B02,083774,Ciotti; Benjamin,17,0,35,18
1657203828075,MATH 103A,A01,083777,Greenfeld; Be'Eri,2,0,36,34
1657203828075,MATH 103A,A02,083778,Greenfeld; Be'Eri,5,0,36,31
1657203828075,MATH 103A,A03,093561,Greenfeld; Be'Eri,4,0,36,32
1657203828075,MATH 103A,B01,083779,Greenfeld; Be'Eri,6,0,36,30
1657203828075,MATH 103A,B02,083780,Greenfeld; Be'Eri,3,0,36,33
1657203828075,MATH 103A,B03,093562,Greenfeld; Be'Eri,3,0,36,33
1657203834100,MATH 105,A01,085443,Carter; Anne Toulson,14,0,35,21
1657203834100,MATH 105,A02,093477,Carter; Anne Toulson,20,0,35,15
1657203840138,MATH 109,A01,083213,Ganzberger; Geoffrey Michael,2,0,34,32
1657203840138,MATH 109,A02,083214,Ganzberger; Geoffrey Michael,4,0,34,30
1657203840138,MATH 109,A03,093478,Ganzberger; Geoffrey Michael,1,0,34,33
1657203840138,MATH 109,B01,083215,Ganzberger; Geoffrey Michael,1,0,32,31
1657203840138,MATH 109,B02,083216,Ganzberger; Geoffrey Michael,1,0,32,31
1657203840138,MATH 109,B03,093479,Ganzberger; Geoffrey Michael,7,0,32,25
1657203846187,MATH 142A,A01,083219,Chow; Bennett,6,0,32,26
1657203846187,MATH 142A,A02,083220,Chow; Bennett,10,0,32,22
1657203846187,MATH 142A,A03,093480,Chow; Bennett,7,0,32,25
1657203846187,MATH 142A,B03,093481,Chow; Bennett,8,0,32,24
1657203846187,MATH 142A,B04,093558,Chow; Bennett,11,0,32,21
1657203846187,MATH 142A,B05,093559,Chow; Bennett,6,0,32,26
1657203852218,MATH 193A,A01,083224,Rotar; Vladimir,7,0,34,27
1657203852218,MATH 193A,A02,083225,Rotar; Vladimir,5,0,34,29
1657203852218,MATH 193A,A03,083781,Rotar; Vladimir,1,0,34,33
1657203852218,MATH 193A,A04,083782,Rotar; Vladimir,8,0,34,26
1657203852218,MATH 193A,A05,093482,Rotar; Vladimir,6,0,34,28
1657203858244,MATH 197,001,091859,McAuley; Julian John,9999,0,9999,0
1657203858244,MATH 197,002,095566,Kedlaya; Kiran S.,9997,0,9999,2
1657203858244,MATH 197,003,095567,Xiao; Ming,9999,0,9999,0
1657203858244,MATH 197,004,095571,Perols; Johan Lars,9998,0,9999,1
1657203865311,COGS 9,A01,083615,Shannon; Kyle Michael,7,0,75,68
1657203871336,COGS 11,A01,083617,Boyle; Mary E. T.,22,0,48,26
1657203877361,COGS 13,A01,083071,Bastos; Amalia Pinkusfeld,9,0,71,62
1657203883395,COGS 14A,A01,092681,Semenuks; Arturs,1,1,100,99
1657203889423,COGS 14B,A01,083073,Cheng; Tzu-Han,6,0,63,57
1657203895457,COGS 17,A01,092677,Semenuks; Arturs,4,0,81,77
1657203901493,COGS 100,A01,083619,Allen; Michael Gordon,15,0,70,55
1657203907518,COGS 101A,A01,083621,Davis; Joshua Daniel,9,0,68,59
1657203913547,COGS 101B,A01,091572,Allen; Michael Gordon,9,0,65,56
1657203919576,COGS 101C,A01,083625,Delgado; Tania,17,0,35,18
1657203925604,COGS 107A,A01,083627,Boyle; Mary E. T.,13,0,60,47
1657203931636,COGS 118A,A01,083075,Gupta; Anjum,16,0,76,60
1657203937670,CSE 3,A50,083646,Miranda; Gregory Joseph,24,0,50,26
1657203943712,CSE 8A,A50,083650,Miranda; Gregory Joseph,17,1,56,39
1657203949741,CSE 11,A01,083080,Cao; Yingjun,5,15,40,35
1657203955785,CSE 12,A01,083652,Krause-Levy; Sophia Louisa,24,1,120,96
1657203961817,CSE 15L,A01,083654,Morris; Justin Loren,9,0,50,41
1657203961817,CSE 15L,A02,083655,Morris; Justin Loren,9,0,50,41
1657203967846,CSE 20,A01,083657,Tran; Khoa Dang,38,0,80,42
1657203973872,CSE 21,A01,095574,Bach; Quang Tran,22,0,48,26
1657203979909,CSE 30,A01,083084,Eldon; John,4,0,80,76
1657203979909,CSE 30,B01,095061,Bhaskar; Nishant,7,0,50,43
1657203985946,CSE 100,A01,083659,Cao; Yingjun,4,4,70,66
1657203991970,CSE 134B,A01,083661,Powell; Thomas Allan,20,0,100,80
1657203998002,CSE 140,A01,083663,Gungor; Onat,13,0,85,72
1657204004028,CSE 140L,A01,083088,Eldon; John,17,0,100,83
1657204010053,CSE 175,A01,083665,Kumar; Rakesh,3,0,25,22
1657204016079,CSE 190,A00,092507,Dubnov; Shlomo,7,0,20,13
1657204022107,ECE 45,A01,083139,Congero; Spencer William,5,0,75,70
1657204028135,ECE 65,A50,083695,Saad; Andrew S,12,0,30,18
1657204028135,ECE 65,A51,095125,Saad; Andrew S,25,0,26,1
1657204034166,ECE 109,A01,091882,Touri; Behrouz,19,0,70,51
1657204040197,ECE 180,A00,083140,Abi Samra; Nicholas Camill,1,0,30,29
1657204040197,ECE 180,B00,083141,Abi Samra; Nicholas Camill,0,0,30,30
1657204046224,MATH 10A,A01,083735,Patchell; Gregory David,2,0,30,28
1657204046224,MATH 10A,A02,083736,Patchell; Gregory David,20,0,30,10
1657204046224,MATH 10A,A03,083737,Patchell; Gregory David,16,0,30,14
1657204052253,MATH 10B,A01,083207,Lim; Seonhee,7,0,34,27
1657204052253,MATH 10B,A02,083208,Lim; Seonhee,9,0,35,26
1657204052253,MATH 10B,A03,093472,Lim; Seonhee,5,0,34,29
1657204052253,MATH 10B,B01,083739,Sinha; Shubham,10,0,30,20
1657204058288,MATH 18,A01,083743,Cinel; Cameron Alexander,6,0,30,24
1657204058288,MATH 18,A02,083744,Cinel; Cameron Alexander,15,0,30,15
1657204058288,MATH 18,A03,083745,Cinel; Cameron Alexander,8,0,30,22
1657204058288,MATH 18,B01,083748,Rideout; David Porter,4,0,37,33
1657204058288,MATH 18,B02,083749,Rideout; David Porter,4,0,36,32
1657204058288,MATH 18,B03,083750,Rideout; David Porter,2,0,37,35
1657204058288,MATH 18,B04,083751,Rideout; David Porter,5,0,36,31
1657204058288,MATH 18,B05,093473,Rideout; David Porter,5,0,36,31
1657204058288,MATH 18,B06,093474,Rideout; David Porter,5,0,36,31
1657204064312,MATH 20A,A01,083754,Zheng; Zequn,13,0,40,27
1657204070336,MATH 20B,A01,083756,Briones; Jor-el Thomas Caparas,1,0,36,35
1657204070336,MATH 20B,A02,083757,Briones; Jor-el Thomas Caparas,1,0,36,35
1657204070336,MATH 20B,A03,093475,Briones; Jor-el Thomas Caparas,1,0,36,35
1657204076360,MATH 20C,A01,083760,Briones; Jor-el Thomas Caparas,1,0,35,34
1657204076360,MATH 20C,A02,083761,Briones; Jor-el Thomas Caparas,8,0,35,27
1657204076360,MATH 20C,A03,093476,Briones; Jor-el Thomas Caparas,0,1,36,36
1657204076360,MATH 20C,B01,083762,Bach; Quang Tran,1,0,30,29
1657204082393,MATH 20D,A01,083765,Tran; Brian Kha,4,0,30,26
1657204082393,MATH 20D,A02,083766,Tran; Brian Kha,5,0,30,25
1657204082393,MATH 20D,A03,083767,Tran; Brian Kha,4,0,30,26
1657204088423,MATH 20E,A01,083771,Ganguly; Soumya,7,0,32,25
1657204088423,MATH 20E,A02,083772,Ganguly; Soumya,7,0,32,25
1657204088423,MATH 20E,B01,083773,Ciotti; Benjamin,19,0,35,16
1657204088423,MATH 20E,B02,083774,Ciotti; Benjamin,17,0,35,18
1657204094456,MATH 103A,A01,083777,Greenfeld; Be'Eri,2,0,36,34
1657204094456,MATH 103A,A02,083778,Greenfeld; Be'Eri,5,0,36,31
1657204094456,MATH 103A,A03,093561,Greenfeld; Be'Eri,4,0,36,32
1657204094456,MATH 103A,B01,083779,Greenfeld; Be'Eri,6,0,36,30
1657204094456,MATH 103A,B02,083780,Greenfeld; Be'Eri,3,0,36,33
1657204094456,MATH 103A,B03,093562,Greenfeld; Be'Eri,3,0,36,33
1657204100485,MATH 105,A01,085443,Carter; Anne Toulson,14,0,35,21
1657204100485,MATH 105,A02,093477,Carter; Anne Toulson,20,0,35,15
1657204106514,MATH 109,A01,083213,Ganzberger; Geoffrey Michael,2,0,34,32
1657204106514,MATH 109,A02,083214,Ganzberger; Geoffrey Michael,4,0,34,30
1657204106514,MATH 109,A03,093478,Ganzberger; Geoffrey Michael,1,0,34,33
1657204106514,MATH 109,B01,083215,Ganzberger; Geoffrey Michael,1,0,32,31
1657204106514,MATH 109,B02,083216,Ganzberger; Geoffrey Michael,1,0,32,31
1657204106514,MATH 109,B03,093479,Ganzberger; Geoffrey Michael,7,0,32,25
1657204112541,MATH 142A,A01,083219,Chow; Bennett,6,0,32,26
1657204112541,MATH 142A,A02,083220,Chow; Bennett,10,0,32,22
1657204112541,MATH 142A,A03,093480,Chow; Bennett,7,0,32,25
1657204112541,MATH 142A,B03,093481,Chow; Bennett,8,0,32,24
1657204112541,MATH 142A,B04,093558,Chow; Bennett,11,0,32,21
1657204112541,MATH 142A,B05,093559,Chow; Bennett,6,0,32,26
1657204118566,MATH 193A,A01,083224,Rotar; Vladimir,7,0,34,27
1657204118566,MATH 193A,A02,083225,Rotar; Vladimir,5,0,34,29
1657204118566,MATH 193A,A03,083781,Rotar; Vladimir,1,0,34,33
1657204118566,MATH 193A,A04,083782,Rotar; Vladimir,8,0,34,26
1657204118566,MATH 193A,A05,093482,Rotar; Vladimir,6,0,34,28
1657204124596,MATH 197,001,091859,McAuley; Julian John,9999,0,9999,0
1657204124596,MATH 197,002,095566,Kedlaya; Kiran S.,9997,0,9999,2
1657204124596,MATH 197,003,095567,Xiao; Ming,9999,0,9999,0
1657204124596,MATH 197,004,095571,Perols; Johan Lars,9998,0,9999,1
1657204131662,COGS 9,A01,083615,Shannon; Kyle Michael,7,0,75,68
1657204137693,COGS 11,A01,083617,Boyle; Mary E. T.,22,0,48,26
1657204143732,COGS 13,A01,083071,Bastos; Amalia Pinkusfeld,9,0,71,62
1657204149763,COGS 14A,A01,092681,Semenuks; Arturs,1,1,100,99
1657204155786,COGS 14B,A01,083073,Cheng; Tzu-Han,6,0,63,57
1657204161811,COGS 17,A01,092677,Semenuks; Arturs,4,0,81,77
1657204167837,COGS 100,A01,083619,Allen; Michael Gordon,15,0,70,55
1657204173861,COGS 101A,A01,083621,Davis; Joshua Daniel,9,0,68,59
1657204179888,COGS 101B,A01,091572,Allen; Michael Gordon,9,0,65,56
1657204185911,COGS 101C,A01,083625,Delgado; Tania,17,0,35,18
1657204191936,COGS 107A,A01,083627,Boyle; Mary E. T.,13,0,60,47
1657204197971,COGS 118A,A01,083075,Gupta; Anjum,16,0,76,60
1657204204005,CSE 3,A50,083646,Miranda; Gregory Joseph,24,0,50,26
1657204210035,CSE 8A,A50,083650,Miranda; Gregory Joseph,17,1,56,39
1657204216064,CSE 11,A01,083080,Cao; Yingjun,5,15,40,35
1657204222093,CSE 12,A01,083652,Krause-Levy; Sophia Louisa,24,1,120,96
1657204228131,CSE 15L,A01,083654,Morris; Justin Loren,9,0,50,41
1657204228131,CSE 15L,A02,083655,Morris; Justin Loren,9,0,50,41
1657204234159,CSE 20,A01,083657,Tran; Khoa Dang,38,0,80,42
1657204240188,CSE 21,A01,095574,Bach; Quang Tran,22,0,48,26
1657204246212,CSE 30,A01,083084,Eldon; John,4,0,80,76
1657204246212,CSE 30,B01,095061,Bhaskar; Nishant,7,0,50,43
1657204252238,CSE 100,A01,083659,Cao; Yingjun,4,4,70,66
1657204258265,CSE 134B,A01,083661,Powell; Thomas Allan,20,0,100,80
1657204264291,CSE 140,A01,083663,Gungor; Onat,13,0,85,72
1657204270318,CSE 140L,A01,083088,Eldon; John,17,0,100,83
1657204278612,CSE 175,A01,083665,Kumar; Rakesh,3,0,25,22
1657204284707,CSE 190,A00,092507,Dubnov; Shlomo,7,0,20,13
1657204290730,ECE 45,A01,083139,Congero; Spencer William,5,0,75,70
1657204296757,ECE 65,A50,083695,Saad; Andrew S,12,0,30,18
1657204296757,ECE 65,A51,095125,Saad; Andrew S,25,0,26,1
1657204302790,ECE 109,A01,091882,Touri; Behrouz,19,0,70,51
1657204308813,ECE 180,A00,083140,Abi Samra; Nicholas Camill,1,0,30,29
1657204308813,ECE 180,B00,083141,Abi Samra; Nicholas Camill,0,0,30,30
1657204314839,MATH 10A,A01,083735,Patchell; Gregory David,2,0,30,28
1657204314839,MATH 10A,A02,083736,Patchell; Gregory David,20,0,30,10
1657204314839,MATH 10A,A03,083737,Patchell; Gregory David,16,0,30,14
1657204320864,MATH 10B,A01,083207,Lim; Seonhee,7,0,34,27
1657204320864,MATH 10B,A02,083208,Lim; Seonhee,9,0,35,26
1657204320864,MATH 10B,A03,093472,Lim; Seonhee,5,0,34,29
1657204320864,MATH 10B,B01,083739,Sinha; Shubham,10,0,30,20
1657204326895,MATH 18,A01,083743,Cinel; Cameron Alexander,6,0,30,24
1657204326895,MATH 18,A02,083744,Cinel; Cameron Alexander,15,0,30,15
1657204326895,MATH 18,A03,083745,Cinel; Cameron Alexander,8,0,30,22
1657204326895,MATH 18,B01,083748,Rideout; David Porter,4,0,37,33
1657204326895,MATH 18,B02,083749,Rideout; David Porter,4,0,36,32
1657204326895,MATH 18,B03,083750,Rideout; David Porter,2,0,37,35
1657204326895,MATH 18,B04,083751,Rideout; David Porter,5,0,36,31
1657204326895,MATH 18,B05,093473,Rideout; David Porter,5,0,36,31
1657204326895,MATH 18,B06,093474,Rideout; David Porter,5,0,36,31
1657204332920,MATH 20A,A01,083754,Zheng; Zequn,13,0,40,27
1657204338946,MATH 20B,A01,083756,Briones; Jor-el Thomas Caparas,1,0,36,35
1657204338946,MATH 20B,A02,083757,Briones; Jor-el Thomas Caparas,1,0,36,35
1657204338946,MATH 20B,A03,093475,Briones; Jor-el Thomas Caparas,1,0,36,35
1657204344975,MATH 20C,A01,083760,Briones; Jor-el Thomas Caparas,1,0,35,34
1657204344975,MATH 20C,A02,083761,Briones; Jor-el Thomas Caparas,8,0,35,27
1657204344975,MATH 20C,A03,093476,Briones; Jor-el Thomas Caparas,0,1,36,36
1657204344975,MATH 20C,B01,083762,Bach; Quang Tran,1,0,30,29
1657204351005,MATH 20D,A01,083765,Tran; Brian Kha,4,0,30,26
1657204351005,MATH 20D,A02,083766,Tran; Brian Kha,5,0,30,25
1657204351005,MATH 20D,A03,083767,Tran; Brian Kha,4,0,30,26
1657204357031,MATH 20E,A01,083771,Ganguly; Soumya,7,0,32,25
1657204357031,MATH 20E,A02,083772,Ganguly; Soumya,7,0,32,25
1657204357031,MATH 20E,B01,083773,Ciotti; Benjamin,19,0,35,16
1657204357031,MATH 20E,B02,083774,Ciotti; Benjamin,17,0,35,18
1657204363057,MATH 103A,A01,083777,Greenfeld; Be'Eri,2,0,36,34
1657204363057,MATH 103A,A02,083778,Greenfeld; Be'Eri,5,0,36,31
1657204363057,MATH 103A,A03,093561,Greenfeld; Be'Eri,4,0,36,32
1657204363057,MATH 103A,B01,083779,Greenfeld; Be'Eri,6,0,36,30
1657204363057,MATH 103A,B02,083780,Greenfeld; Be'Eri,3,0,36,33
1657204363057,MATH 103A,B03,093562,Greenfeld; Be'Eri,3,0,36,33
1657204369107,MATH 105,A01,085443,Carter; Anne Toulson,14,0,35,21
1657204369107,MATH 105,A02,093477,Carter; Anne Toulson,20,0,35,15
1657204375146,MATH 109,A01,083213,Ganzberger; Geoffrey Michael,2,0,34,32
1657204375146,MATH 109,A02,083214,Ganzberger; Geoffrey Michael,4,0,34,30
1657204375146,MATH 109,A03,093478,Ganzberger; Geoffrey Michael,1,0,34,33
1657204375146,MATH 109,B01,083215,Ganzberger; Geoffrey Michael,1,0,32,31
1657204375146,MATH 109,B02,083216,Ganzberger; Geoffrey Michael,1,0,32,31
1657204375146,MATH 109,B03,093479,Ganzberger; Geoffrey Michael,7,0,32,25
1657204381176,MATH 142A,A01,083219,Chow; Bennett,6,0,32,26
1657204381176,MATH 142A,A02,083220,Chow; Bennett,10,0,32,22
1657204381176,MATH 142A,A03,093480,Chow; Bennett,7,0,32,25
1657204381176,MATH 142A,B03,093481,Chow; Bennett,8,0,32,24
1657204381176,MATH 142A,B04,093558,Chow; Bennett,11,0,32,21
1657204381176,MATH 142A,B05,093559,Chow; Bennett,6,0,32,26
1657204387204,MATH 193A,A01,083224,Rotar; Vladimir,7,0,34,27
1657204387204,MATH 193A,A02,083225,Rotar; Vladimir,5,0,34,29
1657204387204,MATH 193A,A03,083781,Rotar; Vladimir,1,0,34,33
1657204387204,MATH 193A,A04,083782,Rotar; Vladimir,8,0,34,26
1657204387204,MATH 193A,A05,093482,Rotar; Vladimir,6,0,34,28
1657204393236,MATH 197,001,091859,McAuley; Julian John,9999,0,9999,0
1657204393236,MATH 197,002,095566,Kedlaya; Kiran S.,9997,0,9999,2
1657204393236,MATH 197,003,095567,Xiao; Ming,9999,0,9999,0
1657204393236,MATH 197,004,095571,Perols; Johan Lars,9998,0,9999,1
1657204400313,COGS 9,A01,083615,Shannon; Kyle Michael,7,0,75,68
1657204406345,COGS 11,A01,083617,Boyle; Mary E. T.,22,0,48,26
1657204412373,COGS 13,A01,083071,Bastos; Amalia Pinkusfeld,9,0,71,62
1657204418407,COGS 14A,A01,092681,Semenuks; Arturs,1,1,100,99
1657204424445,COGS 14B,A01,083073,Cheng; Tzu-Han,6,0,63,57
1657204430470,COGS 17,A01,092677,Semenuks; Arturs,4,0,81,77
1657204436494,COGS 100,A01,083619,Allen; Michael Gordon,15,0,70,55
1657204442573,COGS 101A,A01,083621,Davis; Joshua Daniel,9,0,68,59
1657204448597,COGS 101B,A01,091572,Allen; Michael Gordon,9,0,65,56
1657204454626,COGS 101C,A01,083625,Delgado; Tania,17,0,35,18
1657204460651,COGS 107A,A01,083627,Boyle; Mary E. T.,13,0,60,47
1657204466676,COGS 118A,A01,083075,Gupta; Anjum,16,0,76,60
1657204472720,CSE 3,A50,083646,Miranda; Gregory Joseph,24,0,50,26
1657204478752,CSE 8A,A50,083650,Miranda; Gregory Joseph,17,1,56,39
1657204484780,CSE 11,A01,083080,Cao; Yingjun,5,15,40,35
1657204490816,CSE 12,A01,083652,Krause-Levy; Sophia Louisa,24,1,120,96
1657204496841,CSE 15L,A01,083654,Morris; Justin Loren,9,0,50,41
1657204496841,CSE 15L,A02,083655,Morris; Justin Loren,9,0,50,41
1657204502878,CSE 20,A01,083657,Tran; Khoa Dang,38,0,80,42
1657204508903,CSE 21,A01,095574,Bach; Quang Tran,22,0,48,26
1657204514931,CSE 30,A01,083084,Eldon; John,4,0,80,76
1657204514931,CSE 30,B01,095061,Bhaskar; Nishant,7,0,50,43
1657204520954,CSE 100,A01,083659,Cao; Yingjun,4,4,70,66
1657204526977,CSE 134B,A01,083661,Powell; Thomas Allan,20,0,100,80
1657204533002,CSE 140,A01,083663,Gungor; Onat,13,0,85,72
1657204539026,CSE 140L,A01,083088,Eldon; John,17,0,100,83
1657204545050,CSE 175,A01,083665,Kumar; Rakesh,3,0,25,22
1657204551073,CSE 190,A00,092507,Dubnov; Shlomo,7,0,20,13
1657204557103,ECE 45,A01,083139,Congero; Spencer William,5,0,75,70
1657204563129,ECE 65,A50,083695,Saad; Andrew S,12,0,30,18
1657204563129,ECE 65,A51,095125,Saad; Andrew S,25,0,26,1
1657204569155,ECE 109,A01,091882,Touri; Behrouz,19,0,70,51
1657204575185,ECE 180,A00,083140,Abi Samra; Nicholas Camill,1,0,30,29
1657204575185,ECE 180,B00,083141,Abi Samra; Nicholas Camill,0,0,30,30
1657204581215,MATH 10A,A01,083735,Patchell; Gregory David,2,0,30,28
1657204581215,MATH 10A,A02,083736,Patchell; Gregory David,20,0,30,10
1657204581215,MATH 10A,A03,083737,Patchell; Gregory David,16,0,30,14
1657204587246,MATH 10B,A01,083207,Lim; Seonhee,7,0,34,27
1657204587246,MATH 10B,A02,083208,Lim; Seonhee,9,0,35,26
1657204587246,MATH 10B,A03,093472,Lim; Seonhee,5,0,34,29
1657204587246,MATH 10B,B01,083739,Sinha; Shubham,10,0,30,20
1657204593281,MATH 18,A01,083743,Cinel; Cameron Alexander,6,0,30,24
1657204593281,MATH 18,A02,083744,Cinel; Cameron Alexander,15,0,30,15
1657204593281,MATH 18,A03,083745,Cinel; Cameron Alexander,8,0,30,22
1657204593281,MATH 18,B01,083748,Rideout; David Porter,4,0,37,33
1657204593281,MATH 18,B02,083749,Rideout; David Porter,4,0,36,32
1657204593281,MATH 18,B03,083750,Rideout; David Porter,2,0,37,35
1657204593281,MATH 18,B04,083751,Rideout; David Porter,5,0,36,31
1657204593281,MATH 18,B05,093473,Rideout; David Porter,5,0,36,31
1657204593281,MATH 18,B06,093474,Rideout; David Porter,5,0,36,31
1657204599305,MATH 20A,A01,083754,Zheng; Zequn,13,0,40,27
1657204605331,MATH 20B,A01,083756,Briones; Jor-el Thomas Caparas,1,0,36,35
1657204605331,MATH 20B,A02,083757,Briones; Jor-el Thomas Caparas,1,0,36,35
1657204605331,MATH 20B,A03,093475,Briones; Jor-el Thomas Caparas,1,0,36,35
1657204611375,MATH 20C,A01,083760,Briones; Jor-el Thomas Caparas,1,0,35,34
1657204611375,MATH 20C,A02,083761,Briones; Jor-el Thomas Caparas,8,0,35,27
1657204611375,MATH 20C,A03,093476,Briones; Jor-el Thomas Caparas,0,1,36,36
1657204611375,MATH 20C,B01,083762,Bach; Quang Tran,1,0,30,29
1657204617413,MATH 20D,A01,083765,Tran; Brian Kha,4,0,30,26
1657204617413,MATH 20D,A02,083766,Tran; Brian Kha,5,0,30,25
1657204617413,MATH 20D,A03,083767,Tran; Brian Kha,4,0,30,26
1657204623440,MATH 20E,A01,083771,Ganguly; Soumya,7,0,32,25
1657204623440,MATH 20E,A02,083772,Ganguly; Soumya,7,0,32,25
1657204623440,MATH 20E,B01,083773,Ciotti; Benjamin,19,0,35,16
1657204623440,MATH 20E,B02,083774,Ciotti; Benjamin,17,0,35,18
1657204629480,MATH 103A,A01,083777,Greenfeld; Be'Eri,2,0,36,34
1657204629480,MATH 103A,A02,083778,Greenfeld; Be'Eri,5,0,36,31
1657204629480,MATH 103A,A03,093561,Greenfeld; Be'Eri,4,0,36,32
1657204629480,MATH 103A,B01,083779,Greenfeld; Be'Eri,6,0,36,30
1657204629480,MATH 103A,B02,083780,Greenfeld; Be'Eri,3,0,36,33
1657204629480,MATH 103A,B03,093562,Greenfeld; Be'Eri,3,0,36,33
1657204635506,MATH 105,A01,085443,Carter; Anne Toulson,14,0,35,21
1657204635506,MATH 105,A02,093477,Carter; Anne Toulson,20,0,35,15
1657204641532,MATH 109,A01,083213,Ganzberger; Geoffrey Michael,2,0,34,32
1657204641532,MATH 109,A02,083214,Ganzberger; Geoffrey Michael,4,0,34,30
1657204641532,MATH 109,A03,093478,Ganzberger; Geoffrey Michael,1,0,34,33
1657204641532,MATH 109,B01,083215,Ganzberger; Geoffrey Michael,1,0,32,31
1657204641532,MATH 109,B02,083216,Ganzberger; Geoffrey Michael,1,0,32,31
1657204641532,MATH 109,B03,093479,Ganzberger; Geoffrey Michael,7,0,32,25
1657204647558,MATH 142A,A01,083219,Chow; Bennett,6,0,32,26
1657204647558,MATH 142A,A02,083220,Chow; Bennett,10,0,32,22
1657204647558,MATH 142A,A03,093480,Chow; Bennett,7,0,32,25
1657204647558,MATH 142A,B03,093481,Chow; Bennett,8,0,32,24
1657204647558,MATH 142A,B04,093558,Chow; Bennett,11,0,32,21
1657204647558,MATH 142A,B05,093559,Chow; Bennett,6,0,32,26
1657204653589,MATH 193A,A01,083224,Rotar; Vladimir,7,0,34,27
1657204653589,MATH 193A,A02,083225,Rotar; Vladimir,5,0,34,29
1657204653589,MATH 193A,A03,083781,Rotar; Vladimir,1,0,34,33
1657204653589,MATH 193A,A04,083782,Rotar; Vladimir,8,0,34,26
1657204653589,MATH 193A,A05,093482,Rotar; Vladimir,6,0,34,28
1657204659619,MATH 197,001,091859,McAuley; Julian John,9999,0,9999,0
1657204659619,MATH 197,002,095566,Kedlaya; Kiran S.,9997,0,9999,2
1657204659619,MATH 197,003,095567,Xiao; Ming,9999,0,9999,0
1657204659619,MATH 197,004,095571,Perols; Johan Lars,9998,0,9999,1
1657204666692,COGS 9,A01,083615,Shannon; Kyle Michael,7,0,75,68
1657204672718,COGS 11,A01,083617,Boyle; Mary E. T.,22,0,48,26
1657204678742,COGS 13,A01,083071,Bastos; Amalia Pinkusfeld,9,0,71,62
1657204684765,COGS 14A,A01,092681,Semenuks; Arturs,1,1,100,99
1657204690790,COGS 14B,A01,083073,Cheng; Tzu-Han,6,0,63,57
1657204696811,COGS 17,A01,092677,Semenuks; Arturs,4,0,81,77
1657204702836,COGS 100,A01,083619,Allen; Michael Gordon,15,0,70,55
1657204708867,COGS 101A,A01,083621,Davis; Joshua Daniel,9,0,68,59
1657204714890,COGS 101B,A01,091572,Allen; Michael Gordon,9,0,65,56
1657204720926,COGS 101C,A01,083625,Delgado; Tania,17,0,35,18
1657204726951,COGS 107A,A01,083627,Boyle; Mary E. T.,13,0,60,47
1657204732979,COGS 118A,A01,083075,Gupta; Anjum,16,0,76,60
1657204739011,CSE 3,A50,083646,Miranda; Gregory Joseph,24,0,50,26
1657204745040,CSE 8A,A50,083650,Miranda; Gregory Joseph,17,1,56,39
1657204751069,CSE 11,A01,083080,Cao; Yingjun,5,15,40,35
1657204757095,CSE 12,A01,083652,Krause-Levy; Sophia Louisa,24,1,120,96
1657204763124,CSE 15L,A01,083654,Morris; Justin Loren,9,0,50,41
1657204763124,CSE 15L,A02,083655,Morris; Justin Loren,9,0,50,41
1657204769149,CSE 20,A01,083657,Tran; Khoa Dang,38,0,80,42
1657204775181,CSE 21,A01,095574,Bach; Quang Tran,22,0,48,26
1657204781216,CSE 30,A01,083084,Eldon; John,4,0,80,76
1657204781216,CSE 30,B01,095061,Bhaskar; Nishant,7,0,50,43
1657204787247,CSE 100,A01,083659,Cao; Yingjun,4,4,70,66
1657204793271,CSE 134B,A01,083661,Powell; Thomas Allan,20,0,100,80
1657204799302,CSE 140,A01,083663,Gungor; Onat,13,0,85,72
1657204805344,CSE 140L,A01,083088,Eldon; John,17,0,100,83
1657204811370,CSE 175,A01,083665,Kumar; Rakesh,3,0,25,22
1657204817414,CSE 190,A00,092507,Dubnov; Shlomo,7,0,20,13
1657204823449,ECE 45,A01,083139,Congero; Spencer William,5,0,75,70
1657204829484,ECE 65,A50,083695,Saad; Andrew S,12,0,30,18
1657204829484,ECE 65,A51,095125,Saad; Andrew S,25,0,26,1
1657204835523,ECE 109,A01,091882,Touri; Behrouz,19,0,70,51
1657204841560,ECE 180,A00,083140,Abi Samra; Nicholas Camill,1,0,30,29
1657204841560,ECE 180,B00,083141,Abi Samra; Nicholas Camill,0,0,30,30
1657204847593,MATH 10A,A01,083735,Patchell; Gregory David,2,0,30,28
1657204847593,MATH 10A,A02,083736,Patchell; Gregory David,20,0,30,10
1657204847593,MATH 10A,A03,083737,Patchell; Gregory David,16,0,30,14
1657204853630,MATH 10B,A01,083207,Lim; Seonhee,7,0,34,27
1657204853630,MATH 10B,A02,083208,Lim; Seonhee,9,0,35,26
1657204853630,MATH 10B,A03,093472,Lim; Seonhee,5,0,34,29
1657204853630,MATH 10B,B01,083739,Sinha; Shubham,10,0,30,20
1657204859678,MATH 18,A01,083743,Cinel; Cameron Alexander,6,0,30,24
1657204859678,MATH 18,A02,083744,Cinel; Cameron Alexander,15,0,30,15
1657204859678,MATH 18,A03,083745,Cinel; Cameron Alexander,8,0,30,22
1657204859678,MATH 18,B01,083748,Rideout; David Porter,4,0,37,33
1657204859678,MATH 18,B02,083749,Rideout; David Porter,4,0,36,32
1657204859678,MATH 18,B03,083750,Rideout; David Porter,2,0,37,35
1657204859678,MATH 18,B04,083751,Rideout; David Porter,5,0,36,31
1657204859678,MATH 18,B05,093473,Rideout; David Porter,5,0,36,31
1657204859678,MATH 18,B06,093474,Rideout; David Porter,5,0,36,31
1657204865717,MATH 20A,A01,083754,Zheng; Zequn,13,0,40,27
1657204871754,MATH 20B,A01,083756,Briones; Jor-el Thomas Caparas,1,0,36,35
1657204871754,MATH 20B,A02,083757,Briones; Jor-el Thomas Caparas,1,0,36,35
1657204871754,MATH 20B,A03,093475,Briones; Jor-el Thomas Caparas,1,0,36,35
1657204877798,MATH 20C,A01,083760,Briones; Jor-el Thomas Caparas,1,0,35,34
1657204877798,MATH 20C,A02,083761,Briones; Jor-el Thomas Caparas,8,0,35,27
1657204877798,MATH 20C,A03,093476,Briones; Jor-el Thomas Caparas,0,1,36,36
1657204877798,MATH 20C,B01,083762,Bach; Quang Tran,1,0,30,29
1657204883920,MATH 20D,A01,083765,Tran; Brian Kha,4,0,30,26
1657204883920,MATH 20D,A02,083766,Tran; Brian Kha,5,0,30,25
1657204883920,MATH 20D,A03,083767,Tran; Brian Kha,4,0,30,26
1657204889958,MATH 20E,A01,083771,Ganguly; Soumya,7,0,32,25
1657204889958,MATH 20E,A02,083772,Ganguly; Soumya,7,0,32,25
1657204889958,MATH 20E,B01,083773,Ciotti; Benjamin,19,0,35,16
1657204889958,MATH 20E,B02,083774,Ciotti; Benjamin,17,0,35,18
1657204895991,MATH 103A,A01,083777,Greenfeld; Be'Eri,2,0,36,34
1657204895991,MATH 103A,A02,083778,Greenfeld; Be'Eri,5,0,36,31
1657204895991,MATH 103A,A03,093561,Greenfeld; Be'Eri,4,0,36,32
1657204895991,MATH 103A,B01,083779,Greenfeld; Be'Eri,6,0,36,30
1657204895991,MATH 103A,B02,083780,Greenfeld; Be'Eri,3,0,36,33
1657204895991,MATH 103A,B03,093562,Greenfeld; Be'Eri,3,0,36,33
1657204902019,MATH 105,A01,085443,Carter; Anne Toulson,14,0,35,21
1657204902019,MATH 105,A02,093477,Carter; Anne Toulson,20,0,35,15
1657204908055,MATH 109,A01,083213,Ganzberger; Geoffrey Michael,2,0,34,32
1657204908055,MATH 109,A02,083214,Ganzberger; Geoffrey Michael,4,0,34,30
1657204908055,MATH 109,A03,093478,Ganzberger; Geoffrey Michael,1,0,34,33
1657204908055,MATH 109,B01,083215,Ganzberger; Geoffrey Michael,1,0,32,31
1657204908055,MATH 109,B02,083216,Ganzberger; Geoffrey Michael,1,0,32,31
1657204908055,MATH 109,B03,093479,Ganzberger; Geoffrey Michael,7,0,32,25
1657204914104,MATH 142A,A01,083219,Chow; Bennett,6,0,32,26
1657204914104,MATH 142A,A02,083220,Chow; Bennett,10,0,32,22
1657204914104,MATH 142A,A03,093480,Chow; Bennett,7,0,32,25
1657204914104,MATH 142A,B03,093481,Chow; Bennett,8,0,32,24
1657204914104,MATH 142A,B04,093558,Chow; Bennett,11,0,32,21
1657204914104,MATH 142A,B05,093559,Chow; Bennett,6,0,32,26
1657204920143,MATH 193A,A01,083224,Rotar; Vladimir,7,0,34,27
1657204920143,MATH 193A,A02,083225,Rotar; Vladimir,5,0,34,29
1657204920143,MATH 193A,A03,083781,Rotar; Vladimir,1,0,34,33
1657204920143,MATH 193A,A04,083782,Rotar; Vladimir,8,0,34,26
1657204920143,MATH 193A,A05,093482,Rotar; Vladimir,6,0,34,28
1657204926169,MATH 197,001,091859,McAuley; Julian John,9999,0,9999,0
1657204926169,MATH 197,002,095566,Kedlaya; Kiran S.,9997,0,9999,2
1657204926169,MATH 197,003,095567,Xiao; Ming,9999,0,9999,0
1657204926169,MATH 197,004,095571,Perols; Johan Lars,9998,0,9999,1
1657204933282,COGS 9,A01,083615,Shannon; Kyle Michael,7,0,75,68
1657204939324,COGS 11,A01,083617,Boyle; Mary E. T.,22,0,48,26
1657204945358,COGS 13,A01,083071,Bastos; Amalia Pinkusfeld,9,0,71,62
1657204951406,COGS 14A,A01,092681,Semenuks; Arturs,1,1,100,99
1657204957430,COGS 14B,A01,083073,Cheng; Tzu-Han,6,0,63,57
1657204963455,COGS 17,A01,092677,Semenuks; Arturs,4,0,81,77
1657204969486,COGS 100,A01,083619,Allen; Michael Gordon,15,0,70,55
1657204975513,COGS 101A,A01,083621,Davis; Joshua Daniel,9,0,68,59
1657204981555,COGS 101B,A01,091572,Allen; Michael Gordon,9,0,65,56
1657204987591,COGS 101C,A01,083625,Delgado; Tania,17,0,35,18
1657204993615,COGS 107A,A01,083627,Boyle; Mary E. T.,13,0,60,47
1657204999650,COGS 118A,A01,083075,Gupta; Anjum,16,0,76,60
1657205005681,CSE 3,A50,083646,Miranda; Gregory Joseph,24,0,50,26
1657205011723,CSE 8A,A50,083650,Miranda; Gregory Joseph,17,1,56,39
1657205017758,CSE 11,A01,083080,Cao; Yingjun,5,15,40,35
1657205023784,CSE 12,A01,083652,Krause-Levy; Sophia Louisa,24,1,120,96
1657205029808,CSE 15L,A01,083654,Morris; Justin Loren,9,0,50,41
1657205029808,CSE 15L,A02,083655,Morris; Justin Loren,9,0,50,41
1657205035848,CSE 20,A01,083657,Tran; Khoa Dang,38,0,80,42
1657205041894,CSE 21,A01,095574,Bach; Quang Tran,22,0,48,26
1657205047935,CSE 30,A01,083084,Eldon; John,4,0,80,76
1657205047935,CSE 30,B01,095061,Bhaskar; Nishant,7,0,50,43
1657205053977,CSE 100,A01,083659,Cao; Yingjun,4,4,70,66
1657205060004,CSE 134B,A01,083661,Powell; Thomas Allan,20,0,100,80
1657205066027,CSE 140,A01,083663,Gungor; Onat,13,0,85,72
1657205072052,CSE 140L,A01,083088,Eldon; John,17,0,100,83
1657205078091,CSE 175,A01,083665,Kumar; Rakesh,3,0,25,22
1657205084116,CSE 190,A00,092507,Dubnov; Shlomo,7,0,20,13
1657205090158,ECE 45,A01,083139,Congero; Spencer William,5,0,75,70
1657205096204,ECE 65,A50,083695,Saad; Andrew S,12,0,30,18
1657205096204,ECE 65,A51,095125,Saad; Andrew S,25,0,26,1
1657205102236,ECE 109,A01,091882,Touri; Behrouz,19,0,70,51
1657205108272,ECE 180,A00,083140,Abi Samra; Nicholas Camill,1,0,30,29
1657205108272,ECE 180,B00,083141,Abi Samra; Nicholas Camill,0,0,30,30
1657205114304,MATH 10A,A01,083735,Patchell; Gregory David,2,0,30,28
1657205114304,MATH 10A,A02,083736,Patchell; Gregory David,20,0,30,10
1657205114304,MATH 10A,A03,083737,Patchell; Gregory David,16,0,30,14
1657205120344,MATH 10B,A01,083207,Lim; Seonhee,7,0,34,27
1657205120344,MATH 10B,A02,083208,Lim; Seonhee,9,0,35,26
1657205120344,MATH 10B,A03,093472,Lim; Seonhee,5,0,34,29
1657205120344,MATH 10B,B01,083739,Sinha; Shubham,10,0,30,20
1657205126386,MATH 18,A01,083743,Cinel; Cameron Alexander,6,0,30,24
1657205126386,MATH 18,A02,083744,Cinel; Cameron Alexander,15,0,30,15
1657205126386,MATH 18,A03,083745,Cinel; Cameron Alexander,8,0,30,22
1657205126386,MATH 18,B01,083748,Rideout; David Porter,4,0,37,33
1657205126386,MATH 18,B02,083749,Rideout; David Porter,4,0,36,32
1657205126386,MATH 18,B03,083750,Rideout; David Porter,2,0,37,35
1657205126386,MATH 18,B04,083751,Rideout; David Porter,5,0,36,31
1657205126386,MATH 18,B05,093473,Rideout; David Porter,5,0,36,31
1657205126386,MATH 18,B06,093474,Rideout; David Porter,5,0,36,31
1657205132431,MATH 20A,A01,083754,Zheng; Zequn,13,0,40,27
1657205138465,MATH 20B,A01,083756,Briones; Jor-el Thomas Caparas,1,0,36,35
1657205138465,MATH 20B,A02,083757,Briones; Jor-el Thomas Caparas,1,0,36,35
1657205138465,MATH 20B,A03,093475,Briones; Jor-el Thomas Caparas,1,0,36,35
1657205144520,MATH 20C,A01,083760,Briones; Jor-el Thomas Caparas,1,0,35,34
1657205144520,MATH 20C,A02,083761,Briones; Jor-el Thomas Caparas,8,0,35,27
1657205144520,MATH 20C,A03,093476,Briones; Jor-el Thomas Caparas,0,1,36,36
1657205144520,MATH 20C,B01,083762,Bach; Quang Tran,1,0,30,29
1657205150555,MATH 20D,A01,083765,Tran; Brian Kha,4,0,30,26
1657205150555,MATH 20D,A02,083766,Tran; Brian Kha,5,0,30,25
1657205150555,MATH 20D,A03,083767,Tran; Brian Kha,4,0,30,26
1657205156601,MATH 20E,A01,083771,Ganguly; Soumya,7,0,32,25
1657205156601,MATH 20E,A02,083772,Ganguly; Soumya,7,0,32,25
1657205156601,MATH 20E,B01,083773,Ciotti; Benjamin,19,0,35,16
1657205156601,MATH 20E,B02,083774,Ciotti; Benjamin,17,0,35,18
1657205162634,MATH 103A,A01,083777,Greenfeld; Be'Eri,2,0,36,34
1657205162634,MATH 103A,A02,083778,Greenfeld; Be'Eri,5,0,36,31
1657205162634,MATH 103A,A03,093561,Greenfeld; Be'Eri,4,0,36,32
1657205162634,MATH 103A,B01,083779,Greenfeld; Be'Eri,6,0,36,30
1657205162634,MATH 103A,B02,083780,Greenfeld; Be'Eri,3,0,36,33
1657205162634,MATH 103A,B03,093562,Greenfeld; Be'Eri,3,0,36,33
1657205168679,MATH 105,A01,085443,Carter; Anne Toulson,15,0,35,20
1657205168679,MATH 105,A02,093477,Carter; Anne Toulson,20,0,35,15
1657205174715,MATH 109,A01,083213,Ganzberger; Geoffrey Michael,2,0,34,32
1657205174715,MATH 109,A02,083214,Ganzberger; Geoffrey Michael,4,0,34,30
1657205174715,MATH 109,A03,093478,Ganzberger; Geoffrey Michael,1,0,34,33
1657205174715,MATH 109,B01,083215,Ganzberger; Geoffrey Michael,1,0,32,31
1657205174715,MATH 109,B02,083216,Ganzberger; Geoffrey Michael,1,0,32,31
1657205174715,MATH 109,B03,093479,Ganzberger; Geoffrey Michael,7,0,32,25
1657205180743,MATH 142A,A01,083219,Chow; Bennett,6,0,32,26
1657205180743,MATH 142A,A02,083220,Chow; Bennett,10,0,32,22
1657205180743,MATH 142A,A03,093480,Chow; Bennett,7,0,32,25
1657205180743,MATH 142A,B03,093481,Chow; Bennett,8,0,32,24
1657205180743,MATH 142A,B04,093558,Chow; Bennett,11,0,32,21
1657205180743,MATH 142A,B05,093559,Chow; Bennett,6,0,32,26
1657205186777,MATH 193A,A01,083224,Rotar; Vladimir,7,0,34,27
1657205186777,MATH 193A,A02,083225,Rotar; Vladimir,5,0,34,29
1657205186777,MATH 193A,A03,083781,Rotar; Vladimir,1,0,34,33
1657205186777,MATH 193A,A04,083782,Rotar; Vladimir,8,0,34,26
1657205186777,MATH 193A,A05,093482,Rotar; Vladimir,6,0,34,28
1657205192819,MATH 197,001,091859,McAuley; Julian John,9999,0,9999,0
1657205192819,MATH 197,002,095566,Kedlaya; Kiran S.,9997,0,9999,2
1657205192819,MATH 197,003,095567,Xiao; Ming,9999,0,9999,0
1657205192819,MATH 197,004,095571,Perols; Johan Lars,9998,0,9999,1
1657205199912,COGS 9,A01,083615,Shannon; Kyle Michael,7,0,75,68
1657205205963,COGS 11,A01,083617,Boyle; Mary E. T.,22,0,48,26
1657205212013,COGS 13,A01,083071,Bastos; Amalia Pinkusfeld,9,0,71,62
1657205218045,COGS 14A,A01,092681,Semenuks; Arturs,1,1,100,99
1657205224069,COGS 14B,A01,083073,Cheng; Tzu-Han,6,0,63,57
1657205230097,COGS 17,A01,092677,Semenuks; Arturs,4,0,81,77
1657205236133,COGS 100,A01,083619,Allen; Michael Gordon,15,0,70,55
1657205242175,COGS 101A,A01,083621,Davis; Joshua Daniel,9,0,68,59
1657205248219,COGS 101B,A01,091572,Allen; Michael Gordon,9,0,65,56
1657205254253,COGS 101C,A01,083625,Delgado; Tania,17,0,35,18
1657205260287,COGS 107A,A01,083627,Boyle; Mary E. T.,13,0,60,47
1657205266322,COGS 118A,A01,083075,Gupta; Anjum,16,0,76,60
1657205272362,CSE 3,A50,083646,Miranda; Gregory Joseph,24,0,50,26
1657205278393,CSE 8A,A50,083650,Miranda; Gregory Joseph,17,1,56,39
1657205284421,CSE 11,A01,083080,Cao; Yingjun,5,15,40,35
1657205290453,CSE 12,A01,083652,Krause-Levy; Sophia Louisa,24,1,120,96
1657205296490,CSE 15L,A01,083654,Morris; Justin Loren,9,0,50,41
1657205296490,CSE 15L,A02,083655,Morris; Justin Loren,9,0,50,41
1657205302534,CSE 20,A01,083657,Tran; Khoa Dang,38,0,80,42
1657205308572,CSE 21,A01,095574,Bach; Quang Tran,22,0,48,26
1657205314613,CSE 30,A01,083084,Eldon; John,4,0,80,76
1657205314613,CSE 30,B01,095061,Bhaskar; Nishant,7,0,50,43
1657205320657,CSE 100,A01,083659,Cao; Yingjun,4,4,70,66
1657205326696,CSE 134B,A01,083661,Powell; Thomas Allan,20,0,100,80
1657205332730,CSE 140,A01,083663,Gungor; Onat,13,0,85,72
1657205338765,CSE 140L,A01,083088,Eldon; John,17,0,100,83
1657205344792,CSE 175,A01,083665,Kumar; Rakesh,3,0,25,22
1657205350816,CSE 190,A00,092507,Dubnov; Shlomo,7,0,20,13
1657205356851,ECE 45,A01,083139,Congero; Spencer William,5,0,75,70
1657205362878,ECE 65,A50,083695,Saad; Andrew S,12,0,30,18
1657205362878,ECE 65,A51,095125,Saad; Andrew S,25,0,26,1
1657205368911,ECE 109,A01,091882,Touri; Behrouz,19,0,70,51
1657205374940,ECE 180,A00,083140,Abi Samra; Nicholas Camill,1,0,30,29
1657205374940,ECE 180,B00,083141,Abi Samra; Nicholas Camill,0,0,30,30
1657205380969,MATH 10A,A01,083735,Patchell; Gregory David,2,0,30,28
1657205380969,MATH 10A,A02,083736,Patchell; Gregory David,20,0,30,10
1657205380969,MATH 10A,A03,083737,Patchell; Gregory David,16,0,30,14
1657205387011,MATH 10B,A01,083207,Lim; Seonhee,7,0,34,27
1657205387011,MATH 10B,A02,083208,Lim; Seonhee,9,0,35,26
1657205387011,MATH 10B,A03,093472,Lim; Seonhee,5,0,34,29
1657205387011,MATH 10B,B01,083739,Sinha; Shubham,10,0,30,20
1657205393063,MATH 18,A01,083743,Cinel; Cameron Alexander,6,0,30,24
1657205393063,MATH 18,A02,083744,Cinel; Cameron Alexander,15,0,30,15
1657205393063,MATH 18,A03,083745,Cinel; Cameron Alexander,8,0,30,22
1657205393063,MATH 18,B01,083748,Rideout; David Porter,4,0,37,33
1657205393063,MATH 18,B02,083749,Rideout; David Porter,4,0,36,32
1657205393063,MATH 18,B03,083750,Rideout; David Porter,2,0,37,35
1657205393063,MATH 18,B04,083751,Rideout; David Porter,5,0,36,31
1657205393063,MATH 18,B05,093473,Rideout; David Porter,5,0,36,31
1657205393063,MATH 18,B06,093474,Rideout; David Porter,5,0,36,31
1657205399091,MATH 20A,A01,083754,Zheng; Zequn,13,0,40,27
1657205405123,MATH 20B,A01,083756,Briones; Jor-el Thomas Caparas,1,0,36,35
1657205405123,MATH 20B,A02,083757,Briones; Jor-el Thomas Caparas,1,0,36,35
1657205405123,MATH 20B,A03,093475,Briones; Jor-el Thomas Caparas,1,0,36,35
1657205411172,MATH 20C,A01,083760,Briones; Jor-el Thomas Caparas,1,0,35,34
1657205411172,MATH 20C,A02,083761,Briones; Jor-el Thomas Caparas,8,0,35,27
1657205411172,MATH 20C,A03,093476,Briones; Jor-el Thomas Caparas,0,1,36,36
1657205411172,MATH 20C,B01,083762,Bach; Quang Tran,1,0,30,29
1657205417209,MATH 20D,A01,083765,Tran; Brian Kha,4,0,30,26
1657205417209,MATH 20D,A02,083766,Tran; Brian Kha,5,0,30,25
1657205417209,MATH 20D,A03,083767,Tran; Brian Kha,4,0,30,26
1657205423236,MATH 20E,A01,083771,Ganguly; Soumya,7,0,32,25
1657205423236,MATH 20E,A02,083772,Ganguly; Soumya,7,0,32,25
1657205423236,MATH 20E,B01,083773,Ciotti; Benjamin,19,0,35,16
1657205423236,MATH 20E,B02,083774,Ciotti; Benjamin,17,0,35,18
1657205429278,MATH 103A,A01,083777,Greenfeld; Be'Eri,2,0,36,34
1657205429278,MATH 103A,A02,083778,Greenfeld; Be'Eri,5,0,36,31
1657205429278,MATH 103A,A03,093561,Greenfeld; Be'Eri,4,0,36,32
1657205429278,MATH 103A,B01,083779,Greenfeld; Be'Eri,6,0,36,30
1657205429278,MATH 103A,B02,083780,Greenfeld; Be'Eri,3,0,36,33
1657205429278,MATH 103A,B03,093562,Greenfeld; Be'Eri,3,0,36,33
1657205435322,MATH 105,A01,085443,Carter; Anne Toulson,15,0,35,20
1657205435322,MATH 105,A02,093477,Carter; Anne Toulson,20,0,35,15
1657205441347,MATH 109,A01,083213,Ganzberger; Geoffrey Michael,2,0,34,32
1657205441347,MATH 109,A02,083214,Ganzberger; Geoffrey Michael,4,0,34,30
1657205441347,MATH 109,A03,093478,Ganzberger; Geoffrey Michael,1,0,34,33
1657205441347,MATH 109,B01,083215,Ganzberger; Geoffrey Michael,1,0,32,31
1657205441347,MATH 109,B02,083216,Ganzberger; Geoffrey Michael,1,0,32,31
1657205441347,MATH 109,B03,093479,Ganzberger; Geoffrey Michael,7,0,32,25
1657205447374,MATH 142A,A01,083219,Chow; Bennett,6,0,32,26
1657205447374,MATH 142A,A02,083220,Chow; Bennett,10,0,32,22
1657205447374,MATH 142A,A03,093480,Chow; Bennett,7,0,32,25
1657205447374,MATH 142A,B03,093481,Chow; Bennett,8,0,32,24
1657205447374,MATH 142A,B04,093558,Chow; Bennett,11,0,32,21
1657205447374,MATH 142A,B05,093559,Chow; Bennett,6,0,32,26
1657205453422,MATH 193A,A01,083224,Rotar; Vladimir,7,0,34,27
1657205453422,MATH 193A,A02,083225,Rotar; Vladimir,5,0,34,29
1657205453422,MATH 193A,A03,083781,Rotar; Vladimir,1,0,34,33
1657205453422,MATH 193A,A04,083782,Rotar; Vladimir,8,0,34,26
1657205453422,MATH 193A,A05,093482,Rotar; Vladimir,6,0,34,28
1657205459447,MATH 197,001,091859,McAuley; Julian John,9999,0,9999,0
1657205459447,MATH 197,002,095566,Kedlaya; Kiran S.,9997,0,9999,2
1657205459447,MATH 197,003,095567,Xiao; Ming,9999,0,9999,0
1657205459447,MATH 197,004,095571,Perols; Johan Lars,9998,0,9999,1
1657205466544,COGS 9,A01,083615,Shannon; Kyle Michael,7,0,75,68
1657205472588,COGS 11,A01,083617,Boyle; Mary E. T.,22,0,48,26
1657205478684,COGS 13,A01,083071,Bastos; Amalia Pinkusfeld,9,0,71,62
1657205484714,COGS 14A,A01,092681,Semenuks; Arturs,1,1,100,99
1657205490754,COGS 14B,A01,083073,Cheng; Tzu-Han,6,0,63,57
1657205496785,COGS 17,A01,092677,Semenuks; Arturs,4,0,81,77
1657205502828,COGS 100,A01,083619,Allen; Michael Gordon,15,0,70,55
1657205508853,COGS 101A,A01,083621,Davis; Joshua Daniel,9,0,68,59
1657205514892,COGS 101B,A01,091572,Allen; Michael Gordon,9,0,65,56
1657205520922,COGS 101C,A01,083625,Delgado; Tania,17,0,35,18
1657205526996,COGS 107A,A01,083627,Boyle; Mary E. T.,13,0,60,47
1657205533022,COGS 118A,A01,083075,Gupta; Anjum,16,0,76,60
1657205539058,CSE 3,A50,083646,Miranda; Gregory Joseph,24,0,50,26
1657205545091,CSE 8A,A50,083650,Miranda; Gregory Joseph,17,1,56,39
1657205551125,CSE 11,A01,083080,Cao; Yingjun,5,15,40,35
1657205557177,CSE 12,A01,083652,Krause-Levy; Sophia Louisa,24,1,120,96
1657205563224,CSE 15L,A01,083654,Morris; Justin Loren,9,0,50,41
1657205563224,CSE 15L,A02,083655,Morris; Justin Loren,9,0,50,41
1657205569246,CSE 20,A01,083657,Tran; Khoa Dang,38,0,80,42
1657205575274,CSE 21,A01,095574,Bach; Quang Tran,22,0,48,26
1657205581317,CSE 30,A01,083084,Eldon; John,4,0,80,76
1657205581317,CSE 30,B01,095061,Bhaskar; Nishant,7,0,50,43
1657205587348,CSE 100,A01,083659,Cao; Yingjun,4,4,70,66
1657205593389,CSE 134B,A01,083661,Powell; Thomas Allan,20,0,100,80
1657205599423,CSE 140,A01,083663,Gungor; Onat,13,0,85,72
1657205605448,CSE 140L,A01,083088,Eldon; John,17,0,100,83
1657205611474,CSE 175,A01,083665,Kumar; Rakesh,3,0,25,22
1657205617509,CSE 190,A00,092507,Dubnov; Shlomo,7,0,20,13
1657205623533,ECE 45,A01,083139,Congero; Spencer William,5,0,75,70
1657205629558,ECE 65,A50,083695,Saad; Andrew S,12,0,30,18
1657205629558,ECE 65,A51,095125,Saad; Andrew S,25,0,26,1
1657205635582,ECE 109,A01,091882,Touri; Behrouz,19,0,70,51
1657205641605,ECE 180,A00,083140,Abi Samra; Nicholas Camill,1,0,30,29
1657205641605,ECE 180,B00,083141,Abi Samra; Nicholas Camill,0,0,30,30
1657205647650,MATH 10A,A01,083735,Patchell; Gregory David,2,0,30,28
1657205647650,MATH 10A,A02,083736,Patchell; Gregory David,20,0,30,10
1657205647650,MATH 10A,A03,083737,Patchell; Gregory David,16,0,30,14
1657205653686,MATH 10B,A01,083207,Lim; Seonhee,7,0,34,27
1657205653686,MATH 10B,A02,083208,Lim; Seonhee,9,0,35,26
1657205653686,MATH 10B,A03,093472,Lim; Seonhee,5,0,34,29
1657205653686,MATH 10B,B01,083739,Sinha; Shubham,10,0,30,20
1657205659719,MATH 18,A01,083743,Cinel; Cameron Alexander,6,0,30,24
1657205659719,MATH 18,A02,083744,Cinel; Cameron Alexander,15,0,30,15
1657205659719,MATH 18,A03,083745,Cinel; Cameron Alexander,8,0,30,22
1657205659719,MATH 18,B01,083748,Rideout; David Porter,4,0,37,33
1657205659719,MATH 18,B02,083749,Rideout; David Porter,4,0,36,32
1657205659719,MATH 18,B03,083750,Rideout; David Porter,2,0,37,35
1657205659719,MATH 18,B04,083751,Rideout; David Porter,5,0,36,31
1657205659719,MATH 18,B05,093473,Rideout; David Porter,5,0,36,31
1657205659719,MATH 18,B06,093474,Rideout; David Porter,5,0,36,31
1657205665752,MATH 20A,A01,083754,Zheng; Zequn,13,0,40,27
1657205671788,MATH 20B,A01,083756,Briones; Jor-el Thomas Caparas,1,0,36,35
1657205671788,MATH 20B,A02,083757,Briones; Jor-el Thomas Caparas,1,0,36,35
1657205671788,MATH 20B,A03,093475,Briones; Jor-el Thomas Caparas,1,0,36,35
1657205677835,MATH 20C,A01,083760,Briones; Jor-el Thomas Caparas,1,0,35,34
1657205677835,MATH 20C,A02,083761,Briones; Jor-el Thomas Caparas,8,0,35,27
1657205677835,MATH 20C,A03,093476,Briones; Jor-el Thomas Caparas,0,1,36,36
1657205677835,MATH 20C,B01,083762,Bach; Quang Tran,1,0,30,29
1657205683873,MATH 20D,A01,083765,Tran; Brian Kha,4,0,30,26
1657205683873,MATH 20D,A02,083766,Tran; Brian Kha,5,0,30,25
1657205683873,MATH 20D,A03,083767,Tran; Brian Kha,4,0,30,26
1657205689902,MATH 20E,A01,083771,Ganguly; Soumya,7,0,32,25
1657205689902,MATH 20E,A02,083772,Ganguly; Soumya,7,0,32,25
1657205689902,MATH 20E,B01,083773,Ciotti; Benjamin,19,0,35,16
1657205689902,MATH 20E,B02,083774,Ciotti; Benjamin,17,0,35,18
1657205695945,MATH 103A,A01,083777,Greenfeld; Be'Eri,2,0,36,34
1657205695945,MATH 103A,A02,083778,Greenfeld; Be'Eri,5,0,36,31
1657205695945,MATH 103A,A03,093561,Greenfeld; Be'Eri,4,0,36,32
1657205695945,MATH 103A,B01,083779,Greenfeld; Be'Eri,6,0,36,30
1657205695945,MATH 103A,B02,083780,Greenfeld; Be'Eri,3,0,36,33
1657205695945,MATH 103A,B03,093562,Greenfeld; Be'Eri,3,0,36,33
1657205701979,MATH 105,A01,085443,Carter; Anne Toulson,15,0,35,20
1657205701979,MATH 105,A02,093477,Carter; Anne Toulson,20,0,35,15
1657205708008,MATH 109,A01,083213,Ganzberger; Geoffrey Michael,2,0,34,32
1657205708008,MATH 109,A02,083214,Ganzberger; Geoffrey Michael,4,0,34,30
1657205708008,MATH 109,A03,093478,Ganzberger; Geoffrey Michael,1,0,34,33
1657205708008,MATH 109,B01,083215,Ganzberger; Geoffrey Michael,1,0,32,31
1657205708008,MATH 109,B02,083216,Ganzberger; Geoffrey Michael,1,0,32,31
1657205708008,MATH 109,B03,093479,Ganzberger; Geoffrey Michael,7,0,32,25
1657205714034,MATH 142A,A01,083219,Chow; Bennett,6,0,32,26
1657205714034,MATH 142A,A02,083220,Chow; Bennett,10,0,32,22
1657205714034,MATH 142A,A03,093480,Chow; Bennett,7,0,32,25
1657205714034,MATH 142A,B03,093481,Chow; Bennett,8,0,32,24
1657205714034,MATH 142A,B04,093558,Chow; Bennett,11,0,32,21
1657205714034,MATH 142A,B05,093559,Chow; Bennett,6,0,32,26
1657205720077,MATH 193A,A01,083224,Rotar; Vladimir,7,0,34,27
1657205720077,MATH 193A,A02,083225,Rotar; Vladimir,5,0,34,29
1657205720077,MATH 193A,A03,083781,Rotar; Vladimir,1,0,34,33
1657205720077,MATH 193A,A04,083782,Rotar; Vladimir,8,0,34,26
1657205720077,MATH 193A,A05,093482,Rotar; Vladimir,6,0,34,28
1657205726111,MATH 197,001,091859,McAuley; Julian John,9999,0,9999,0
1657205726111,MATH 197,002,095566,Kedlaya; Kiran S.,9997,0,9999,2
1657205726111,MATH 197,003,095567,Xiao; Ming,9999,0,9999,0
1657205726111,MATH 197,004,095571,Perols; Johan Lars,9998,0,9999,1
1657205733176,COGS 9,A01,083615,Shannon; Kyle Michael,7,0,75,68
1657205739226,COGS 11,A01,083617,Boyle; Mary E. T.,22,0,48,26
1657205745277,COGS 13,A01,083071,Bastos; Amalia Pinkusfeld,9,0,71,62
1657205751334,COGS 14A,A01,092681,Semenuks; Arturs,1,1,100,99
1657205757359,COGS 14B,A01,083073,Cheng; Tzu-Han,6,0,63,57
1657205763384,COGS 17,A01,092677,Semenuks; Arturs,4,0,81,77
1657205769425,COGS 100,A01,083619,Allen; Michael Gordon,15,0,70,55
1657205775481,COGS 101A,A01,083621,Davis; Joshua Daniel,9,0,68,59
1657205781519,COGS 101B,A01,091572,Allen; Michael Gordon,9,0,65,56
1657205787597,COGS 101C,A01,083625,Delgado; Tania,17,0,35,18
1657205793653,COGS 107A,A01,083627,Boyle; Mary E. T.,13,0,60,47
1657205799678,COGS 118A,A01,083075,Gupta; Anjum,16,0,76,60
1657205805707,CSE 3,A50,083646,Miranda; Gregory Joseph,24,0,50,26
1657205811754,CSE 8A,A50,083650,Miranda; Gregory Joseph,17,1,56,39
1657205817823,CSE 11,A01,083080,Cao; Yingjun,5,15,40,35
1657205823873,CSE 12,A01,083652,Krause-Levy; Sophia Louisa,24,1,120,96
1657205829924,CSE 15L,A01,083654,Morris; Justin Loren,9,0,50,41
1657205829924,CSE 15L,A02,083655,Morris; Justin Loren,9,0,50,41
1657205835970,CSE 20,A01,083657,Tran; Khoa Dang,38,0,80,42
1657205842009,CSE 21,A01,095574,Bach; Quang Tran,22,0,48,26
1657205848037,CSE 30,A01,083084,Eldon; John,4,0,80,76
1657205848037,CSE 30,B01,095061,Bhaskar; Nishant,7,0,50,43
1657205854071,CSE 100,A01,083659,Cao; Yingjun,4,4,70,66
1657205860114,CSE 134B,A01,083661,Powell; Thomas Allan,20,0,100,80
1657205866161,CSE 140,A01,083663,Gungor; Onat,13,0,85,72
1657205872200,CSE 140L,A01,083088,Eldon; John,17,0,100,83
1657205878246,CSE 175,A01,083665,Kumar; Rakesh,3,0,25,22
1657205884306,CSE 190,A00,092507,Dubnov; Shlomo,7,0,20,13
1657205890343,ECE 45,A01,083139,Congero; Spencer William,5,0,75,70
1657205896368,ECE 65,A50,083695,Saad; Andrew S,12,0,30,18
1657205896368,ECE 65,A51,095125,Saad; Andrew S,25,0,26,1
1657205902418,ECE 109,A01,091882,Touri; Behrouz,19,0,70,51
1657205908453,ECE 180,A00,083140,Abi Samra; Nicholas Camill,1,0,30,29
1657205908453,ECE 180,B00,083141,Abi Samra; Nicholas Camill,0,0,30,30
1657205914498,MATH 10A,A01,083735,Patchell; Gregory David,2,0,30,28
1657205914498,MATH 10A,A02,083736,Patchell; Gregory David,20,0,30,10
1657205914498,MATH 10A,A03,083737,Patchell; Gregory David,16,0,30,14
1657205920533,MATH 10B,A01,083207,Lim; Seonhee,7,0,34,27
1657205920533,MATH 10B,A02,083208,Lim; Seonhee,9,0,35,26
1657205920533,MATH 10B,A03,093472,Lim; Seonhee,5,0,34,29
1657205920533,MATH 10B,B01,083739,Sinha; Shubham,10,0,30,20
1657205926579,MATH 18,A01,083743,Cinel; Cameron Alexander,6,0,30,24
1657205926579,MATH 18,A02,083744,Cinel; Cameron Alexander,15,0,30,15
1657205926579,MATH 18,A03,083745,Cinel; Cameron Alexander,8,0,30,22
1657205926579,MATH 18,B01,083748,Rideout; David Porter,4,0,37,33
1657205926579,MATH 18,B02,083749,Rideout; David Porter,4,0,36,32
1657205926579,MATH 18,B03,083750,Rideout; David Porter,2,0,37,35
1657205926579,MATH 18,B04,083751,Rideout; David Porter,5,0,36,31
1657205926579,MATH 18,B05,093473,Rideout; David Porter,5,0,36,31
1657205926579,MATH 18,B06,093474,Rideout; David Porter,5,0,36,31
1657205932601,MATH 20A,A01,083754,Zheng; Zequn,13,0,40,27
1657205938651,MATH 20B,A01,083756,Briones; Jor-el Thomas Caparas,1,0,36,35
1657205938651,MATH 20B,A02,083757,Briones; Jor-el Thomas Caparas,1,0,36,35
1657205938651,MATH 20B,A03,093475,Briones; Jor-el Thomas Caparas,1,0,36,35
1657205944677,MATH 20C,A01,083760,Briones; Jor-el Thomas Caparas,1,0,35,34
1657205944677,MATH 20C,A02,083761,Briones; Jor-el Thomas Caparas,8,0,35,27
1657205944677,MATH 20C,A03,093476,Briones; Jor-el Thomas Caparas,0,1,36,36
1657205944677,MATH 20C,B01,083762,Bach; Quang Tran,1,0,30,29
1657205950703,MATH 20D,A01,083765,Tran; Brian Kha,4,0,30,26
1657205950703,MATH 20D,A02,083766,Tran; Brian Kha,5,0,30,25
1657205950703,MATH 20D,A03,083767,Tran; Brian Kha,4,0,30,26
1657205956754,MATH 20E,A01,083771,Ganguly; Soumya,7,0,32,25
1657205956754,MATH 20E,A02,083772,Ganguly; Soumya,7,0,32,25
1657205956754,MATH 20E,B01,083773,Ciotti; Benjamin,19,0,35,16
1657205956754,MATH 20E,B02,083774,Ciotti; Benjamin,17,0,35,18
1657205962800,MATH 103A,A01,083777,Greenfeld; Be'Eri,2,0,36,34
1657205962800,MATH 103A,A02,083778,Greenfeld; Be'Eri,5,0,36,31
1657205962800,MATH 103A,A03,093561,Greenfeld; Be'Eri,4,0,36,32
1657205962800,MATH 103A,B01,083779,Greenfeld; Be'Eri,6,0,36,30
1657205962800,MATH 103A,B02,083780,Greenfeld; Be'Eri,3,0,36,33
1657205962800,MATH 103A,B03,093562,Greenfeld; Be'Eri,3,0,36,33
1657205968842,MATH 105,A01,085443,Carter; Anne Toulson,15,0,35,20
1657205968842,MATH 105,A02,093477,Carter; Anne Toulson,20,0,35,15
1657205974885,MATH 109,A01,083213,Ganzberger; Geoffrey Michael,2,0,34,32
1657205974885,MATH 109,A02,083214,Ganzberger; Geoffrey Michael,4,0,34,30
1657205974885,MATH 109,A03,093478,Ganzberger; Geoffrey Michael,1,0,34,33
1657205974885,MATH 109,B01,083215,Ganzberger; Geoffrey Michael,1,0,32,31
1657205974885,MATH 109,B02,083216,Ganzberger; Geoffrey Michael,1,0,32,31
1657205974885,MATH 109,B03,093479,Ganzberger; Geoffrey Michael,7,0,32,25
1657205980933,MATH 142A,A01,083219,Chow; Bennett,6,0,32,26
1657205980933,MATH 142A,A02,083220,Chow; Bennett,10,0,32,22
1657205980933,MATH 142A,A03,093480,Chow; Bennett,7,0,32,25
1657205980933,MATH 142A,B03,093481,Chow; Bennett,8,0,32,24
1657205980933,MATH 142A,B04,093558,Chow; Bennett,11,0,32,21
1657205980933,MATH 142A,B05,093559,Chow; Bennett,6,0,32,26
1657205986962,MATH 193A,A01,083224,Rotar; Vladimir,7,0,34,27
1657205986962,MATH 193A,A02,083225,Rotar; Vladimir,5,0,34,29
1657205986962,MATH 193A,A03,083781,Rotar; Vladimir,1,0,34,33
1657205986962,MATH 193A,A04,083782,Rotar; Vladimir,8,0,34,26
1657205986962,MATH 193A,A05,093482,Rotar; Vladimir,6,0,34,28
1657205993010,MATH 197,001,091859,McAuley; Julian John,9999,0,9999,0
1657205993010,MATH 197,002,095566,Kedlaya; Kiran S.,9997,0,9999,2
1657205993010,MATH 197,003,095567,Xiao; Ming,9999,0,9999,0
1657205993010,MATH 197,004,095571,Perols; Johan Lars,9998,0,9999,1
1657206000088,COGS 9,A01,083615,Shannon; Kyle Michael,7,0,75,68
1657206006118,COGS 11,A01,083617,Boyle; Mary E. T.,22,0,48,26
1657206012155,COGS 13,A01,083071,Bastos; Amalia Pinkusfeld,9,0,71,62
1657206018187,COGS 14A,A01,092681,Semenuks; Arturs,1,1,100,99
1657206024211,COGS 14B,A01,083073,Cheng; Tzu-Han,6,0,63,57
1657206030235,COGS 17,A01,092677,Semenuks; Arturs,4,0,81,77
1657206036277,COGS 100,A01,083619,Allen; Michael Gordon,15,0,70,55
1657206042322,COGS 101A,A01,083621,Davis; Joshua Daniel,9,0,68,59
1657206048378,COGS 101B,A01,091572,Allen; Michael Gordon,9,0,65,56
1657206054418,COGS 101C,A01,083625,Delgado; Tania,17,0,35,18
1657206060466,COGS 107A,A01,083627,Boyle; Mary E. T.,13,0,60,47
1657206066512,COGS 118A,A01,083075,Gupta; Anjum,16,0,76,60
1657206072561,CSE 3,A50,083646,Miranda; Gregory Joseph,24,0,50,26
1657206078680,CSE 8A,A50,083650,Miranda; Gregory Joseph,17,1,56,39
1657206084726,CSE 11,A01,083080,Cao; Yingjun,5,15,40,35
1657206090776,CSE 12,A01,083652,Krause-Levy; Sophia Louisa,24,1,120,96
1657206096815,CSE 15L,A01,083654,Morris; Justin Loren,9,0,50,41
1657206096815,CSE 15L,A02,083655,Morris; Justin Loren,9,0,50,41
1657206102851,CSE 20,A01,083657,Tran; Khoa Dang,38,0,80,42
1657206108907,CSE 21,A01,095574,Bach; Quang Tran,22,0,48,26
1657206114946,CSE 30,A01,083084,Eldon; John,4,0,80,76
1657206114946,CSE 30,B01,095061,Bhaskar; Nishant,7,0,50,43
1657206120972,CSE 100,A01,083659,Cao; Yingjun,4,4,70,66
1657206127001,CSE 134B,A01,083661,Powell; Thomas Allan,20,0,100,80
1657206133042,CSE 140,A01,083663,Gungor; Onat,13,0,85,72
1657206139079,CSE 140L,A01,083088,Eldon; John,17,0,100,83
1657206145104,CSE 175,A01,083665,Kumar; Rakesh,3,0,25,22
1657206151142,CSE 190,A00,092507,Dubnov; Shlomo,7,0,20,13
1657206157192,ECE 45,A01,083139,Congero; Spencer William,5,0,75,70
1657206163216,ECE 65,A50,083695,Saad; Andrew S,12,0,30,18
1657206163216,ECE 65,A51,095125,Saad; Andrew S,25,0,26,1
1657206169247,ECE 109,A01,091882,Touri; Behrouz,19,0,70,51
1657206175286,ECE 180,A00,083140,Abi Samra; Nicholas Camill,1,0,30,29
1657206175286,ECE 180,B00,083141,Abi Samra; Nicholas Camill,0,0,30,30
1657206181311,MATH 10A,A01,083735,Patchell; Gregory David,2,0,30,28
1657206181311,MATH 10A,A02,083736,Patchell; Gregory David,20,0,30,10
1657206181311,MATH 10A,A03,083737,Patchell; Gregory David,16,0,30,14
1657206187361,MATH 10B,A01,083207,Lim; Seonhee,7,0,34,27
1657206187361,MATH 10B,A02,083208,Lim; Seonhee,9,0,35,26
1657206187361,MATH 10B,A03,093472,Lim; Seonhee,5,0,34,29
1657206187361,MATH 10B,B01,083739,Sinha; Shubham,10,0,30,20
1657206193403,MATH 18,A01,083743,Cinel; Cameron Alexander,6,0,30,24
1657206193403,MATH 18,A02,083744,Cinel; Cameron Alexander,15,0,30,15
1657206193403,MATH 18,A03,083745,Cinel; Cameron Alexander,8,0,30,22
1657206193403,MATH 18,B01,083748,Rideout; David Porter,4,0,37,33
1657206193403,MATH 18,B02,083749,Rideout; David Porter,4,0,36,32
1657206193403,MATH 18,B03,083750,Rideout; David Porter,2,0,37,35
1657206193403,MATH 18,B04,083751,Rideout; David Porter,5,0,36,31
1657206193403,MATH 18,B05,093473,Rideout; David Porter,5,0,36,31
1657206193403,MATH 18,B06,093474,Rideout; David Porter,5,0,36,31
1657206199439,MATH 20A,A01,083754,Zheng; Zequn,13,0,40,27
1657206205487,MATH 20B,A01,083756,Briones; Jor-el Thomas Caparas,1,0,36,35
1657206205487,MATH 20B,A02,083757,Briones; Jor-el Thomas Caparas,1,0,36,35
1657206205487,MATH 20B,A03,093475,Briones; Jor-el Thomas Caparas,1,0,36,35
1657206211521,MATH 20C,A01,083760,Briones; Jor-el Thomas Caparas,1,0,35,34
1657206211521,MATH 20C,A02,083761,Briones; Jor-el Thomas Caparas,8,0,35,27
1657206211521,MATH 20C,A03,093476,Briones; Jor-el Thomas Caparas,0,1,36,36
1657206211521,MATH 20C,B01,083762,Bach; Quang Tran,1,0,30,29
1657206217561,MATH 20D,A01,083765,Tran; Brian Kha,4,0,30,26
1657206217561,MATH 20D,A02,083766,Tran; Brian Kha,5,0,30,25
1657206217561,MATH 20D,A03,083767,Tran; Brian Kha,4,0,30,26
1657206223588,MATH 20E,A01,083771,Ganguly; Soumya,7,0,32,25
1657206223588,MATH 20E,A02,083772,Ganguly; Soumya,7,0,32,25
1657206223588,MATH 20E,B01,083773,Ciotti; Benjamin,19,0,35,16
1657206223588,MATH 20E,B02,083774,Ciotti; Benjamin,17,0,35,18
1657206229626,MATH 103A,A01,083777,Greenfeld; Be'Eri,2,0,36,34
1657206229626,MATH 103A,A02,083778,Greenfeld; Be'Eri,5,0,36,31
1657206229626,MATH 103A,A03,093561,Greenfeld; Be'Eri,4,0,36,32
1657206229626,MATH 103A,B01,083779,Greenfeld; Be'Eri,6,0,36,30
1657206229626,MATH 103A,B02,083780,Greenfeld; Be'Eri,3,0,36,33
1657206229626,MATH 103A,B03,093562,Greenfeld; Be'Eri,3,0,36,33
1657206235658,MATH 105,A01,085443,Carter; Anne Toulson,15,0,35,20
1657206235658,MATH 105,A02,093477,Carter; Anne Toulson,20,0,35,15
1657206241718,MATH 109,A01,083213,Ganzberger; Geoffrey Michael,2,0,34,32
1657206241718,MATH 109,A02,083214,Ganzberger; Geoffrey Michael,4,0,34,30
1657206241718,MATH 109,A03,093478,Ganzberger; Geoffrey Michael,1,0,34,33
1657206241718,MATH 109,B01,083215,Ganzberger; Geoffrey Michael,1,0,32,31
1657206241718,MATH 109,B02,083216,Ganzberger; Geoffrey Michael,1,0,32,31
1657206241718,MATH 109,B03,093479,Ganzberger; Geoffrey Michael,7,0,32,25
1657206247761,MATH 142A,A01,083219,Chow; Bennett,6,0,32,26
1657206247761,MATH 142A,A02,083220,Chow; Bennett,10,0,32,22
1657206247761,MATH 142A,A03,093480,Chow; Bennett,7,0,32,25
1657206247761,MATH 142A,B03,093481,Chow; Bennett,8,0,32,24
1657206247761,MATH 142A,B04,093558,Chow; Bennett,11,0,32,21
1657206247761,MATH 142A,B05,093559,Chow; Bennett,6,0,32,26
1657206253793,MATH 193A,A01,083224,Rotar; Vladimir,7,0,34,27
1657206253793,MATH 193A,A02,083225,Rotar; Vladimir,5,0,34,29
1657206253793,MATH 193A,A03,083781,Rotar; Vladimir,1,0,34,33
1657206253793,MATH 193A,A04,083782,Rotar; Vladimir,8,0,34,26
1657206253793,MATH 193A,A05,093482,Rotar; Vladimir,6,0,34,28
1657206259817,MATH 197,001,091859,McAuley; Julian John,9999,0,9999,0
1657206259817,MATH 197,002,095566,Kedlaya; Kiran S.,9997,0,9999,2
1657206259817,MATH 197,003,095567,Xiao; Ming,9999,0,9999,0
1657206259817,MATH 197,004,095571,Perols; Johan Lars,9998,0,9999,1
1657206266907,COGS 9,A01,083615,Shannon; Kyle Michael,7,0,75,68
1657206272939,COGS 11,A01,083617,Boyle; Mary E. T.,22,0,48,26
1657206278976,COGS 13,A01,083071,Bastos; Amalia Pinkusfeld,9,0,71,62
1657206285009,COGS 14A,A01,092681,Semenuks; Arturs,1,1,100,99
1657206291046,COGS 14B,A01,083073,Cheng; Tzu-Han,6,0,63,57
1657206297087,COGS 17,A01,092677,Semenuks; Arturs,4,0,81,77
1657206303120,COGS 100,A01,083619,Allen; Michael Gordon,15,0,70,55
1657206309157,COGS 101A,A01,083621,Davis; Joshua Daniel,9,0,68,59
1657206315201,COGS 101B,A01,091572,Allen; Michael Gordon,9,0,65,56
1657206321231,COGS 101C,A01,083625,Delgado; Tania,17,0,35,18
1657206327273,COGS 107A,A01,083627,Boyle; Mary E. T.,13,0,60,47
1657206333310,COGS 118A,A01,083075,Gupta; Anjum,16,0,76,60
1657206339357,CSE 3,A50,083646,Miranda; Gregory Joseph,24,0,50,26
1657206345419,CSE 8A,A50,083650,Miranda; Gregory Joseph,17,1,56,39
1657206351450,CSE 11,A01,083080,Cao; Yingjun,5,15,40,35
1657206357489,CSE 12,A01,083652,Krause-Levy; Sophia Louisa,24,1,120,96
1657206363525,CSE 15L,A01,083654,Morris; Justin Loren,9,0,50,41
1657206363525,CSE 15L,A02,083655,Morris; Justin Loren,9,0,50,41
1657206369560,CSE 20,A01,083657,Tran; Khoa Dang,38,0,80,42
1657206375597,CSE 21,A01,095574,Bach; Quang Tran,22,0,48,26
1657206381646,CSE 30,A01,083084,Eldon; John,4,0,80,76
1657206381646,CSE 30,B01,095061,Bhaskar; Nishant,7,0,50,43
1657206387671,CSE 100,A01,083659,Cao; Yingjun,4,4,70,66
1657206393712,CSE 134B,A01,083661,Powell; Thomas Allan,20,0,100,80
1657206399769,CSE 140,A01,083663,Gungor; Onat,13,0,85,72
1657206405806,CSE 140L,A01,083088,Eldon; John,17,0,100,83
1657206411853,CSE 175,A01,083665,Kumar; Rakesh,3,0,25,22
1657206417882,CSE 190,A00,092507,Dubnov; Shlomo,7,0,20,13
1657206423920,ECE 45,A01,083139,Congero; Spencer William,5,0,75,70
1657206429948,ECE 65,A50,083695,Saad; Andrew S,12,0,30,18
1657206429948,ECE 65,A51,095125,Saad; Andrew S,25,0,26,1
1657206435998,ECE 109,A01,091882,Touri; Behrouz,19,0,70,51
1657206442034,ECE 180,A00,083140,Abi Samra; Nicholas Camill,1,0,30,29
1657206442034,ECE 180,B00,083141,Abi Samra; Nicholas Camill,0,0,30,30
1657206448070,MATH 10A,A01,083735,Patchell; Gregory David,2,0,30,28
1657206448070,MATH 10A,A02,083736,Patchell; Gregory David,20,0,30,10
1657206448070,MATH 10A,A03,083737,Patchell; Gregory David,16,0,30,14
1657206454121,MATH 10B,A01,083207,Lim; Seonhee,7,0,34,27
1657206454121,MATH 10B,A02,083208,Lim; Seonhee,9,0,35,26
1657206454121,MATH 10B,A03,093472,Lim; Seonhee,5,0,34,29
1657206454121,MATH 10B,B01,083739,Sinha; Shubham,10,0,30,20
1657206460177,MATH 18,A01,083743,Cinel; Cameron Alexander,6,0,30,24
1657206460177,MATH 18,A02,083744,Cinel; Cameron Alexander,15,0,30,15
1657206460177,MATH 18,A03,083745,Cinel; Cameron Alexander,8,0,30,22
1657206460177,MATH 18,B01,083748,Rideout; David Porter,4,0,37,33
1657206460177,MATH 18,B02,083749,Rideout; David Porter,4,0,36,32
1657206460177,MATH 18,B03,083750,Rideout; David Porter,2,0,37,35
1657206460177,MATH 18,B04,083751,Rideout; David Porter,5,0,36,31
1657206460177,MATH 18,B05,093473,Rideout; David Porter,5,0,36,31
1657206460177,MATH 18,B06,093474,Rideout; David Porter,5,0,36,31
1657206466235,MATH 20A,A01,083754,Zheng; Zequn,13,0,40,27
1657206472293,MATH 20B,A01,083756,Briones; Jor-el Thomas Caparas,1,0,36,35
1657206472293,MATH 20B,A02,083757,Briones; Jor-el Thomas Caparas,1,0,36,35
1657206472293,MATH 20B,A03,093475,Briones; Jor-el Thomas Caparas,1,0,36,35
1657206478330,MATH 20C,A01,083760,Briones; Jor-el Thomas Caparas,1,0,35,34
1657206478330,MATH 20C,A02,083761,Briones; Jor-el Thomas Caparas,8,0,35,27
1657206478330,MATH 20C,A03,093476,Briones; Jor-el Thomas Caparas,0,1,36,36
1657206478330,MATH 20C,B01,083762,Bach; Quang Tran,1,0,30,29
1657206484368,MATH 20D,A01,083765,Tran; Brian Kha,4,0,30,26
1657206484368,MATH 20D,A02,083766,Tran; Brian Kha,5,0,30,25
1657206484368,MATH 20D,A03,083767,Tran; Brian Kha,4,0,30,26
1657206490417,MATH 20E,A01,083771,Ganguly; Soumya,7,0,32,25
1657206490417,MATH 20E,A02,083772,Ganguly; Soumya,7,0,32,25
1657206490417,MATH 20E,B01,083773,Ciotti; Benjamin,19,0,35,16
1657206490417,MATH 20E,B02,083774,Ciotti; Benjamin,17,0,35,18
1657206496452,MATH 103A,A01,083777,Greenfeld; Be'Eri,2,0,36,34
1657206496452,MATH 103A,A02,083778,Greenfeld; Be'Eri,5,0,36,31
1657206496452,MATH 103A,A03,093561,Greenfeld; Be'Eri,4,0,36,32
1657206496452,MATH 103A,B01,083779,Greenfeld; Be'Eri,6,0,36,30
1657206496452,MATH 103A,B02,083780,Greenfeld; Be'Eri,3,0,36,33
1657206496452,MATH 103A,B03,093562,Greenfeld; Be'Eri,3,0,36,33
1657206502493,MATH 105,A01,085443,Carter; Anne Toulson,15,0,35,20
1657206502493,MATH 105,A02,093477,Carter; Anne Toulson,20,0,35,15
1657206508528,MATH 109,A01,083213,Ganzberger; Geoffrey Michael,2,0,34,32
1657206508528,MATH 109,A02,083214,Ganzberger; Geoffrey Michael,4,0,34,30
1657206508528,MATH 109,A03,093478,Ganzberger; Geoffrey Michael,1,0,34,33
1657206508528,MATH 109,B01,083215,Ganzberger; Geoffrey Michael,1,0,32,31
1657206508528,MATH 109,B02,083216,Ganzberger; Geoffrey Michael,1,0,32,31
1657206508528,MATH 109,B03,093479,Ganzberger; Geoffrey Michael,7,0,32,25
1657206514561,MATH 142A,A01,083219,Chow; Bennett,6,0,32,26
1657206514561,MATH 142A,A02,083220,Chow; Bennett,10,0,32,22
1657206514561,MATH 142A,A03,093480,Chow; Bennett,7,0,32,25
1657206514561,MATH 142A,B03,093481,Chow; Bennett,8,0,32,24
1657206514561,MATH 142A,B04,093558,Chow; Bennett,11,0,32,21
1657206514561,MATH 142A,B05,093559,Chow; Bennett,6,0,32,26
1657206520596,MATH 193A,A01,083224,Rotar; Vladimir,7,0,34,27
1657206520596,MATH 193A,A02,083225,Rotar; Vladimir,5,0,34,29
1657206520596,MATH 193A,A03,083781,Rotar; Vladimir,1,0,34,33
1657206520596,MATH 193A,A04,083782,Rotar; Vladimir,8,0,34,26
1657206520596,MATH 193A,A05,093482,Rotar; Vladimir,6,0,34,28
1657206526642,MATH 197,001,091859,McAuley; Julian John,9999,0,9999,0
1657206526642,MATH 197,002,095566,Kedlaya; Kiran S.,9997,0,9999,2
1657206526642,MATH 197,003,095567,Xiao; Ming,9999,0,9999,0
1657206526642,MATH 197,004,095571,Perols; Johan Lars,9998,0,9999,1
1657206533756,COGS 9,A01,083615,Shannon; Kyle Michael,7,0,75,68
1657206539803,COGS 11,A01,083617,Boyle; Mary E. T.,22,0,48,26
1657206545826,COGS 13,A01,083071,Bastos; Amalia Pinkusfeld,9,0,71,62
1657206551876,COGS 14A,A01,092681,Semenuks; Arturs,1,1,100,99
1657206557912,COGS 14B,A01,083073,Cheng; Tzu-Han,6,0,63,57
1657206563941,COGS 17,A01,092677,Semenuks; Arturs,4,0,81,77
1657206569965,COGS 100,A01,083619,Allen; Michael Gordon,15,0,70,55
1657206576011,COGS 101A,A01,083621,Davis; Joshua Daniel,9,0,68,59
1657206582048,COGS 101B,A01,091572,Allen; Michael Gordon,9,0,65,56
1657206588086,COGS 101C,A01,083625,Delgado; Tania,17,0,35,18
1657206594117,COGS 107A,A01,083627,Boyle; Mary E. T.,13,0,60,47
1657206600166,COGS 118A,A01,083075,Gupta; Anjum,16,0,76,60
1657206606204,CSE 3,A50,083646,Miranda; Gregory Joseph,24,0,50,26
1657206612249,CSE 8A,A50,083650,Miranda; Gregory Joseph,17,1,56,39
1657206618283,CSE 11,A01,083080,Cao; Yingjun,5,15,40,35
1657206624330,CSE 12,A01,083652,Krause-Levy; Sophia Louisa,24,1,120,96
1657206630364,CSE 15L,A01,083654,Morris; Justin Loren,9,0,50,41
1657206630364,CSE 15L,A02,083655,Morris; Justin Loren,9,0,50,41
1657206636395,CSE 20,A01,083657,Tran; Khoa Dang,38,0,80,42
1657206642417,CSE 21,A01,095574,Bach; Quang Tran,22,0,48,26
1657206648472,CSE 30,A01,083084,Eldon; John,4,0,80,76
1657206648472,CSE 30,B01,095061,Bhaskar; Nishant,7,0,50,43
1657206654510,CSE 100,A01,083659,Cao; Yingjun,4,4,70,66
1657206660536,CSE 134B,A01,083661,Powell; Thomas Allan,20,0,100,80
1657206666591,CSE 140,A01,083663,Gungor; Onat,13,0,85,72
1657206672634,CSE 140L,A01,083088,Eldon; John,17,0,100,83
1657206678727,CSE 175,A01,083665,Kumar; Rakesh,3,0,25,22
1657206684761,CSE 190,A00,092507,Dubnov; Shlomo,7,0,20,13
1657206690804,ECE 45,A01,083139,Congero; Spencer William,5,0,75,70
1657206696859,ECE 65,A50,083695,Saad; Andrew S,12,0,30,18
1657206696859,ECE 65,A51,095125,Saad; Andrew S,25,0,26,1
1657206702897,ECE 109,A01,091882,Touri; Behrouz,19,0,70,51
1657206708933,ECE 180,A00,083140,Abi Samra; Nicholas Camill,1,0,30,29
1657206708933,ECE 180,B00,083141,Abi Samra; Nicholas Camill,0,0,30,30
1657206714962,MATH 10A,A01,083735,Patchell; Gregory David,2,0,30,28
1657206714962,MATH 10A,A02,083736,Patchell; Gregory David,20,0,30,10
1657206714962,MATH 10A,A03,083737,Patchell; Gregory David,16,0,30,14
1657206720993,MATH 10B,A01,083207,Lim; Seonhee,7,0,34,27
1657206720993,MATH 10B,A02,083208,Lim; Seonhee,9,0,35,26
1657206720993,MATH 10B,A03,093472,Lim; Seonhee,5,0,34,29
1657206720993,MATH 10B,B01,083739,Sinha; Shubham,10,0,30,20
1657206727036,MATH 18,A01,083743,Cinel; Cameron Alexander,6,0,30,24
1657206727036,MATH 18,A02,083744,Cinel; Cameron Alexander,15,0,30,15
1657206727036,MATH 18,A03,083745,Cinel; Cameron Alexander,8,0,30,22
1657206727036,MATH 18,B01,083748,Rideout; David Porter,4,0,37,33
1657206727036,MATH 18,B02,083749,Rideout; David Porter,4,0,36,32
1657206727036,MATH 18,B03,083750,Rideout; David Porter,2,0,37,35
1657206727036,MATH 18,B04,083751,Rideout; David Porter,5,0,36,31
1657206727036,MATH 18,B05,093473,Rideout; David Porter,5,0,36,31
1657206727036,MATH 18,B06,093474,Rideout; David Porter,5,0,36,31
1657206733079,MATH 20A,A01,083754,Zheng; Zequn,13,0,40,27
1657206739125,MATH 20B,A01,083756,Briones; Jor-el Thomas Caparas,1,0,36,35
1657206739125,MATH 20B,A02,083757,Briones; Jor-el Thomas Caparas,1,0,36,35
1657206739125,MATH 20B,A03,093475,Briones; Jor-el Thomas Caparas,1,0,36,35
1657206745162,MATH 20C,A01,083760,Briones; Jor-el Thomas Caparas,1,0,35,34
1657206745162,MATH 20C,A02,083761,Briones; Jor-el Thomas Caparas,8,0,35,27
1657206745162,MATH 20C,A03,093476,Briones; Jor-el Thomas Caparas,0,1,36,36
1657206745162,MATH 20C,B01,083762,Bach; Quang Tran,1,0,30,29
1657206751203,MATH 20D,A01,083765,Tran; Brian Kha,4,0,30,26
1657206751203,MATH 20D,A02,083766,Tran; Brian Kha,5,0,30,25
1657206751203,MATH 20D,A03,083767,Tran; Brian Kha,4,0,30,26
1657206757245,MATH 20E,A01,083771,Ganguly; Soumya,7,0,32,25
1657206757245,MATH 20E,A02,083772,Ganguly; Soumya,7,0,32,25
1657206757245,MATH 20E,B01,083773,Ciotti; Benjamin,19,0,35,16
1657206757245,MATH 20E,B02,083774,Ciotti; Benjamin,17,0,35,18
1657206763295,MATH 103A,A01,083777,Greenfeld; Be'Eri,2,0,36,34
1657206763295,MATH 103A,A02,083778,Greenfeld; Be'Eri,5,0,36,31
1657206763295,MATH 103A,A03,093561,Greenfeld; Be'Eri,4,0,36,32
1657206763295,MATH 103A,B01,083779,Greenfeld; Be'Eri,6,0,36,30
1657206763295,MATH 103A,B02,083780,Greenfeld; Be'Eri,3,0,36,33
1657206763295,MATH 103A,B03,093562,Greenfeld; Be'Eri,3,0,36,33
1657206769326,MATH 105,A01,085443,Carter; Anne Toulson,15,0,35,20
1657206769326,MATH 105,A02,093477,Carter; Anne Toulson,20,0,35,15
1657206775350,MATH 109,A01,083213,Ganzberger; Geoffrey Michael,2,0,34,32
1657206775350,MATH 109,A02,083214,Ganzberger; Geoffrey Michael,4,0,34,30
1657206775350,MATH 109,A03,093478,Ganzberger; Geoffrey Michael,1,0,34,33
1657206775350,MATH 109,B01,083215,Ganzberger; Geoffrey Michael,1,0,32,31
1657206775350,MATH 109,B02,083216,Ganzberger; Geoffrey Michael,1,0,32,31
1657206775350,MATH 109,B03,093479,Ganzberger; Geoffrey Michael,7,0,32,25
1657206781383,MATH 142A,A01,083219,Chow; Bennett,6,0,32,26
1657206781383,MATH 142A,A02,083220,Chow; Bennett,10,0,32,22
1657206781383,MATH 142A,A03,093480,Chow; Bennett,7,0,32,25
1657206781383,MATH 142A,B03,093481,Chow; Bennett,8,0,32,24
1657206781383,MATH 142A,B04,093558,Chow; Bennett,11,0,32,21
1657206781383,MATH 142A,B05,093559,Chow; Bennett,6,0,32,26
1657206787416,MATH 193A,A01,083224,Rotar; Vladimir,7,0,34,27
1657206787416,MATH 193A,A02,083225,Rotar; Vladimir,5,0,34,29
1657206787416,MATH 193A,A03,083781,Rotar; Vladimir,1,0,34,33
1657206787416,MATH 193A,A04,083782,Rotar; Vladimir,8,0,34,26
1657206787416,MATH 193A,A05,093482,Rotar; Vladimir,6,0,34,28
1657206793455,MATH 197,001,091859,McAuley; Julian John,9999,0,9999,0
1657206793455,MATH 197,002,095566,Kedlaya; Kiran S.,9997,0,9999,2
1657206793455,MATH 197,003,095567,Xiao; Ming,9999,0,9999,0
1657206793455,MATH 197,004,095571,Perols; Johan Lars,9998,0,9999,1
1657206800525,COGS 9,A01,083615,Shannon; Kyle Michael,7,0,75,68
1657206806560,COGS 11,A01,083617,Boyle; Mary E. T.,22,0,48,26
1657206812584,COGS 13,A01,083071,Bastos; Amalia Pinkusfeld,9,0,71,62
1657206818637,COGS 14A,A01,092681,Semenuks; Arturs,1,1,100,99
1657206824671,COGS 14B,A01,083073,Cheng; Tzu-Han,6,0,63,57
1657206830717,COGS 17,A01,092677,Semenuks; Arturs,4,0,81,77
1657206836763,COGS 100,A01,083619,Allen; Michael Gordon,15,0,70,55
1657206842816,COGS 101A,A01,083621,Davis; Joshua Daniel,9,0,68,59
1657206848861,COGS 101B,A01,091572,Allen; Michael Gordon,9,0,65,56
1657206854888,COGS 101C,A01,083625,Delgado; Tania,17,0,35,18
1657206860946,COGS 107A,A01,083627,Boyle; Mary E. T.,13,0,60,47
1657206866991,COGS 118A,A01,083075,Gupta; Anjum,16,0,76,60
1657206873040,CSE 3,A50,083646,Miranda; Gregory Joseph,24,0,50,26
1657206879076,CSE 8A,A50,083650,Miranda; Gregory Joseph,17,1,56,39
1657206885128,CSE 11,A01,083080,Cao; Yingjun,5,15,40,35
1657206891170,CSE 12,A01,083652,Krause-Levy; Sophia Louisa,24,1,120,96
1657206897210,CSE 15L,A01,083654,Morris; Justin Loren,9,0,50,41
1657206897210,CSE 15L,A02,083655,Morris; Justin Loren,9,0,50,41
1657206903243,CSE 20,A01,083657,Tran; Khoa Dang,38,0,80,42
1657206909279,CSE 21,A01,095574,Bach; Quang Tran,22,0,48,26
1657206915312,CSE 30,A01,083084,Eldon; John,4,0,80,76
1657206915312,CSE 30,B01,095061,Bhaskar; Nishant,7,0,50,43
1657206921351,CSE 100,A01,083659,Cao; Yingjun,4,4,70,66
1657206927411,CSE 134B,A01,083661,Powell; Thomas Allan,20,0,100,80
1657206933435,CSE 140,A01,083663,Gungor; Onat,13,0,85,72
1657206939484,CSE 140L,A01,083088,Eldon; John,17,0,100,83
1657206945509,CSE 175,A01,083665,Kumar; Rakesh,3,0,25,22
1657206951541,CSE 190,A00,092507,Dubnov; Shlomo,7,0,20,13
1657206957569,ECE 45,A01,083139,Congero; Spencer William,5,0,75,70
1657206963593,ECE 65,A50,083695,Saad; Andrew S,12,0,30,18
1657206963593,ECE 65,A51,095125,Saad; Andrew S,25,0,26,1
1657206969640,ECE 109,A01,091882,Touri; Behrouz,19,0,70,51
1657206975694,ECE 180,A00,083140,Abi Samra; Nicholas Camill,1,0,30,29
1657206975694,ECE 180,B00,083141,Abi Samra; Nicholas Camill,0,0,30,30
1657206981747,MATH 10A,A01,083735,Patchell; Gregory David,2,0,30,28
1657206981747,MATH 10A,A02,083736,Patchell; Gregory David,20,0,30,10
1657206981747,MATH 10A,A03,083737,Patchell; Gregory David,16,0,30,14
1657206987787,MATH 10B,A01,083207,Lim; Seonhee,7,0,34,27
1657206987787,MATH 10B,A02,083208,Lim; Seonhee,9,0,35,26
1657206987787,MATH 10B,A03,093472,Lim; Seonhee,5,0,34,29
1657206987787,MATH 10B,B01,083739,Sinha; Shubham,10,0,30,20
1657206993820,MATH 18,A01,083743,Cinel; Cameron Alexander,6,0,30,24
1657206993820,MATH 18,A02,083744,Cinel; Cameron Alexander,15,0,30,15
1657206993820,MATH 18,A03,083745,Cinel; Cameron Alexander,8,0,30,22
1657206993820,MATH 18,B01,083748,Rideout; David Porter,4,0,37,33
1657206993820,MATH 18,B02,083749,Rideout; David Porter,4,0,36,32
1657206993820,MATH 18,B03,083750,Rideout; David Porter,2,0,37,35
1657206993820,MATH 18,B04,083751,Rideout; David Porter,5,0,36,31
1657206993820,MATH 18,B05,093473,Rideout; David Porter,5,0,36,31
1657206993820,MATH 18,B06,093474,Rideout; David Porter,5,0,36,31
1657206999869,MATH 20A,A01,083754,Zheng; Zequn,13,0,40,27
1657207005901,MATH 20B,A01,083756,Briones; Jor-el Thomas Caparas,1,0,36,35
1657207005901,MATH 20B,A02,083757,Briones; Jor-el Thomas Caparas,1,0,36,35
1657207005901,MATH 20B,A03,093475,Briones; Jor-el Thomas Caparas,1,0,36,35
1657207011926,MATH 20C,A01,083760,Briones; Jor-el Thomas Caparas,1,0,35,34
1657207011926,MATH 20C,A02,083761,Briones; Jor-el Thomas Caparas,8,0,35,27
1657207011926,MATH 20C,A03,093476,Briones; Jor-el Thomas Caparas,0,1,36,36
1657207011926,MATH 20C,B01,083762,Bach; Quang Tran,1,0,30,29
1657207017965,MATH 20D,A01,083765,Tran; Brian Kha,4,0,30,26
1657207017965,MATH 20D,A02,083766,Tran; Brian Kha,5,0,30,25
1657207017965,MATH 20D,A03,083767,Tran; Brian Kha,4,0,30,26
1657207024000,MATH 20E,A01,083771,Ganguly; Soumya,7,0,32,25
1657207024000,MATH 20E,A02,083772,Ganguly; Soumya,7,0,32,25
1657207024000,MATH 20E,B01,083773,Ciotti; Benjamin,19,0,35,16
1657207024000,MATH 20E,B02,083774,Ciotti; Benjamin,17,0,35,18
1657207030043,MATH 103A,A01,083777,Greenfeld; Be'Eri,2,0,36,34
1657207030043,MATH 103A,A02,083778,Greenfeld; Be'Eri,5,0,36,31
1657207030043,MATH 103A,A03,093561,Greenfeld; Be'Eri,4,0,36,32
1657207030043,MATH 103A,B01,083779,Greenfeld; Be'Eri,6,0,36,30
1657207030043,MATH 103A,B02,083780,Greenfeld; Be'Eri,3,0,36,33
1657207030043,MATH 103A,B03,093562,Greenfeld; Be'Eri,3,0,36,33
1657207036079,MATH 105,A01,085443,Carter; Anne Toulson,15,0,35,20
1657207036079,MATH 105,A02,093477,Carter; Anne Toulson,20,0,35,15
1657207042120,MATH 109,A01,083213,Ganzberger; Geoffrey Michael,2,0,34,32
1657207042120,MATH 109,A02,083214,Ganzberger; Geoffrey Michael,4,0,34,30
1657207042120,MATH 109,A03,093478,Ganzberger; Geoffrey Michael,1,0,34,33
1657207042120,MATH 109,B01,083215,Ganzberger; Geoffrey Michael,1,0,32,31
1657207042120,MATH 109,B02,083216,Ganzberger; Geoffrey Michael,1,0,32,31
1657207042120,MATH 109,B03,093479,Ganzberger; Geoffrey Michael,7,0,32,25
1657207048175,MATH 142A,A01,083219,Chow; Bennett,6,0,32,26
1657207048175,MATH 142A,A02,083220,Chow; Bennett,10,0,32,22
1657207048175,MATH 142A,A03,093480,Chow; Bennett,7,0,32,25
1657207048175,MATH 142A,B03,093481,Chow; Bennett,8,0,32,24
1657207048175,MATH 142A,B04,093558,Chow; Bennett,11,0,32,21
1657207048175,MATH 142A,B05,093559,Chow; Bennett,6,0,32,26
1657207054219,MATH 193A,A01,083224,Rotar; Vladimir,7,0,34,27
1657207054219,MATH 193A,A02,083225,Rotar; Vladimir,5,0,34,29
1657207054219,MATH 193A,A03,083781,Rotar; Vladimir,1,0,34,33
1657207054219,MATH 193A,A04,083782,Rotar; Vladimir,8,0,34,26
1657207054219,MATH 193A,A05,093482,Rotar; Vladimir,6,0,34,28
1657207060262,MATH 197,001,091859,McAuley; Julian John,9999,0,9999,0
1657207060262,MATH 197,002,095566,Kedlaya; Kiran S.,9997,0,9999,2
1657207060262,MATH 197,003,095567,Xiao; Ming,9999,0,9999,0
1657207060262,MATH 197,004,095571,Perols; Johan Lars,9998,0,9999,1
1657207067336,COGS 9,A01,083615,Shannon; Kyle Michael,7,0,75,68
1657207073382,COGS 11,A01,083617,Boyle; Mary E. T.,22,0,48,26
1657207079428,COGS 13,A01,083071,Bastos; Amalia Pinkusfeld,9,0,71,62
1657207085461,COGS 14A,A01,092681,Semenuks; Arturs,1,1,100,99
1657207091505,COGS 14B,A01,083073,Cheng; Tzu-Han,6,0,63,57
1657207097531,COGS 17,A01,092677,Semenuks; Arturs,4,0,81,77
1657207103559,COGS 100,A01,083619,Allen; Michael Gordon,15,0,70,55
1657207109602,COGS 101A,A01,083621,Davis; Joshua Daniel,9,0,68,59
1657207115628,COGS 101B,A01,091572,Allen; Michael Gordon,9,0,65,56
1657207121658,COGS 101C,A01,083625,Delgado; Tania,17,0,35,18
1657207127691,COGS 107A,A01,083627,Boyle; Mary E. T.,13,0,60,47
1657207133727,COGS 118A,A01,083075,Gupta; Anjum,16,0,76,60
1657207139765,CSE 3,A50,083646,Miranda; Gregory Joseph,24,0,50,26
1657207145788,CSE 8A,A50,083650,Miranda; Gregory Joseph,17,1,56,39
1657207151832,CSE 11,A01,083080,Cao; Yingjun,5,15,40,35
1657207157869,CSE 12,A01,083652,Krause-Levy; Sophia Louisa,24,1,120,96
1657207163905,CSE 15L,A01,083654,Morris; Justin Loren,9,0,50,41
1657207163905,CSE 15L,A02,083655,Morris; Justin Loren,9,0,50,41
1657207169943,CSE 20,A01,083657,Tran; Khoa Dang,38,0,80,42
1657207175970,CSE 21,A01,095574,Bach; Quang Tran,22,0,48,26
1657207182020,CSE 30,A01,083084,Eldon; John,4,0,80,76
1657207182020,CSE 30,B01,095061,Bhaskar; Nishant,7,0,50,43
1657207188047,CSE 100,A01,083659,Cao; Yingjun,4,4,70,66
1657207194088,CSE 134B,A01,083661,Powell; Thomas Allan,20,0,100,80
1657207200136,CSE 140,A01,083663,Gungor; Onat,13,0,85,72
1657207206176,CSE 140L,A01,083088,Eldon; John,17,0,100,83
1657207212227,CSE 175,A01,083665,Kumar; Rakesh,3,0,25,22
1657207218256,CSE 190,A00,092507,Dubnov; Shlomo,7,0,20,13
1657207224282,ECE 45,A01,083139,Congero; Spencer William,5,0,75,70
1657207230334,ECE 65,A50,083695,Saad; Andrew S,12,0,30,18
1657207230334,ECE 65,A51,095125,Saad; Andrew S,25,0,26,1
1657207236374,ECE 109,A01,091882,Touri; Behrouz,19,0,70,51
1657207242410,ECE 180,A00,083140,Abi Samra; Nicholas Camill,1,0,30,29
1657207242410,ECE 180,B00,083141,Abi Samra; Nicholas Camill,0,0,30,30
1657207248450,MATH 10A,A01,083735,Patchell; Gregory David,2,0,30,28
1657207248450,MATH 10A,A02,083736,Patchell; Gregory David,20,0,30,10
1657207248450,MATH 10A,A03,083737,Patchell; Gregory David,16,0,30,14
1657207254497,MATH 10B,A01,083207,Lim; Seonhee,7,0,34,27
1657207254497,MATH 10B,A02,083208,Lim; Seonhee,9,0,35,26
1657207254497,MATH 10B,A03,093472,Lim; Seonhee,5,0,34,29
1657207254497,MATH 10B,B01,083739,Sinha; Shubham,10,0,30,20
1657207260540,MATH 18,A01,083743,Cinel; Cameron Alexander,6,0,30,24
1657207260540,MATH 18,A02,083744,Cinel; Cameron Alexander,15,0,30,15
1657207260540,MATH 18,A03,083745,Cinel; Cameron Alexander,8,0,30,22
1657207260540,MATH 18,B01,083748,Rideout; David Porter,4,0,37,33
1657207260540,MATH 18,B02,083749,Rideout; David Porter,4,0,36,32
1657207260540,MATH 18,B03,083750,Rideout; David Porter,2,0,37,35
1657207260540,MATH 18,B04,083751,Rideout; David Porter,5,0,36,31
1657207260540,MATH 18,B05,093473,Rideout; David Porter,5,0,36,31
1657207260540,MATH 18,B06,093474,Rideout; David Porter,5,0,36,31
1657207266580,MATH 20A,A01,083754,Zheng; Zequn,13,0,40,27
1657207272619,MATH 20B,A01,083756,Briones; Jor-el Thomas Caparas,1,0,36,35
1657207272619,MATH 20B,A02,083757,Briones; Jor-el Thomas Caparas,1,0,36,35
1657207272619,MATH 20B,A03,093475,Briones; Jor-el Thomas Caparas,1,0,36,35
1657207278745,MATH 20C,A01,083760,Briones; Jor-el Thomas Caparas,1,0,35,34
1657207278745,MATH 20C,A02,083761,Briones; Jor-el Thomas Caparas,8,0,35,27
1657207278745,MATH 20C,A03,093476,Briones; Jor-el Thomas Caparas,0,1,36,36
1657207278745,MATH 20C,B01,083762,Bach; Quang Tran,1,0,30,29
1657207284805,MATH 20D,A01,083765,Tran; Brian Kha,4,0,30,26
1657207284805,MATH 20D,A02,083766,Tran; Brian Kha,5,0,30,25
1657207284805,MATH 20D,A03,083767,Tran; Brian Kha,4,0,30,26
1657207290841,MATH 20E,A01,083771,Ganguly; Soumya,7,0,32,25
1657207290841,MATH 20E,A02,083772,Ganguly; Soumya,7,0,32,25
1657207290841,MATH 20E,B01,083773,Ciotti; Benjamin,19,0,35,16
1657207290841,MATH 20E,B02,083774,Ciotti; Benjamin,17,0,35,18
1657207296901,MATH 103A,A01,083777,Greenfeld; Be'Eri,2,0,36,34
1657207296901,MATH 103A,A02,083778,Greenfeld; Be'Eri,5,0,36,31
1657207296901,MATH 103A,A03,093561,Greenfeld; Be'Eri,4,0,36,32
1657207296901,MATH 103A,B01,083779,Greenfeld; Be'Eri,6,0,36,30
1657207296901,MATH 103A,B02,083780,Greenfeld; Be'Eri,3,0,36,33
1657207296901,MATH 103A,B03,093562,Greenfeld; Be'Eri,3,0,36,33
1657207302954,MATH 105,A01,085443,Carter; Anne Toulson,15,0,35,20
1657207302954,MATH 105,A02,093477,Carter; Anne Toulson,20,0,35,15
1657207308990,MATH 109,A01,083213,Ganzberger; Geoffrey Michael,2,0,34,32
1657207308990,MATH 109,A02,083214,Ganzberger; Geoffrey Michael,4,0,34,30
1657207308990,MATH 109,A03,093478,Ganzberger; Geoffrey Michael,1,0,34,33
1657207308990,MATH 109,B01,083215,Ganzberger; Geoffrey Michael,1,0,32,31
1657207308990,MATH 109,B02,083216,Ganzberger; Geoffrey Michael,1,0,32,31
1657207308990,MATH 109,B03,093479,Ganzberger; Geoffrey Michael,7,0,32,25
1657207315018,MATH 142A,A01,083219,Chow; Bennett,6,0,32,26
1657207315018,MATH 142A,A02,083220,Chow; Bennett,10,0,32,22
1657207315018,MATH 142A,A03,093480,Chow; Bennett,7,0,32,25
1657207315018,MATH 142A,B03,093481,Chow; Bennett,8,0,32,24
1657207315018,MATH 142A,B04,093558,Chow; Bennett,11,0,32,21
1657207315018,MATH 142A,B05,093559,Chow; Bennett,6,0,32,26
1657207321044,MATH 193A,A01,083224,Rotar; Vladimir,7,0,34,27
1657207321044,MATH 193A,A02,083225,Rotar; Vladimir,5,0,34,29
1657207321044,MATH 193A,A03,083781,Rotar; Vladimir,1,0,34,33
1657207321044,MATH 193A,A04,083782,Rotar; Vladimir,8,0,34,26
1657207321044,MATH 193A,A05,093482,Rotar; Vladimir,6,0,34,28
1657207327072,MATH 197,001,091859,McAuley; Julian John,9999,0,9999,0
1657207327072,MATH 197,002,095566,Kedlaya; Kiran S.,9997,0,9999,2
1657207327072,MATH 197,003,095567,Xiao; Ming,9999,0,9999,0
1657207327072,MATH 197,004,095571,Perols; Johan Lars,9998,0,9999,1
1657207334168,COGS 9,A01,083615,Shannon; Kyle Michael,7,0,75,68
1657207340198,COGS 11,A01,083617,Boyle; Mary E. T.,22,0,48,26
1657207346233,COGS 13,A01,083071,Bastos; Amalia Pinkusfeld,9,0,71,62
1657207352257,COGS 14A,A01,092681,Semenuks; Arturs,1,1,100,99
1657207358289,COGS 14B,A01,083073,Cheng; Tzu-Han,6,0,63,57
1657207364317,COGS 17,A01,092677,Semenuks; Arturs,4,0,81,77
1657207370342,COGS 100,A01,083619,Allen; Michael Gordon,15,0,70,55
1657207376379,COGS 101A,A01,083621,Davis; Joshua Daniel,9,0,68,59
1657207382405,COGS 101B,A01,091572,Allen; Michael Gordon,9,0,65,56
1657207388449,COGS 101C,A01,083625,Delgado; Tania,17,0,35,18
1657207394488,COGS 107A,A01,083627,Boyle; Mary E. T.,13,0,60,47
1657207400530,COGS 118A,A01,083075,Gupta; Anjum,16,0,76,60
1657207406565,CSE 3,A50,083646,Miranda; Gregory Joseph,24,0,50,26
1657207412589,CSE 8A,A50,083650,Miranda; Gregory Joseph,17,1,56,39
1657207418613,CSE 11,A01,083080,Cao; Yingjun,5,15,40,35
1657207424638,CSE 12,A01,083652,Krause-Levy; Sophia Louisa,24,1,120,96
1657207430675,CSE 15L,A01,083654,Morris; Justin Loren,9,0,50,41
1657207430675,CSE 15L,A02,083655,Morris; Justin Loren,9,0,50,41
1657207436699,CSE 20,A01,083657,Tran; Khoa Dang,38,0,80,42
1657207442732,CSE 21,A01,095574,Bach; Quang Tran,22,0,48,26
1657207448776,CSE 30,A01,083084,Eldon; John,4,0,80,76
1657207448776,CSE 30,B01,095061,Bhaskar; Nishant,7,0,50,43
1657207454816,CSE 100,A01,083659,Cao; Yingjun,4,4,70,66
1657207460841,CSE 134B,A01,083661,Powell; Thomas Allan,20,0,100,80
1657207466887,CSE 140,A01,083663,Gungor; Onat,13,0,85,72
1657207472913,CSE 140L,A01,083088,Eldon; John,17,0,100,83
1657207478945,CSE 175,A01,083665,Kumar; Rakesh,3,0,25,22
1657207484968,CSE 190,A00,092507,Dubnov; Shlomo,7,0,20,13
1657207490992,ECE 45,A01,083139,Congero; Spencer William,5,0,75,70
1657207497023,ECE 65,A50,083695,Saad; Andrew S,12,0,30,18
1657207497023,ECE 65,A51,095125,Saad; Andrew S,25,0,26,1
1657207503053,ECE 109,A01,091882,Touri; Behrouz,19,0,70,51
1657207509079,ECE 180,A00,083140,Abi Samra; Nicholas Camill,1,0,30,29
1657207509079,ECE 180,B00,083141,Abi Samra; Nicholas Camill,0,0,30,30
1657207515115,MATH 10A,A01,083735,Patchell; Gregory David,2,0,30,28
1657207515115,MATH 10A,A02,083736,Patchell; Gregory David,20,0,30,10
1657207515115,MATH 10A,A03,083737,Patchell; Gregory David,16,0,30,14
1657207521163,MATH 10B,A01,083207,Lim; Seonhee,7,0,34,27
1657207521163,MATH 10B,A02,083208,Lim; Seonhee,9,0,35,26
1657207521163,MATH 10B,A03,093472,Lim; Seonhee,5,0,34,29
1657207521163,MATH 10B,B01,083739,Sinha; Shubham,10,0,30,20
1657207527191,MATH 18,A01,083743,Cinel; Cameron Alexander,6,0,30,24
1657207527191,MATH 18,A02,083744,Cinel; Cameron Alexander,15,0,30,15
1657207527191,MATH 18,A03,083745,Cinel; Cameron Alexander,8,0,30,22
1657207527191,MATH 18,B01,083748,Rideout; David Porter,4,0,37,33
1657207527191,MATH 18,B02,083749,Rideout; David Porter,4,0,36,32
1657207527191,MATH 18,B03,083750,Rideout; David Porter,2,0,37,35
1657207527191,MATH 18,B04,083751,Rideout; David Porter,5,0,36,31
1657207527191,MATH 18,B05,093473,Rideout; David Porter,5,0,36,31
1657207527191,MATH 18,B06,093474,Rideout; David Porter,5,0,36,31
1657207533222,MATH 20A,A01,083754,Zheng; Zequn,13,0,40,27
1657207539274,MATH 20B,A01,083756,Briones; Jor-el Thomas Caparas,2,0,36,34
1657207539274,MATH 20B,A02,083757,Briones; Jor-el Thomas Caparas,1,0,36,35
1657207539274,MATH 20B,A03,093475,Briones; Jor-el Thomas Caparas,1,0,36,35
1657207545315,MATH 20C,A01,083760,Briones; Jor-el Thomas Caparas,1,0,35,34
1657207545315,MATH 20C,A02,083761,Briones; Jor-el Thomas Caparas,8,0,35,27
1657207545315,MATH 20C,A03,093476,Briones; Jor-el Thomas Caparas,0,1,36,36
1657207545315,MATH 20C,B01,083762,Bach; Quang Tran,1,0,30,29
1657207551347,MATH 20D,A01,083765,Tran; Brian Kha,4,0,30,26
1657207551347,MATH 20D,A02,083766,Tran; Brian Kha,5,0,30,25
1657207551347,MATH 20D,A03,083767,Tran; Brian Kha,4,0,30,26
1657207557373,MATH 20E,A01,083771,Ganguly; Soumya,7,0,32,25
1657207557373,MATH 20E,A02,083772,Ganguly; Soumya,7,0,32,25
1657207557373,MATH 20E,B01,083773,Ciotti; Benjamin,19,0,35,16
1657207557373,MATH 20E,B02,083774,Ciotti; Benjamin,17,0,35,18
1657207563415,MATH 103A,A01,083777,Greenfeld; Be'Eri,2,0,36,34
1657207563415,MATH 103A,A02,083778,Greenfeld; Be'Eri,5,0,36,31
1657207563415,MATH 103A,A03,093561,Greenfeld; Be'Eri,4,0,36,32
1657207563415,MATH 103A,B01,083779,Greenfeld; Be'Eri,6,0,36,30
1657207563415,MATH 103A,B02,083780,Greenfeld; Be'Eri,3,0,36,33
1657207563415,MATH 103A,B03,093562,Greenfeld; Be'Eri,3,0,36,33
1657207569457,MATH 105,A01,085443,Carter; Anne Toulson,15,0,35,20
1657207569457,MATH 105,A02,093477,Carter; Anne Toulson,20,0,35,15
1657207575502,MATH 109,A01,083213,Ganzberger; Geoffrey Michael,2,0,34,32
1657207575502,MATH 109,A02,083214,Ganzberger; Geoffrey Michael,4,0,34,30
1657207575502,MATH 109,A03,093478,Ganzberger; Geoffrey Michael,1,0,34,33
1657207575502,MATH 109,B01,083215,Ganzberger; Geoffrey Michael,1,0,32,31
1657207575502,MATH 109,B02,083216,Ganzberger; Geoffrey Michael,1,0,32,31
1657207575502,MATH 109,B03,093479,Ganzberger; Geoffrey Michael,7,0,32,25
1657207581537,MATH 142A,A01,083219,Chow; Bennett,6,0,32,26
1657207581537,MATH 142A,A02,083220,Chow; Bennett,10,0,32,22
1657207581537,MATH 142A,A03,093480,Chow; Bennett,7,0,32,25
1657207581537,MATH 142A,B03,093481,Chow; Bennett,8,0,32,24
1657207581537,MATH 142A,B04,093558,Chow; Bennett,11,0,32,21
1657207581537,MATH 142A,B05,093559,Chow; Bennett,6,0,32,26
1657207587570,MATH 193A,A01,083224,Rotar; Vladimir,7,0,34,27
1657207587570,MATH 193A,A02,083225,Rotar; Vladimir,5,0,34,29
1657207587570,MATH 193A,A03,083781,Rotar; Vladimir,1,0,34,33
1657207587570,MATH 193A,A04,083782,Rotar; Vladimir,8,0,34,26
1657207587570,MATH 193A,A05,093482,Rotar; Vladimir,6,0,34,28
1657207593609,MATH 197,001,091859,McAuley; Julian John,9999,0,9999,0
1657207593609,MATH 197,002,095566,Kedlaya; Kiran S.,9997,0,9999,2
1657207593609,MATH 197,003,095567,Xiao; Ming,9999,0,9999,0
1657207593609,MATH 197,004,095571,Perols; Johan Lars,9998,0,9999,1
1657207600702,COGS 9,A01,083615,Shannon; Kyle Michael,7,0,75,68
1657207606736,COGS 11,A01,083617,Boyle; Mary E. T.,22,0,48,26
1657207612773,COGS 13,A01,083071,Bastos; Amalia Pinkusfeld,9,0,71,62
1657207618801,COGS 14A,A01,092681,Semenuks; Arturs,1,1,100,99
1657207624830,COGS 14B,A01,083073,Cheng; Tzu-Han,6,0,63,57
1657207630868,COGS 17,A01,092677,Semenuks; Arturs,4,0,81,77
1657207636894,COGS 100,A01,083619,Allen; Michael Gordon,15,0,70,55
1657207642936,COGS 101A,A01,083621,Davis; Joshua Daniel,9,0,68,59
1657207648979,COGS 101B,A01,091572,Allen; Michael Gordon,9,0,65,56
1657207655013,COGS 101C,A01,083625,Delgado; Tania,17,0,35,18
1657207661042,COGS 107A,A01,083627,Boyle; Mary E. T.,13,0,60,47
1657207667101,COGS 118A,A01,083075,Gupta; Anjum,16,0,76,60
1657207673153,CSE 3,A50,083646,Miranda; Gregory Joseph,24,0,50,26
1657207679175,CSE 8A,A50,083650,Miranda; Gregory Joseph,17,1,56,39
1657207685219,CSE 11,A01,083080,Cao; Yingjun,5,15,40,35
1657207691254,CSE 12,A01,083652,Krause-Levy; Sophia Louisa,24,1,120,96
1657207697277,CSE 15L,A01,083654,Morris; Justin Loren,9,0,50,41
1657207697277,CSE 15L,A02,083655,Morris; Justin Loren,9,0,50,41
1657207703315,CSE 20,A01,083657,Tran; Khoa Dang,38,0,80,42
1657207709356,CSE 21,A01,095574,Bach; Quang Tran,22,0,48,26
1657207715407,CSE 30,A01,083084,Eldon; John,4,0,80,76
1657207715407,CSE 30,B01,095061,Bhaskar; Nishant,7,0,50,43
1657207721433,CSE 100,A01,083659,Cao; Yingjun,4,4,70,66
1657207727482,CSE 134B,A01,083661,Powell; Thomas Allan,20,0,100,80
1657207733514,CSE 140,A01,083663,Gungor; Onat,13,0,85,72
1657207739538,CSE 140L,A01,083088,Eldon; John,17,0,100,83
1657207745570,CSE 175,A01,083665,Kumar; Rakesh,3,0,25,22
1657207751615,CSE 190,A00,092507,Dubnov; Shlomo,7,0,20,13
1657207757670,ECE 45,A01,083139,Congero; Spencer William,5,0,75,70
1657207763696,ECE 65,A50,083695,Saad; Andrew S,12,0,30,18
1657207763696,ECE 65,A51,095125,Saad; Andrew S,25,0,26,1
1657207769726,ECE 109,A01,091882,Touri; Behrouz,19,0,70,51
1657207775786,ECE 180,A00,083140,Abi Samra; Nicholas Camill,1,0,30,29
1657207775786,ECE 180,B00,083141,Abi Samra; Nicholas Camill,0,0,30,30
1657207781823,MATH 10A,A01,083735,Patchell; Gregory David,2,0,30,28
1657207781823,MATH 10A,A02,083736,Patchell; Gregory David,20,0,30,10
1657207781823,MATH 10A,A03,083737,Patchell; Gregory David,16,0,30,14
1657207787866,MATH 10B,A01,083207,Lim; Seonhee,7,0,34,27
1657207787866,MATH 10B,A02,083208,Lim; Seonhee,9,0,35,26
1657207787866,MATH 10B,A03,093472,Lim; Seonhee,5,0,34,29
1657207787866,MATH 10B,B01,083739,Sinha; Shubham,10,0,30,20
1657207793911,MATH 18,A01,083743,Cinel; Cameron Alexander,6,0,30,24
1657207793911,MATH 18,A02,083744,Cinel; Cameron Alexander,15,0,30,15
1657207793911,MATH 18,A03,083745,Cinel; Cameron Alexander,8,0,30,22
1657207793911,MATH 18,B01,083748,Rideout; David Porter,4,0,37,33
1657207793911,MATH 18,B02,083749,Rideout; David Porter,4,0,36,32
1657207793911,MATH 18,B03,083750,Rideout; David Porter,2,0,37,35
1657207793911,MATH 18,B04,083751,Rideout; David Porter,5,0,36,31
1657207793911,MATH 18,B05,093473,Rideout; David Porter,5,0,36,31
1657207793911,MATH 18,B06,093474,Rideout; David Porter,5,0,36,31
1657207799941,MATH 20A,A01,083754,Zheng; Zequn,13,0,40,27
1657207805970,MATH 20B,A01,083756,Briones; Jor-el Thomas Caparas,2,0,36,34
1657207805970,MATH 20B,A02,083757,Briones; Jor-el Thomas Caparas,1,0,36,35
1657207805970,MATH 20B,A03,093475,Briones; Jor-el Thomas Caparas,1,0,36,35
1657207812006,MATH 20C,A01,083760,Briones; Jor-el Thomas Caparas,1,0,35,34
1657207812006,MATH 20C,A02,083761,Briones; Jor-el Thomas Caparas,8,0,35,27
1657207812006,MATH 20C,A03,093476,Briones; Jor-el Thomas Caparas,0,1,36,36
1657207812006,MATH 20C,B01,083762,Bach; Quang Tran,1,0,30,29
1657207818045,MATH 20D,A01,083765,Tran; Brian Kha,4,0,30,26
1657207818045,MATH 20D,A02,083766,Tran; Brian Kha,5,0,30,25
1657207818045,MATH 20D,A03,083767,Tran; Brian Kha,4,0,30,26
1657207824069,MATH 20E,A01,083771,Ganguly; Soumya,7,0,32,25
1657207824069,MATH 20E,A02,083772,Ganguly; Soumya,7,0,32,25
1657207824069,MATH 20E,B01,083773,Ciotti; Benjamin,19,0,35,16
1657207824069,MATH 20E,B02,083774,Ciotti; Benjamin,17,0,35,18
1657207830123,MATH 103A,A01,083777,Greenfeld; Be'Eri,2,0,36,34
1657207830123,MATH 103A,A02,083778,Greenfeld; Be'Eri,5,0,36,31
1657207830123,MATH 103A,A03,093561,Greenfeld; Be'Eri,4,0,36,32
1657207830123,MATH 103A,B01,083779,Greenfeld; Be'Eri,6,0,36,30
1657207830123,MATH 103A,B02,083780,Greenfeld; Be'Eri,3,0,36,33
1657207830123,MATH 103A,B03,093562,Greenfeld; Be'Eri,3,0,36,33
1657207836168,MATH 105,A01,085443,Carter; Anne Toulson,15,0,35,20
1657207836168,MATH 105,A02,093477,Carter; Anne Toulson,20,0,35,15
1657207842191,MATH 109,A01,083213,Ganzberger; Geoffrey Michael,2,0,34,32
1657207842191,MATH 109,A02,083214,Ganzberger; Geoffrey Michael,4,0,34,30
1657207842191,MATH 109,A03,093478,Ganzberger; Geoffrey Michael,1,0,34,33
1657207842191,MATH 109,B01,083215,Ganzberger; Geoffrey Michael,1,0,32,31
1657207842191,MATH 109,B02,083216,Ganzberger; Geoffrey Michael,1,0,32,31
1657207842191,MATH 109,B03,093479,Ganzberger; Geoffrey Michael,7,0,32,25
1657207848241,MATH 142A,A01,083219,Chow; Bennett,6,0,32,26
1657207848241,MATH 142A,A02,083220,Chow; Bennett,10,0,32,22
1657207848241,MATH 142A,A03,093480,Chow; Bennett,7,0,32,25
1657207848241,MATH 142A,B03,093481,Chow; Bennett,8,0,32,24
1657207848241,MATH 142A,B04,093558,Chow; Bennett,11,0,32,21
1657207848241,MATH 142A,B05,093559,Chow; Bennett,6,0,32,26
1657207854278,MATH 193A,A01,083224,Rotar; Vladimir,7,0,34,27
1657207854278,MATH 193A,A02,083225,Rotar; Vladimir,5,0,34,29
1657207854278,MATH 193A,A03,083781,Rotar; Vladimir,1,0,34,33
1657207854278,MATH 193A,A04,083782,Rotar; Vladimir,8,0,34,26
1657207854278,MATH 193A,A05,093482,Rotar; Vladimir,6,0,34,28
1657207860338,MATH 197,001,091859,McAuley; Julian John,9999,0,9999,0
1657207860338,MATH 197,002,095566,Kedlaya; Kiran S.,9997,0,9999,2
1657207860338,MATH 197,003,095567,Xiao; Ming,9999,0,9999,0
1657207860338,MATH 197,004,095571,Perols; Johan Lars,9998,0,9999,1
1657207867429,COGS 9,A01,083615,Shannon; Kyle Michael,7,0,75,68
1657207873567,COGS 11,A01,083617,Boyle; Mary E. T.,22,0,48,26
1657207879606,COGS 13,A01,083071,Bastos; Amalia Pinkusfeld,9,0,71,62
1657207885645,COGS 14A,A01,092681,Semenuks; Arturs,1,1,100,99
1657207891683,COGS 14B,A01,083073,Cheng; Tzu-Han,6,0,63,57
1657207897721,COGS 17,A01,092677,Semenuks; Arturs,4,0,81,77
1657207903749,COGS 100,A01,083619,Allen; Michael Gordon,15,0,70,55
1657207909796,COGS 101A,A01,083621,Davis; Joshua Daniel,9,0,68,59
1657207915818,COGS 101B,A01,091572,Allen; Michael Gordon,9,0,65,56
1657207921848,COGS 101C,A01,083625,Delgado; Tania,17,0,35,18
1657207927897,COGS 107A,A01,083627,Boyle; Mary E. T.,13,0,60,47
1657207933921,COGS 118A,A01,083075,Gupta; Anjum,16,0,76,60
1657207939950,CSE 3,A50,083646,Miranda; Gregory Joseph,24,0,50,26
1657207945978,CSE 8A,A50,083650,Miranda; Gregory Joseph,17,1,56,39
1657207952048,CSE 11,A01,083080,Cao; Yingjun,5,15,40,35
1657207958099,CSE 12,A01,083652,Krause-Levy; Sophia Louisa,24,1,120,96
1657207964123,CSE 15L,A01,083654,Morris; Justin Loren,9,0,50,41
1657207964123,CSE 15L,A02,083655,Morris; Justin Loren,9,0,50,41
1657207970168,CSE 20,A01,083657,Tran; Khoa Dang,38,0,80,42
1657207976206,CSE 21,A01,095574,Bach; Quang Tran,22,0,48,26
1657207982248,CSE 30,A01,083084,Eldon; John,4,0,80,76
1657207982248,CSE 30,B01,095061,Bhaskar; Nishant,7,0,50,43
1657207988296,CSE 100,A01,083659,Cao; Yingjun,4,4,70,66
1657207994328,CSE 134B,A01,083661,Powell; Thomas Allan,20,0,100,80
1657208000351,CSE 140,A01,083663,Gungor; Onat,13,0,85,72
1657208006392,CSE 140L,A01,083088,Eldon; John,17,0,100,83
1657208012425,CSE 175,A01,083665,Kumar; Rakesh,3,0,25,22
1657208018471,CSE 190,A00,092507,Dubnov; Shlomo,7,0,20,13
1657208024509,ECE 45,A01,083139,Congero; Spencer William,5,0,75,70
1657208030538,ECE 65,A50,083695,Saad; Andrew S,12,0,30,18
1657208030538,ECE 65,A51,095125,Saad; Andrew S,25,0,26,1
1657208036563,ECE 109,A01,091882,Touri; Behrouz,19,0,70,51
1657208042599,ECE 180,A00,083140,Abi Samra; Nicholas Camill,1,0,30,29
1657208042599,ECE 180,B00,083141,Abi Samra; Nicholas Camill,0,0,30,30
1657208048648,MATH 10A,A01,083735,Patchell; Gregory David,2,0,30,28
1657208048648,MATH 10A,A02,083736,Patchell; Gregory David,20,0,30,10
1657208048648,MATH 10A,A03,083737,Patchell; Gregory David,16,0,30,14
1657208054690,MATH 10B,A01,083207,Lim; Seonhee,7,0,34,27
1657208054690,MATH 10B,A02,083208,Lim; Seonhee,9,0,35,26
1657208054690,MATH 10B,A03,093472,Lim; Seonhee,5,0,34,29
1657208054690,MATH 10B,B01,083739,Sinha; Shubham,10,0,30,20
1657208060742,MATH 18,A01,083743,Cinel; Cameron Alexander,6,0,30,24
1657208060742,MATH 18,A02,083744,Cinel; Cameron Alexander,15,0,30,15
1657208060742,MATH 18,A03,083745,Cinel; Cameron Alexander,8,0,30,22
1657208060742,MATH 18,B01,083748,Rideout; David Porter,4,0,37,33
1657208060742,MATH 18,B02,083749,Rideout; David Porter,4,0,36,32
1657208060742,MATH 18,B03,083750,Rideout; David Porter,2,0,37,35
1657208060742,MATH 18,B04,083751,Rideout; David Porter,5,0,36,31
1657208060742,MATH 18,B05,093473,Rideout; David Porter,5,0,36,31
1657208060742,MATH 18,B06,093474,Rideout; David Porter,5,0,36,31
1657208066774,MATH 20A,A01,083754,Zheng; Zequn,13,0,40,27
1657208072808,MATH 20B,A01,083756,Briones; Jor-el Thomas Caparas,2,0,36,34
1657208072808,MATH 20B,A02,083757,Briones; Jor-el Thomas Caparas,1,0,36,35
1657208072808,MATH 20B,A03,093475,Briones; Jor-el Thomas Caparas,1,0,36,35
1657208078867,MATH 20C,A01,083760,Briones; Jor-el Thomas Caparas,1,0,35,34
1657208078867,MATH 20C,A02,083761,Briones; Jor-el Thomas Caparas,8,0,35,27
1657208078867,MATH 20C,A03,093476,Briones; Jor-el Thomas Caparas,0,1,36,36
1657208078867,MATH 20C,B01,083762,Bach; Quang Tran,1,0,30,29
1657208084910,MATH 20D,A01,083765,Tran; Brian Kha,4,0,30,26
1657208084910,MATH 20D,A02,083766,Tran; Brian Kha,5,0,30,25
1657208084910,MATH 20D,A03,083767,Tran; Brian Kha,4,0,30,26
1657208090952,MATH 20E,A01,083771,Ganguly; Soumya,7,0,32,25
1657208090952,MATH 20E,A02,083772,Ganguly; Soumya,7,0,32,25
1657208090952,MATH 20E,B01,083773,Ciotti; Benjamin,19,0,35,16
1657208090952,MATH 20E,B02,083774,Ciotti; Benjamin,17,0,35,18
1657208096985,MATH 103A,A01,083777,Greenfeld; Be'Eri,2,0,36,34
1657208096985,MATH 103A,A02,083778,Greenfeld; Be'Eri,5,0,36,31
1657208096985,MATH 103A,A03,093561,Greenfeld; Be'Eri,4,0,36,32
1657208096985,MATH 103A,B01,083779,Greenfeld; Be'Eri,6,0,36,30
1657208096985,MATH 103A,B02,083780,Greenfeld; Be'Eri,3,0,36,33
1657208096985,MATH 103A,B03,093562,Greenfeld; Be'Eri,3,0,36,33
1657208103013,MATH 105,A01,085443,Carter; Anne Toulson,15,0,35,20
1657208103013,MATH 105,A02,093477,Carter; Anne Toulson,20,0,35,15
1657208109038,MATH 109,A01,083213,Ganzberger; Geoffrey Michael,2,0,34,32
1657208109038,MATH 109,A02,083214,Ganzberger; Geoffrey Michael,4,0,34,30
1657208109038,MATH 109,A03,093478,Ganzberger; Geoffrey Michael,1,0,34,33
1657208109038,MATH 109,B01,083215,Ganzberger; Geoffrey Michael,1,0,32,31
1657208109038,MATH 109,B02,083216,Ganzberger; Geoffrey Michael,1,0,32,31
1657208109038,MATH 109,B03,093479,Ganzberger; Geoffrey Michael,7,0,32,25
1657208115078,MATH 142A,A01,083219,Chow; Bennett,6,0,32,26
1657208115078,MATH 142A,A02,083220,Chow; Bennett,10,0,32,22
1657208115078,MATH 142A,A03,093480,Chow; Bennett,7,0,32,25
1657208115078,MATH 142A,B03,093481,Chow; Bennett,8,0,32,24
1657208115078,MATH 142A,B04,093558,Chow; Bennett,11,0,32,21
1657208115078,MATH 142A,B05,093559,Chow; Bennett,6,0,32,26
1657208121104,MATH 193A,A01,083224,Rotar; Vladimir,7,0,34,27
1657208121104,MATH 193A,A02,083225,Rotar; Vladimir,5,0,34,29
1657208121104,MATH 193A,A03,083781,Rotar; Vladimir,1,0,34,33
1657208121104,MATH 193A,A04,083782,Rotar; Vladimir,8,0,34,26
1657208121104,MATH 193A,A05,093482,Rotar; Vladimir,6,0,34,28
1657208127138,MATH 197,001,091859,McAuley; Julian John,9999,0,9999,0
1657208127138,MATH 197,002,095566,Kedlaya; Kiran S.,9997,0,9999,2
1657208127138,MATH 197,003,095567,Xiao; Ming,9999,0,9999,0
1657208127138,MATH 197,004,095571,Perols; Johan Lars,9998,0,9999,1
1657208134229,COGS 9,A01,083615,Shannon; Kyle Michael,7,0,75,68
1657208140270,COGS 11,A01,083617,Boyle; Mary E. T.,22,0,48,26
1657208146312,COGS 13,A01,083071,Bastos; Amalia Pinkusfeld,9,0,71,62
1657208152347,COGS 14A,A01,092681,Semenuks; Arturs,1,1,100,99
1657208158387,COGS 14B,A01,083073,Cheng; Tzu-Han,6,0,63,57
1657208164422,COGS 17,A01,092677,Semenuks; Arturs,4,0,81,77
1657208170465,COGS 100,A01,083619,Allen; Michael Gordon,15,0,70,55
1657208176501,COGS 101A,A01,083621,Davis; Joshua Daniel,9,0,68,59
1657208182545,COGS 101B,A01,091572,Allen; Michael Gordon,9,0,65,56
1657208188571,COGS 101C,A01,083625,Delgado; Tania,17,0,35,18
1657208194593,COGS 107A,A01,083627,Boyle; Mary E. T.,13,0,60,47
1657208200648,COGS 118A,A01,083075,Gupta; Anjum,16,0,76,60
1657208206698,CSE 3,A50,083646,Miranda; Gregory Joseph,24,0,50,26
1657208212732,CSE 8A,A50,083650,Miranda; Gregory Joseph,17,1,56,39
1657208218786,CSE 11,A01,083080,Cao; Yingjun,5,15,40,35
1657208224819,CSE 12,A01,083652,Krause-Levy; Sophia Louisa,24,1,120,96
1657208230871,CSE 15L,A01,083654,Morris; Justin Loren,9,0,50,41
1657208230871,CSE 15L,A02,083655,Morris; Justin Loren,9,0,50,41
1657208236905,CSE 20,A01,083657,Tran; Khoa Dang,38,0,80,42
1657208242937,CSE 21,A01,095574,Bach; Quang Tran,22,0,48,26
1657208248978,CSE 30,A01,083084,Eldon; John,4,0,80,76
1657208248978,CSE 30,B01,095061,Bhaskar; Nishant,7,0,50,43
1657208255031,CSE 100,A01,083659,Cao; Yingjun,4,4,70,66
1657208261055,CSE 134B,A01,083661,Powell; Thomas Allan,20,0,100,80
1657208267088,CSE 140,A01,083663,Gungor; Onat,13,0,85,72
1657208273121,CSE 140L,A01,083088,Eldon; John,17,0,100,83
1657208279146,CSE 175,A01,083665,Kumar; Rakesh,3,0,25,22
1657208285185,CSE 190,A00,092507,Dubnov; Shlomo,7,0,20,13
1657208291244,ECE 45,A01,083139,Congero; Spencer William,5,0,75,70
1657208297273,ECE 65,A50,083695,Saad; Andrew S,12,0,30,18
1657208297273,ECE 65,A51,095125,Saad; Andrew S,25,0,26,1
1657208303321,ECE 109,A01,091882,Touri; Behrouz,19,0,70,51
1657208309347,ECE 180,A00,083140,Abi Samra; Nicholas Camill,1,0,30,29
1657208309347,ECE 180,B00,083141,Abi Samra; Nicholas Camill,0,0,30,30
1657208315401,MATH 10A,A01,083735,Patchell; Gregory David,2,0,30,28
1657208315401,MATH 10A,A02,083736,Patchell; Gregory David,20,0,30,10
1657208315401,MATH 10A,A03,083737,Patchell; Gregory David,16,0,30,14
1657208321434,MATH 10B,A01,083207,Lim; Seonhee,7,0,34,27
1657208321434,MATH 10B,A02,083208,Lim; Seonhee,9,0,35,26
1657208321434,MATH 10B,A03,093472,Lim; Seonhee,5,0,34,29
1657208321434,MATH 10B,B01,083739,Sinha; Shubham,10,0,30,20
1657208327474,MATH 18,A01,083743,Cinel; Cameron Alexander,6,0,30,24
1657208327474,MATH 18,A02,083744,Cinel; Cameron Alexander,15,0,30,15
1657208327474,MATH 18,A03,083745,Cinel; Cameron Alexander,8,0,30,22
1657208327474,MATH 18,B01,083748,Rideout; David Porter,4,0,37,33
1657208327474,MATH 18,B02,083749,Rideout; David Porter,4,0,36,32
1657208327474,MATH 18,B03,083750,Rideout; David Porter,2,0,37,35
1657208327474,MATH 18,B04,083751,Rideout; David Porter,5,0,36,31
1657208327474,MATH 18,B05,093473,Rideout; David Porter,5,0,36,31
1657208327474,MATH 18,B06,093474,Rideout; David Porter,5,0,36,31
1657208333516,MATH 20A,A01,083754,Zheng; Zequn,13,0,40,27
1657208339548,MATH 20B,A01,083756,Briones; Jor-el Thomas Caparas,2,0,36,34
1657208339548,MATH 20B,A02,083757,Briones; Jor-el Thomas Caparas,1,0,36,35
1657208339548,MATH 20B,A03,093475,Briones; Jor-el Thomas Caparas,1,0,36,35
1657208345589,MATH 20C,A01,083760,Briones; Jor-el Thomas Caparas,1,0,35,34
1657208345589,MATH 20C,A02,083761,Briones; Jor-el Thomas Caparas,8,0,35,27
1657208345589,MATH 20C,A03,093476,Briones; Jor-el Thomas Caparas,0,1,36,36
1657208345589,MATH 20C,B01,083762,Bach; Quang Tran,1,0,30,29
1657208351635,MATH 20D,A01,083765,Tran; Brian Kha,4,0,30,26
1657208351635,MATH 20D,A02,083766,Tran; Brian Kha,5,0,30,25
1657208351635,MATH 20D,A03,083767,Tran; Brian Kha,4,0,30,26
1657208357676,MATH 20E,A01,083771,Ganguly; Soumya,7,0,32,25
1657208357676,MATH 20E,A02,083772,Ganguly; Soumya,7,0,32,25
1657208357676,MATH 20E,B01,083773,Ciotti; Benjamin,19,0,35,16
1657208357676,MATH 20E,B02,083774,Ciotti; Benjamin,17,0,35,18
1657208363711,MATH 103A,A01,083777,Greenfeld; Be'Eri,2,0,36,34
1657208363711,MATH 103A,A02,083778,Greenfeld; Be'Eri,5,0,36,31
1657208363711,MATH 103A,A03,093561,Greenfeld; Be'Eri,4,0,36,32
1657208363711,MATH 103A,B01,083779,Greenfeld; Be'Eri,6,0,36,30
1657208363711,MATH 103A,B02,083780,Greenfeld; Be'Eri,3,0,36,33
1657208363711,MATH 103A,B03,093562,Greenfeld; Be'Eri,3,0,36,33
1657208369752,MATH 105,A01,085443,Carter; Anne Toulson,15,0,35,20
1657208369752,MATH 105,A02,093477,Carter; Anne Toulson,20,0,35,15
1657208375794,MATH 109,A01,083213,Ganzberger; Geoffrey Michael,2,0,34,32
1657208375794,MATH 109,A02,083214,Ganzberger; Geoffrey Michael,4,0,34,30
1657208375794,MATH 109,A03,093478,Ganzberger; Geoffrey Michael,2,0,34,32
1657208375794,MATH 109,B01,083215,Ganzberger; Geoffrey Michael,1,0,32,31
1657208375794,MATH 109,B02,083216,Ganzberger; Geoffrey Michael,1,0,32,31
1657208375794,MATH 109,B03,093479,Ganzberger; Geoffrey Michael,7,0,32,25
1657208381836,MATH 142A,A01,083219,Chow; Bennett,6,0,32,26
1657208381836,MATH 142A,A02,083220,Chow; Bennett,10,0,32,22
1657208381836,MATH 142A,A03,093480,Chow; Bennett,7,0,32,25
1657208381836,MATH 142A,B03,093481,Chow; Bennett,8,0,32,24
1657208381836,MATH 142A,B04,093558,Chow; Bennett,11,0,32,21
1657208381836,MATH 142A,B05,093559,Chow; Bennett,6,0,32,26
1657208387879,MATH 193A,A01,083224,Rotar; Vladimir,7,0,34,27
1657208387879,MATH 193A,A02,083225,Rotar; Vladimir,5,0,34,29
1657208387879,MATH 193A,A03,083781,Rotar; Vladimir,1,0,34,33
1657208387879,MATH 193A,A04,083782,Rotar; Vladimir,8,0,34,26
1657208387879,MATH 193A,A05,093482,Rotar; Vladimir,6,0,34,28
1657208393941,MATH 197,001,091859,McAuley; Julian John,9999,0,9999,0
1657208393941,MATH 197,002,095566,Kedlaya; Kiran S.,9997,0,9999,2
1657208393941,MATH 197,003,095567,Xiao; Ming,9999,0,9999,0
1657208393941,MATH 197,004,095571,Perols; Johan Lars,9998,0,9999,1
1657208401029,COGS 9,A01,083615,Shannon; Kyle Michael,7,0,75,68
1657208407065,COGS 11,A01,083617,Boyle; Mary E. T.,22,0,48,26
1657208413113,COGS 13,A01,083071,Bastos; Amalia Pinkusfeld,9,0,71,62
1657208419138,COGS 14A,A01,092681,Semenuks; Arturs,1,1,100,99
1657208425190,COGS 14B,A01,083073,Cheng; Tzu-Han,6,0,63,57
1657208431231,COGS 17,A01,092677,Semenuks; Arturs,4,0,81,77
1657208437271,COGS 100,A01,083619,Allen; Michael Gordon,15,0,70,55
1657208443325,COGS 101A,A01,083621,Davis; Joshua Daniel,9,0,68,59
1657208449358,COGS 101B,A01,091572,Allen; Michael Gordon,9,0,65,56
1657208455416,COGS 101C,A01,083625,Delgado; Tania,17,0,35,18
1657208461459,COGS 107A,A01,083627,Boyle; Mary E. T.,13,0,60,47
1657208467488,COGS 118A,A01,083075,Gupta; Anjum,16,0,76,60
1657208473598,CSE 3,A50,083646,Miranda; Gregory Joseph,24,0,50,26
1657208479646,CSE 8A,A50,083650,Miranda; Gregory Joseph,17,1,56,39
1657208485683,CSE 11,A01,083080,Cao; Yingjun,5,15,40,35
1657208491723,CSE 12,A01,083652,Krause-Levy; Sophia Louisa,24,1,120,96
1657208497746,CSE 15L,A01,083654,Morris; Justin Loren,9,0,50,41
1657208497746,CSE 15L,A02,083655,Morris; Justin Loren,9,0,50,41
1657208503779,CSE 20,A01,083657,Tran; Khoa Dang,38,0,80,42
1657208509823,CSE 21,A01,095574,Bach; Quang Tran,22,0,48,26
1657208515868,CSE 30,A01,083084,Eldon; John,4,0,80,76
1657208515868,CSE 30,B01,095061,Bhaskar; Nishant,7,0,50,43
1657208521917,CSE 100,A01,083659,Cao; Yingjun,4,4,70,66
1657208527964,CSE 134B,A01,083661,Powell; Thomas Allan,20,0,100,80
1657208534003,CSE 140,A01,083663,Gungor; Onat,13,0,85,72
1657208540035,CSE 140L,A01,083088,Eldon; John,17,0,100,83
1657208546069,CSE 175,A01,083665,Kumar; Rakesh,3,0,25,22
1657208552102,CSE 190,A00,092507,Dubnov; Shlomo,7,0,20,13
1657208558142,ECE 45,A01,083139,Congero; Spencer William,5,0,75,70
1657208564176,ECE 65,A50,083695,Saad; Andrew S,12,0,30,18
1657208564176,ECE 65,A51,095125,Saad; Andrew S,25,0,26,1
1657208570211,ECE 109,A01,091882,Touri; Behrouz,19,0,70,51
1657208576260,ECE 180,A00,083140,Abi Samra; Nicholas Camill,1,0,30,29
1657208576260,ECE 180,B00,083141,Abi Samra; Nicholas Camill,0,0,30,30
1657208582297,MATH 10A,A01,083735,Patchell; Gregory David,2,0,30,28
1657208582297,MATH 10A,A02,083736,Patchell; Gregory David,20,0,30,10
1657208582297,MATH 10A,A03,083737,Patchell; Gregory David,16,0,30,14
1657208588333,MATH 10B,A01,083207,Lim; Seonhee,7,0,34,27
1657208588333,MATH 10B,A02,083208,Lim; Seonhee,9,0,35,26
1657208588333,MATH 10B,A03,093472,Lim; Seonhee,5,0,34,29
1657208588333,MATH 10B,B01,083739,Sinha; Shubham,10,0,30,20
1657208594371,MATH 18,A01,083743,Cinel; Cameron Alexander,6,0,30,24
1657208594371,MATH 18,A02,083744,Cinel; Cameron Alexander,15,0,30,15
1657208594371,MATH 18,A03,083745,Cinel; Cameron Alexander,8,0,30,22
1657208594371,MATH 18,B01,083748,Rideout; David Porter,4,0,37,33
1657208594371,MATH 18,B02,083749,Rideout; David Porter,4,0,36,32
1657208594371,MATH 18,B03,083750,Rideout; David Porter,2,0,37,35
1657208594371,MATH 18,B04,083751,Rideout; David Porter,5,0,36,31
1657208594371,MATH 18,B05,093473,Rideout; David Porter,5,0,36,31
1657208594371,MATH 18,B06,093474,Rideout; David Porter,5,0,36,31
1657208600409,MATH 20A,A01,083754,Zheng; Zequn,13,0,40,27
1657208606473,MATH 20B,A01,083756,Briones; Jor-el Thomas Caparas,2,0,36,34
1657208606473,MATH 20B,A02,083757,Briones; Jor-el Thomas Caparas,1,0,36,35
1657208606473,MATH 20B,A03,093475,Briones; Jor-el Thomas Caparas,1,0,36,35
1657208612511,MATH 20C,A01,083760,Briones; Jor-el Thomas Caparas,1,0,35,34
1657208612511,MATH 20C,A02,083761,Briones; Jor-el Thomas Caparas,8,0,35,27
1657208612511,MATH 20C,A03,093476,Briones; Jor-el Thomas Caparas,0,1,36,36
1657208612511,MATH 20C,B01,083762,Bach; Quang Tran,1,0,30,29
1657208618557,MATH 20D,A01,083765,Tran; Brian Kha,4,0,30,26
1657208618557,MATH 20D,A02,083766,Tran; Brian Kha,5,0,30,25
1657208618557,MATH 20D,A03,083767,Tran; Brian Kha,4,0,30,26
1657208624611,MATH 20E,A01,083771,Ganguly; Soumya,7,0,32,25
1657208624611,MATH 20E,A02,083772,Ganguly; Soumya,7,0,32,25
1657208624611,MATH 20E,B01,083773,Ciotti; Benjamin,19,0,35,16
1657208624611,MATH 20E,B02,083774,Ciotti; Benjamin,17,0,35,18
1657208630666,MATH 103A,A01,083777,Greenfeld; Be'Eri,2,0,36,34
1657208630666,MATH 103A,A02,083778,Greenfeld; Be'Eri,5,0,36,31
1657208630666,MATH 103A,A03,093561,Greenfeld; Be'Eri,4,0,36,32
1657208630666,MATH 103A,B01,083779,Greenfeld; Be'Eri,6,0,36,30
1657208630666,MATH 103A,B02,083780,Greenfeld; Be'Eri,3,0,36,33
1657208630666,MATH 103A,B03,093562,Greenfeld; Be'Eri,3,0,36,33
1657208636711,MATH 105,A01,085443,Carter; Anne Toulson,15,0,35,20
1657208636711,MATH 105,A02,093477,Carter; Anne Toulson,20,0,35,15
1657208642751,MATH 109,A01,083213,Ganzberger; Geoffrey Michael,2,0,34,32
1657208642751,MATH 109,A02,083214,Ganzberger; Geoffrey Michael,4,0,34,30
1657208642751,MATH 109,A03,093478,Ganzberger; Geoffrey Michael,2,0,34,32
1657208642751,MATH 109,B01,083215,Ganzberger; Geoffrey Michael,1,0,32,31
1657208642751,MATH 109,B02,083216,Ganzberger; Geoffrey Michael,1,0,32,31
1657208642751,MATH 109,B03,093479,Ganzberger; Geoffrey Michael,7,0,32,25
1657208648804,MATH 142A,A01,083219,Chow; Bennett,6,0,32,26
1657208648804,MATH 142A,A02,083220,Chow; Bennett,10,0,32,22
1657208648804,MATH 142A,A03,093480,Chow; Bennett,7,0,32,25
1657208648804,MATH 142A,B03,093481,Chow; Bennett,8,0,32,24
1657208648804,MATH 142A,B04,093558,Chow; Bennett,11,0,32,21
1657208648804,MATH 142A,B05,093559,Chow; Bennett,6,0,32,26
1657208654867,MATH 193A,A01,083224,Rotar; Vladimir,7,0,34,27
1657208654867,MATH 193A,A02,083225,Rotar; Vladimir,5,0,34,29
1657208654867,MATH 193A,A03,083781,Rotar; Vladimir,1,0,34,33
1657208654867,MATH 193A,A04,083782,Rotar; Vladimir,8,0,34,26
1657208654867,MATH 193A,A05,093482,Rotar; Vladimir,6,0,34,28
1657208660933,MATH 197,001,091859,McAuley; Julian John,9999,0,9999,0
1657208660933,MATH 197,002,095566,Kedlaya; Kiran S.,9997,0,9999,2
1657208660933,MATH 197,003,095567,Xiao; Ming,9999,0,9999,0
1657208660933,MATH 197,004,095571,Perols; Johan Lars,9998,0,9999,1
1657208668012,COGS 9,A01,083615,Shannon; Kyle Michael,7,0,75,68
1657208674058,COGS 11,A01,083617,Boyle; Mary E. T.,22,0,48,26
1657208680098,COGS 13,A01,083071,Bastos; Amalia Pinkusfeld,9,0,71,62
1657208686141,COGS 14A,A01,092681,Semenuks; Arturs,1,1,100,99
1657208692193,COGS 14B,A01,083073,Cheng; Tzu-Han,6,0,63,57
1657208698223,COGS 17,A01,092677,Semenuks; Arturs,4,0,81,77
1657208704271,COGS 100,A01,083619,Allen; Michael Gordon,15,0,70,55
1657208710299,COGS 101A,A01,083621,Davis; Joshua Daniel,9,0,68,59
1657208716323,COGS 101B,A01,091572,Allen; Michael Gordon,9,0,65,56
1657208722351,COGS 101C,A01,083625,Delgado; Tania,17,0,35,18
1657208728393,COGS 107A,A01,083627,Boyle; Mary E. T.,13,0,60,47
1657208734430,COGS 118A,A01,083075,Gupta; Anjum,16,0,76,60
1657208740482,CSE 3,A50,083646,Miranda; Gregory Joseph,24,0,50,26
1657208746537,CSE 8A,A50,083650,Miranda; Gregory Joseph,17,1,56,39
1657208752579,CSE 11,A01,083080,Cao; Yingjun,5,15,40,35
1657208758614,CSE 12,A01,083652,Krause-Levy; Sophia Louisa,24,1,120,96
1657208764665,CSE 15L,A01,083654,Morris; Justin Loren,9,0,50,41
1657208764665,CSE 15L,A02,083655,Morris; Justin Loren,9,0,50,41
1657208770696,CSE 20,A01,083657,Tran; Khoa Dang,38,0,80,42
1657208776752,CSE 21,A01,095574,Bach; Quang Tran,22,0,48,26
1657208782791,CSE 30,A01,083084,Eldon; John,4,0,80,76
1657208782791,CSE 30,B01,095061,Bhaskar; Nishant,7,0,50,43
1657208788847,CSE 100,A01,083659,Cao; Yingjun,4,4,70,66
1657208794881,CSE 134B,A01,083661,Powell; Thomas Allan,20,0,100,80
1657208800932,CSE 140,A01,083663,Gungor; Onat,13,0,85,72
1657208806972,CSE 140L,A01,083088,Eldon; John,17,0,100,83
1657208813010,CSE 175,A01,083665,Kumar; Rakesh,3,0,25,22
1657208819036,CSE 190,A00,092507,Dubnov; Shlomo,7,0,20,13
1657208825073,ECE 45,A01,083139,Congero; Spencer William,5,0,75,70
1657208831118,ECE 65,A50,083695,Saad; Andrew S,12,0,30,18
1657208831118,ECE 65,A51,095125,Saad; Andrew S,25,0,26,1
1657208837176,ECE 109,A01,091882,Touri; Behrouz,19,0,70,51
1657208843218,ECE 180,A00,083140,Abi Samra; Nicholas Camill,1,0,30,29
1657208843218,ECE 180,B00,083141,Abi Samra; Nicholas Camill,0,0,30,30
1657208849253,MATH 10A,A01,083735,Patchell; Gregory David,2,0,30,28
1657208849253,MATH 10A,A02,083736,Patchell; Gregory David,20,0,30,10
1657208849253,MATH 10A,A03,083737,Patchell; Gregory David,16,0,30,14
1657208855299,MATH 10B,A01,083207,Lim; Seonhee,7,0,34,27
1657208855299,MATH 10B,A02,083208,Lim; Seonhee,9,0,35,26
1657208855299,MATH 10B,A03,093472,Lim; Seonhee,5,0,34,29
1657208855299,MATH 10B,B01,083739,Sinha; Shubham,10,0,30,20
1657208861338,MATH 18,A01,083743,Cinel; Cameron Alexander,6,0,30,24
1657208861338,MATH 18,A02,083744,Cinel; Cameron Alexander,15,0,30,15
1657208861338,MATH 18,A03,083745,Cinel; Cameron Alexander,8,0,30,22
1657208861338,MATH 18,B01,083748,Rideout; David Porter,4,0,37,33
1657208861338,MATH 18,B02,083749,Rideout; David Porter,4,0,36,32
1657208861338,MATH 18,B03,083750,Rideout; David Porter,2,0,37,35
1657208861338,MATH 18,B04,083751,Rideout; David Porter,5,0,36,31
1657208861338,MATH 18,B05,093473,Rideout; David Porter,5,0,36,31
1657208861338,MATH 18,B06,093474,Rideout; David Porter,5,0,36,31
1657208867381,MATH 20A,A01,083754,Zheng; Zequn,13,0,40,27
1657208873406,MATH 20B,A01,083756,Briones; Jor-el Thomas Caparas,2,0,36,34
1657208873406,MATH 20B,A02,083757,Briones; Jor-el Thomas Caparas,1,0,36,35
1657208873406,MATH 20B,A03,093475,Briones; Jor-el Thomas Caparas,1,0,36,35
1657208879440,MATH 20C,A01,083760,Briones; Jor-el Thomas Caparas,1,0,35,34
1657208879440,MATH 20C,A02,083761,Briones; Jor-el Thomas Caparas,8,0,35,27
1657208879440,MATH 20C,A03,093476,Briones; Jor-el Thomas Caparas,0,1,36,36
1657208879440,MATH 20C,B01,083762,Bach; Quang Tran,1,0,30,29
1657208885476,MATH 20D,A01,083765,Tran; Brian Kha,4,0,30,26
1657208885476,MATH 20D,A02,083766,Tran; Brian Kha,5,0,30,25
1657208885476,MATH 20D,A03,083767,Tran; Brian Kha,4,0,30,26
1657208891500,MATH 20E,A01,083771,Ganguly; Soumya,7,0,32,25
1657208891500,MATH 20E,A02,083772,Ganguly; Soumya,7,0,32,25
1657208891500,MATH 20E,B01,083773,Ciotti; Benjamin,19,0,35,16
1657208891500,MATH 20E,B02,083774,Ciotti; Benjamin,17,0,35,18
1657208897540,MATH 103A,A01,083777,Greenfeld; Be'Eri,2,0,36,34
1657208897540,MATH 103A,A02,083778,Greenfeld; Be'Eri,5,0,36,31
1657208897540,MATH 103A,A03,093561,Greenfeld; Be'Eri,4,0,36,32
1657208897540,MATH 103A,B01,083779,Greenfeld; Be'Eri,6,0,36,30
1657208897540,MATH 103A,B02,083780,Greenfeld; Be'Eri,3,0,36,33
1657208897540,MATH 103A,B03,093562,Greenfeld; Be'Eri,3,0,36,33
1657208903573,MATH 105,A01,085443,Carter; Anne Toulson,15,0,35,20
1657208903573,MATH 105,A02,093477,Carter; Anne Toulson,20,0,35,15
1657208909612,MATH 109,A01,083213,Ganzberger; Geoffrey Michael,2,0,34,32
1657208909612,MATH 109,A02,083214,Ganzberger; Geoffrey Michael,4,0,34,30
1657208909612,MATH 109,A03,093478,Ganzberger; Geoffrey Michael,2,0,34,32
1657208909612,MATH 109,B01,083215,Ganzberger; Geoffrey Michael,1,0,32,31
1657208909612,MATH 109,B02,083216,Ganzberger; Geoffrey Michael,1,0,32,31
1657208909612,MATH 109,B03,093479,Ganzberger; Geoffrey Michael,7,0,32,25
1657208915664,MATH 142A,A01,083219,Chow; Bennett,6,0,32,26
1657208915664,MATH 142A,A02,083220,Chow; Bennett,10,0,32,22
1657208915664,MATH 142A,A03,093480,Chow; Bennett,7,0,32,25
1657208915664,MATH 142A,B03,093481,Chow; Bennett,8,0,32,24
1657208915664,MATH 142A,B04,093558,Chow; Bennett,11,0,32,21
1657208915664,MATH 142A,B05,093559,Chow; Bennett,6,0,32,26
1657208921698,MATH 193A,A01,083224,Rotar; Vladimir,7,0,34,27
1657208921698,MATH 193A,A02,083225,Rotar; Vladimir,5,0,34,29
1657208921698,MATH 193A,A03,083781,Rotar; Vladimir,1,0,34,33
1657208921698,MATH 193A,A04,083782,Rotar; Vladimir,8,0,34,26
1657208921698,MATH 193A,A05,093482,Rotar; Vladimir,6,0,34,28
1657208927727,MATH 197,001,091859,McAuley; Julian John,9999,0,9999,0
1657208927727,MATH 197,002,095566,Kedlaya; Kiran S.,9997,0,9999,2
1657208927727,MATH 197,003,095567,Xiao; Ming,9999,0,9999,0
1657208927727,MATH 197,004,095571,Perols; Johan Lars,9998,0,9999,1
1657208934810,COGS 9,A01,083615,Shannon; Kyle Michael,7,0,75,68
1657208940832,COGS 11,A01,083617,Boyle; Mary E. T.,22,0,48,26
1657208946887,COGS 13,A01,083071,Bastos; Amalia Pinkusfeld,9,0,71,62
1657208952919,COGS 14A,A01,092681,Semenuks; Arturs,1,1,100,99
1657208958958,COGS 14B,A01,083073,Cheng; Tzu-Han,6,0,63,57
1657208964984,COGS 17,A01,092677,Semenuks; Arturs,4,0,81,77
1657208971029,COGS 100,A01,083619,Allen; Michael Gordon,15,0,70,55
1657208977058,COGS 101A,A01,083621,Davis; Joshua Daniel,9,0,68,59
1657208983085,COGS 101B,A01,091572,Allen; Michael Gordon,9,0,65,56
1657208989123,COGS 101C,A01,083625,Delgado; Tania,17,0,35,18
1657208995166,COGS 107A,A01,083627,Boyle; Mary E. T.,13,0,60,47
1657209001214,COGS 118A,A01,083075,Gupta; Anjum,16,0,76,60
1657209007238,CSE 3,A50,083646,Miranda; Gregory Joseph,24,0,50,26
1657209013271,CSE 8A,A50,083650,Miranda; Gregory Joseph,17,1,56,39
1657209019294,CSE 11,A01,083080,Cao; Yingjun,5,15,40,35
1657209025318,CSE 12,A01,083652,Krause-Levy; Sophia Louisa,24,1,120,96
1657209031350,CSE 15L,A01,083654,Morris; Justin Loren,9,0,50,41
1657209031350,CSE 15L,A02,083655,Morris; Justin Loren,9,0,50,41
1657209037397,CSE 20,A01,083657,Tran; Khoa Dang,38,0,80,42
1657209043422,CSE 21,A01,095574,Bach; Quang Tran,22,0,48,26
1657209049457,CSE 30,A01,083084,Eldon; John,4,0,80,76
1657209049457,CSE 30,B01,095061,Bhaskar; Nishant,7,0,50,43
1657209055481,CSE 100,A01,083659,Cao; Yingjun,4,4,70,66
1657209061508,CSE 134B,A01,083661,Powell; Thomas Allan,20,0,100,80
1657209067545,CSE 140,A01,083663,Gungor; Onat,13,0,85,72
1657209073646,CSE 140L,A01,083088,Eldon; John,17,0,100,83
1657209079682,CSE 175,A01,083665,Kumar; Rakesh,3,0,25,22
1657209085707,CSE 190,A00,092507,Dubnov; Shlomo,7,0,20,13
1657209091750,ECE 45,A01,083139,Congero; Spencer William,5,0,75,70
1657209097774,ECE 65,A50,083695,Saad; Andrew S,12,0,30,18
1657209097774,ECE 65,A51,095125,Saad; Andrew S,25,0,26,1
1657209103802,ECE 109,A01,091882,Touri; Behrouz,19,0,70,51
1657209109843,ECE 180,A00,083140,Abi Samra; Nicholas Camill,1,0,30,29
1657209109843,ECE 180,B00,083141,Abi Samra; Nicholas Camill,0,0,30,30
1657209115869,MATH 10A,A01,083735,Patchell; Gregory David,2,0,30,28
1657209115869,MATH 10A,A02,083736,Patchell; Gregory David,20,0,30,10
1657209115869,MATH 10A,A03,083737,Patchell; Gregory David,16,0,30,14
1657209121915,MATH 10B,A01,083207,Lim; Seonhee,7,0,34,27
1657209121915,MATH 10B,A02,083208,Lim; Seonhee,9,0,35,26
1657209121915,MATH 10B,A03,093472,Lim; Seonhee,5,0,34,29
1657209121915,MATH 10B,B01,083739,Sinha; Shubham,10,0,30,20
1657209127940,MATH 18,A01,083743,Cinel; Cameron Alexander,6,0,30,24
1657209127940,MATH 18,A02,083744,Cinel; Cameron Alexander,15,0,30,15
1657209127940,MATH 18,A03,083745,Cinel; Cameron Alexander,8,0,30,22
1657209127940,MATH 18,B01,083748,Rideout; David Porter,4,0,37,33
1657209127940,MATH 18,B02,083749,Rideout; David Porter,4,0,36,32
1657209127940,MATH 18,B03,083750,Rideout; David Porter,2,0,37,35
1657209127940,MATH 18,B04,083751,Rideout; David Porter,5,0,36,31
1657209127940,MATH 18,B05,093473,Rideout; David Porter,5,0,36,31
1657209127940,MATH 18,B06,093474,Rideout; David Porter,5,0,36,31
1657209133964,MATH 20A,A01,083754,Zheng; Zequn,13,0,40,27
1657209139997,MATH 20B,A01,083756,Briones; Jor-el Thomas Caparas,2,0,36,34
1657209139997,MATH 20B,A02,083757,Briones; Jor-el Thomas Caparas,1,0,36,35
1657209139997,MATH 20B,A03,093475,Briones; Jor-el Thomas Caparas,1,0,36,35
1657209146035,MATH 20C,A01,083760,Briones; Jor-el Thomas Caparas,1,0,35,34
1657209146035,MATH 20C,A02,083761,Briones; Jor-el Thomas Caparas,8,0,35,27
1657209146035,MATH 20C,A03,093476,Briones; Jor-el Thomas Caparas,0,1,36,36
1657209146035,MATH 20C,B01,083762,Bach; Quang Tran,1,0,30,29
1657209152067,MATH 20D,A01,083765,Tran; Brian Kha,4,0,30,26
1657209152067,MATH 20D,A02,083766,Tran; Brian Kha,5,0,30,25
1657209152067,MATH 20D,A03,083767,Tran; Brian Kha,4,0,30,26
1657209158091,MATH 20E,A01,083771,Ganguly; Soumya,7,0,32,25
1657209158091,MATH 20E,A02,083772,Ganguly; Soumya,7,0,32,25
1657209158091,MATH 20E,B01,083773,Ciotti; Benjamin,19,0,35,16
1657209158091,MATH 20E,B02,083774,Ciotti; Benjamin,17,0,35,18
1657209164142,MATH 103A,A01,083777,Greenfeld; Be'Eri,2,0,36,34
1657209164142,MATH 103A,A02,083778,Greenfeld; Be'Eri,5,0,36,31
1657209164142,MATH 103A,A03,093561,Greenfeld; Be'Eri,4,0,36,32
1657209164142,MATH 103A,B01,083779,Greenfeld; Be'Eri,6,0,36,30
1657209164142,MATH 103A,B02,083780,Greenfeld; Be'Eri,3,0,36,33
1657209164142,MATH 103A,B03,093562,Greenfeld; Be'Eri,3,0,36,33
1657209170170,MATH 105,A01,085443,Carter; Anne Toulson,15,0,35,20
1657209170170,MATH 105,A02,093477,Carter; Anne Toulson,20,0,35,15
1657209176205,MATH 109,A01,083213,Ganzberger; Geoffrey Michael,2,0,34,32
1657209176205,MATH 109,A02,083214,Ganzberger; Geoffrey Michael,4,0,34,30
1657209176205,MATH 109,A03,093478,Ganzberger; Geoffrey Michael,2,0,34,32
1657209176205,MATH 109,B01,083215,Ganzberger; Geoffrey Michael,1,0,32,31
1657209176205,MATH 109,B02,083216,Ganzberger; Geoffrey Michael,1,0,32,31
1657209176205,MATH 109,B03,093479,Ganzberger; Geoffrey Michael,7,0,32,25
1657209182249,MATH 142A,A01,083219,Chow; Bennett,6,0,32,26
1657209182249,MATH 142A,A02,083220,Chow; Bennett,10,0,32,22
1657209182249,MATH 142A,A03,093480,Chow; Bennett,7,0,32,25
1657209182249,MATH 142A,B03,093481,Chow; Bennett,8,0,32,24
1657209182249,MATH 142A,B04,093558,Chow; Bennett,11,0,32,21
1657209182249,MATH 142A,B05,093559,Chow; Bennett,6,0,32,26
1657209188282,MATH 193A,A01,083224,Rotar; Vladimir,7,0,34,27
1657209188282,MATH 193A,A02,083225,Rotar; Vladimir,5,0,34,29
1657209188282,MATH 193A,A03,083781,Rotar; Vladimir,1,0,34,33
1657209188282,MATH 193A,A04,083782,Rotar; Vladimir,8,0,34,26
1657209188282,MATH 193A,A05,093482,Rotar; Vladimir,6,0,34,28
1657209194312,MATH 197,001,091859,McAuley; Julian John,9999,0,9999,0
1657209194312,MATH 197,002,095566,Kedlaya; Kiran S.,9997,0,9999,2
1657209194312,MATH 197,003,095567,Xiao; Ming,9999,0,9999,0
1657209194312,MATH 197,004,095571,Perols; Johan Lars,9998,0,9999,1
1657209201394,COGS 9,A01,083615,Shannon; Kyle Michael,7,0,75,68
1657209207426,COGS 11,A01,083617,Boyle; Mary E. T.,22,0,48,26
1657209213463,COGS 13,A01,083071,Bastos; Amalia Pinkusfeld,9,0,71,62
1657209219502,COGS 14A,A01,092681,Semenuks; Arturs,1,1,100,99
1657209225526,COGS 14B,A01,083073,Cheng; Tzu-Han,6,0,63,57
1657209231576,COGS 17,A01,092677,Semenuks; Arturs,4,0,81,77
1657209237618,COGS 100,A01,083619,Allen; Michael Gordon,15,0,70,55
1657209243645,COGS 101A,A01,083621,Davis; Joshua Daniel,9,0,68,59
1657209249669,COGS 101B,A01,091572,Allen; Michael Gordon,9,0,65,56
1657209255693,COGS 101C,A01,083625,Delgado; Tania,17,0,35,18
1657209261724,COGS 107A,A01,083627,Boyle; Mary E. T.,13,0,60,47
1657209267771,COGS 118A,A01,083075,Gupta; Anjum,16,0,76,60
1657209273823,CSE 3,A50,083646,Miranda; Gregory Joseph,24,0,50,26
1657209279848,CSE 8A,A50,083650,Miranda; Gregory Joseph,17,1,56,39
1657209285905,CSE 11,A01,083080,Cao; Yingjun,5,15,40,35
1657209291937,CSE 12,A01,083652,Krause-Levy; Sophia Louisa,24,1,120,96
1657209297967,CSE 15L,A01,083654,Morris; Justin Loren,9,0,50,41
1657209297967,CSE 15L,A02,083655,Morris; Justin Loren,9,0,50,41
1657209303993,CSE 20,A01,083657,Tran; Khoa Dang,38,0,80,42
1657209310019,CSE 21,A01,095574,Bach; Quang Tran,22,0,48,26
1657209316090,CSE 30,A01,083084,Eldon; John,4,0,80,76
1657209316090,CSE 30,B01,095061,Bhaskar; Nishant,7,0,50,43
1657209322121,CSE 100,A01,083659,Cao; Yingjun,4,4,70,66
1657209328144,CSE 134B,A01,083661,Powell; Thomas Allan,20,0,100,80
1657209334174,CSE 140,A01,083663,Gungor; Onat,13,0,85,72
1657209340213,CSE 140L,A01,083088,Eldon; John,17,0,100,83
1657209346261,CSE 175,A01,083665,Kumar; Rakesh,3,0,25,22
1657209352298,CSE 190,A00,092507,Dubnov; Shlomo,7,0,20,13
1657209358343,ECE 45,A01,083139,Congero; Spencer William,5,0,75,70
1657209364397,ECE 65,A50,083695,Saad; Andrew S,12,0,30,18
1657209364397,ECE 65,A51,095125,Saad; Andrew S,25,0,26,1
1657209370422,ECE 109,A01,091882,Touri; Behrouz,19,0,70,51
1657209376446,ECE 180,A00,083140,Abi Samra; Nicholas Camill,1,0,30,29
1657209376446,ECE 180,B00,083141,Abi Samra; Nicholas Camill,0,0,30,30
1657209382469,MATH 10A,A01,083735,Patchell; Gregory David,2,0,30,28
1657209382469,MATH 10A,A02,083736,Patchell; Gregory David,20,0,30,10
1657209382469,MATH 10A,A03,083737,Patchell; Gregory David,16,0,30,14
1657209388505,MATH 10B,A01,083207,Lim; Seonhee,7,0,34,27
1657209388505,MATH 10B,A02,083208,Lim; Seonhee,9,0,35,26
1657209388505,MATH 10B,A03,093472,Lim; Seonhee,5,0,34,29
1657209388505,MATH 10B,B01,083739,Sinha; Shubham,10,0,30,20
1657209394554,MATH 18,A01,083743,Cinel; Cameron Alexander,6,0,30,24
1657209394554,MATH 18,A02,083744,Cinel; Cameron Alexander,15,0,30,15
1657209394554,MATH 18,A03,083745,Cinel; Cameron Alexander,8,0,30,22
1657209394554,MATH 18,B01,083748,Rideout; David Porter,4,0,37,33
1657209394554,MATH 18,B02,083749,Rideout; David Porter,4,0,36,32
1657209394554,MATH 18,B03,083750,Rideout; David Porter,2,0,37,35
1657209394554,MATH 18,B04,083751,Rideout; David Porter,5,0,36,31
1657209394554,MATH 18,B05,093473,Rideout; David Porter,5,0,36,31
1657209394554,MATH 18,B06,093474,Rideout; David Porter,5,0,36,31
1657209400590,MATH 20A,A01,083754,Zheng; Zequn,13,0,40,27
1657209406619,MATH 20B,A01,083756,Briones; Jor-el Thomas Caparas,2,0,36,34
1657209406619,MATH 20B,A02,083757,Briones; Jor-el Thomas Caparas,1,0,36,35
1657209406619,MATH 20B,A03,093475,Briones; Jor-el Thomas Caparas,1,0,36,35
1657209412668,MATH 20C,A01,083760,Briones; Jor-el Thomas Caparas,1,0,35,34
1657209412668,MATH 20C,A02,083761,Briones; Jor-el Thomas Caparas,8,0,35,27
1657209412668,MATH 20C,A03,093476,Briones; Jor-el Thomas Caparas,0,1,36,36
1657209412668,MATH 20C,B01,083762,Bach; Quang Tran,1,0,30,29
1657209418706,MATH 20D,A01,083765,Tran; Brian Kha,4,0,30,26
1657209418706,MATH 20D,A02,083766,Tran; Brian Kha,5,0,30,25
1657209418706,MATH 20D,A03,083767,Tran; Brian Kha,4,0,30,26
1657209424734,MATH 20E,A01,083771,Ganguly; Soumya,7,0,32,25
1657209424734,MATH 20E,A02,083772,Ganguly; Soumya,7,0,32,25
1657209424734,MATH 20E,B01,083773,Ciotti; Benjamin,19,0,35,16
1657209424734,MATH 20E,B02,083774,Ciotti; Benjamin,17,0,35,18
1657209430758,MATH 103A,A01,083777,Greenfeld; Be'Eri,2,0,36,34
1657209430758,MATH 103A,A02,083778,Greenfeld; Be'Eri,5,0,36,31
1657209430758,MATH 103A,A03,093561,Greenfeld; Be'Eri,4,0,36,32
1657209430758,MATH 103A,B01,083779,Greenfeld; Be'Eri,6,0,36,30
1657209430758,MATH 103A,B02,083780,Greenfeld; Be'Eri,3,0,36,33
1657209430758,MATH 103A,B03,093562,Greenfeld; Be'Eri,3,0,36,33
1657209436805,MATH 105,A01,085443,Carter; Anne Toulson,15,0,35,20
1657209436805,MATH 105,A02,093477,Carter; Anne Toulson,20,0,35,15
1657209442833,MATH 109,A01,083213,Ganzberger; Geoffrey Michael,2,0,34,32
1657209442833,MATH 109,A02,083214,Ganzberger; Geoffrey Michael,4,0,34,30
1657209442833,MATH 109,A03,093478,Ganzberger; Geoffrey Michael,2,0,34,32
1657209442833,MATH 109,B01,083215,Ganzberger; Geoffrey Michael,1,0,32,31
1657209442833,MATH 109,B02,083216,Ganzberger; Geoffrey Michael,1,0,32,31
1657209442833,MATH 109,B03,093479,Ganzberger; Geoffrey Michael,7,0,32,25
1657209448869,MATH 142A,A01,083219,Chow; Bennett,6,0,32,26
1657209448869,MATH 142A,A02,083220,Chow; Bennett,10,0,32,22
1657209448869,MATH 142A,A03,093480,Chow; Bennett,7,0,32,25
1657209448869,MATH 142A,B03,093481,Chow; Bennett,8,0,32,24
1657209448869,MATH 142A,B04,093558,Chow; Bennett,11,0,32,21
1657209448869,MATH 142A,B05,093559,Chow; Bennett,6,0,32,26
1657209454908,MATH 193A,A01,083224,Rotar; Vladimir,7,0,34,27
1657209454908,MATH 193A,A02,083225,Rotar; Vladimir,5,0,34,29
1657209454908,MATH 193A,A03,083781,Rotar; Vladimir,1,0,34,33
1657209454908,MATH 193A,A04,083782,Rotar; Vladimir,8,0,34,26
1657209454908,MATH 193A,A05,093482,Rotar; Vladimir,6,0,34,28
1657209460969,MATH 197,001,091859,McAuley; Julian John,9999,0,9999,0
1657209460969,MATH 197,002,095566,Kedlaya; Kiran S.,9997,0,9999,2
1657209460969,MATH 197,003,095567,Xiao; Ming,9999,0,9999,0
1657209460969,MATH 197,004,095571,Perols; Johan Lars,9998,0,9999,1
1657209468043,COGS 9,A01,083615,Shannon; Kyle Michael,7,0,75,68
1657209474073,COGS 11,A01,083617,Boyle; Mary E. T.,22,0,48,26
1657209480101,COGS 13,A01,083071,Bastos; Amalia Pinkusfeld,9,0,71,62
1657209486131,COGS 14A,A01,092681,Semenuks; Arturs,1,1,100,99
1657209492162,COGS 14B,A01,083073,Cheng; Tzu-Han,6,0,63,57
1657209498201,COGS 17,A01,092677,Semenuks; Arturs,4,0,81,77
1657209504249,COGS 100,A01,083619,Allen; Michael Gordon,15,0,70,55
1657209510307,COGS 101A,A01,083621,Davis; Joshua Daniel,9,0,68,59
1657209516359,COGS 101B,A01,091572,Allen; Michael Gordon,9,0,65,56
1657209522401,COGS 101C,A01,083625,Delgado; Tania,17,0,35,18
1657209528439,COGS 107A,A01,083627,Boyle; Mary E. T.,13,0,60,47
1657209534487,COGS 118A,A01,083075,Gupta; Anjum,16,0,76,60
1657209540539,CSE 3,A50,083646,Miranda; Gregory Joseph,24,0,50,26
1657209546581,CSE 8A,A50,083650,Miranda; Gregory Joseph,17,1,56,39
1657209552637,CSE 11,A01,083080,Cao; Yingjun,5,15,40,35
1657209558666,CSE 12,A01,083652,Krause-Levy; Sophia Louisa,24,1,120,96
1657209564720,CSE 15L,A01,083654,Morris; Justin Loren,9,0,50,41
1657209564720,CSE 15L,A02,083655,Morris; Justin Loren,9,0,50,41
1657209570751,CSE 20,A01,083657,Tran; Khoa Dang,38,0,80,42
1657209576781,CSE 21,A01,095574,Bach; Quang Tran,22,0,48,26
1657209582824,CSE 30,A01,083084,Eldon; John,4,0,80,76
1657209582824,CSE 30,B01,095061,Bhaskar; Nishant,7,0,50,43
1657209588847,CSE 100,A01,083659,Cao; Yingjun,4,4,70,66
1657209594901,CSE 134B,A01,083661,Powell; Thomas Allan,20,0,100,80
1657209600936,CSE 140,A01,083663,Gungor; Onat,13,0,85,72
1657209606982,CSE 140L,A01,083088,Eldon; John,17,0,100,83
1657209613012,CSE 175,A01,083665,Kumar; Rakesh,3,0,25,22
1657209619042,CSE 190,A00,092507,Dubnov; Shlomo,7,0,20,13
1657209625067,ECE 45,A01,083139,Congero; Spencer William,5,0,75,70
1657209631114,ECE 65,A50,083695,Saad; Andrew S,12,0,30,18
1657209631114,ECE 65,A51,095125,Saad; Andrew S,25,0,26,1
1657209637138,ECE 109,A01,091882,Touri; Behrouz,19,0,70,51
1657209643161,ECE 180,A00,083140,Abi Samra; Nicholas Camill,1,0,30,29
1657209643161,ECE 180,B00,083141,Abi Samra; Nicholas Camill,0,0,30,30
1657209649189,MATH 10A,A01,083735,Patchell; Gregory David,2,0,30,28
1657209649189,MATH 10A,A02,083736,Patchell; Gregory David,20,0,30,10
1657209649189,MATH 10A,A03,083737,Patchell; Gregory David,16,0,30,14
1657209655222,MATH 10B,A01,083207,Lim; Seonhee,7,0,34,27
1657209655222,MATH 10B,A02,083208,Lim; Seonhee,9,0,35,26
1657209655222,MATH 10B,A03,093472,Lim; Seonhee,5,0,34,29
1657209655222,MATH 10B,B01,083739,Sinha; Shubham,10,0,30,20
1657209661263,MATH 18,A01,083743,Cinel; Cameron Alexander,6,0,30,24
1657209661263,MATH 18,A02,083744,Cinel; Cameron Alexander,15,0,30,15
1657209661263,MATH 18,A03,083745,Cinel; Cameron Alexander,8,0,30,22
1657209661263,MATH 18,B01,083748,Rideout; David Porter,4,0,37,33
1657209661263,MATH 18,B02,083749,Rideout; David Porter,4,0,36,32
1657209661263,MATH 18,B03,083750,Rideout; David Porter,2,0,37,35
1657209661263,MATH 18,B04,083751,Rideout; David Porter,5,0,36,31
1657209661263,MATH 18,B05,093473,Rideout; David Porter,5,0,36,31
1657209661263,MATH 18,B06,093474,Rideout; David Porter,5,0,36,31
1657209667311,MATH 20A,A01,083754,Zheng; Zequn,13,0,40,27
1657209673444,MATH 20B,A01,083756,Briones; Jor-el Thomas Caparas,2,0,36,34
1657209673444,MATH 20B,A02,083757,Briones; Jor-el Thomas Caparas,1,0,36,35
1657209673444,MATH 20B,A03,093475,Briones; Jor-el Thomas Caparas,1,0,36,35
1657209679472,MATH 20C,A01,083760,Briones; Jor-el Thomas Caparas,1,0,35,34
1657209679472,MATH 20C,A02,083761,Briones; Jor-el Thomas Caparas,8,0,35,27
1657209679472,MATH 20C,A03,093476,Briones; Jor-el Thomas Caparas,0,1,36,36
1657209679472,MATH 20C,B01,083762,Bach; Quang Tran,1,0,30,29
1657209685506,MATH 20D,A01,083765,Tran; Brian Kha,4,0,30,26
1657209685506,MATH 20D,A02,083766,Tran; Brian Kha,5,0,30,25
1657209685506,MATH 20D,A03,083767,Tran; Brian Kha,4,0,30,26
1657209691550,MATH 20E,A01,083771,Ganguly; Soumya,7,0,32,25
1657209691550,MATH 20E,A02,083772,Ganguly; Soumya,7,0,32,25
1657209691550,MATH 20E,B01,083773,Ciotti; Benjamin,19,0,35,16
1657209691550,MATH 20E,B02,083774,Ciotti; Benjamin,17,0,35,18
1657209697600,MATH 103A,A01,083777,Greenfeld; Be'Eri,2,0,36,34
1657209697600,MATH 103A,A02,083778,Greenfeld; Be'Eri,5,0,36,31
1657209697600,MATH 103A,A03,093561,Greenfeld; Be'Eri,4,0,36,32
1657209697600,MATH 103A,B01,083779,Greenfeld; Be'Eri,6,0,36,30
1657209697600,MATH 103A,B02,083780,Greenfeld; Be'Eri,3,0,36,33
1657209697600,MATH 103A,B03,093562,Greenfeld; Be'Eri,3,0,36,33
1657209703630,MATH 105,A01,085443,Carter; Anne Toulson,15,0,35,20
1657209703630,MATH 105,A02,093477,Carter; Anne Toulson,20,0,35,15
1657209709680,MATH 109,A01,083213,Ganzberger; Geoffrey Michael,2,0,34,32
1657209709680,MATH 109,A02,083214,Ganzberger; Geoffrey Michael,4,0,34,30
1657209709680,MATH 109,A03,093478,Ganzberger; Geoffrey Michael,2,0,34,32
1657209709680,MATH 109,B01,083215,Ganzberger; Geoffrey Michael,1,0,32,31
1657209709680,MATH 109,B02,083216,Ganzberger; Geoffrey Michael,1,0,32,31
1657209709680,MATH 109,B03,093479,Ganzberger; Geoffrey Michael,7,0,32,25
1657209715724,MATH 142A,A01,083219,Chow; Bennett,6,0,32,26
1657209715724,MATH 142A,A02,083220,Chow; Bennett,10,0,32,22
1657209715724,MATH 142A,A03,093480,Chow; Bennett,7,0,32,25
1657209715724,MATH 142A,B03,093481,Chow; Bennett,8,0,32,24
1657209715724,MATH 142A,B04,093558,Chow; Bennett,11,0,32,21
1657209715724,MATH 142A,B05,093559,Chow; Bennett,6,0,32,26
1657209721785,MATH 193A,A01,083224,Rotar; Vladimir,7,0,34,27
1657209721785,MATH 193A,A02,083225,Rotar; Vladimir,5,0,34,29
1657209721785,MATH 193A,A03,083781,Rotar; Vladimir,1,0,34,33
1657209721785,MATH 193A,A04,083782,Rotar; Vladimir,8,0,34,26
1657209721785,MATH 193A,A05,093482,Rotar; Vladimir,6,0,34,28
1657209727823,MATH 197,001,091859,McAuley; Julian John,9999,0,9999,0
1657209727823,MATH 197,002,095566,Kedlaya; Kiran S.,9997,0,9999,2
1657209727823,MATH 197,003,095567,Xiao; Ming,9999,0,9999,0
1657209727823,MATH 197,004,095571,Perols; Johan Lars,9998,0,9999,1
1657209734903,COGS 9,A01,083615,Shannon; Kyle Michael,7,0,75,68
1657209740942,COGS 11,A01,083617,Boyle; Mary E. T.,22,0,48,26
1657209746996,COGS 13,A01,083071,Bastos; Amalia Pinkusfeld,9,0,71,62
1657209753047,COGS 14A,A01,092681,Semenuks; Arturs,1,1,100,99
1657209759096,COGS 14B,A01,083073,Cheng; Tzu-Han,6,0,63,57
1657209765124,COGS 17,A01,092677,Semenuks; Arturs,4,0,81,77
1657209771161,COGS 100,A01,083619,Allen; Michael Gordon,15,0,70,55
1657209777187,COGS 101A,A01,083621,Davis; Joshua Daniel,9,0,68,59
1657209783240,COGS 101B,A01,091572,Allen; Michael Gordon,9,0,65,56
1657209789268,COGS 101C,A01,083625,Delgado; Tania,17,0,35,18
1657209795305,COGS 107A,A01,083627,Boyle; Mary E. T.,13,0,60,47
1657209801341,COGS 118A,A01,083075,Gupta; Anjum,16,0,76,60
1657209807390,CSE 3,A50,083646,Miranda; Gregory Joseph,24,0,50,26
1657209813414,CSE 8A,A50,083650,Miranda; Gregory Joseph,17,1,56,39
1657209819438,CSE 11,A01,083080,Cao; Yingjun,5,15,40,35
1657209825474,CSE 12,A01,083652,Krause-Levy; Sophia Louisa,24,1,120,96
1657209831498,CSE 15L,A01,083654,Morris; Justin Loren,9,0,50,41
1657209831498,CSE 15L,A02,083655,Morris; Justin Loren,9,0,50,41
1657209837535,CSE 20,A01,083657,Tran; Khoa Dang,38,0,80,42
1657209843561,CSE 21,A01,095574,Bach; Quang Tran,22,0,48,26
1657209849586,CSE 30,A01,083084,Eldon; John,4,0,80,76
1657209849586,CSE 30,B01,095061,Bhaskar; Nishant,7,0,50,43
1657209855642,CSE 100,A01,083659,Cao; Yingjun,4,4,70,66
1657209861683,CSE 134B,A01,083661,Powell; Thomas Allan,20,0,100,80
1657209867711,CSE 140,A01,083663,Gungor; Onat,13,0,85,72
1657209873747,CSE 140L,A01,083088,Eldon; John,17,0,100,83
1657209879783,CSE 175,A01,083665,Kumar; Rakesh,3,0,25,22
1657209885808,CSE 190,A00,092507,Dubnov; Shlomo,7,0,20,13
1657209891844,ECE 45,A01,083139,Congero; Spencer William,5,0,75,70
1657209897870,ECE 65,A50,083695,Saad; Andrew S,12,0,30,18
1657209897870,ECE 65,A51,095125,Saad; Andrew S,25,0,26,1
1657209903933,ECE 109,A01,091882,Touri; Behrouz,19,0,70,51
1657209909967,ECE 180,A00,083140,Abi Samra; Nicholas Camill,1,0,30,29
1657209909967,ECE 180,B00,083141,Abi Samra; Nicholas Camill,0,0,30,30
1657209916008,MATH 10A,A01,083735,Patchell; Gregory David,2,0,30,28
1657209916008,MATH 10A,A02,083736,Patchell; Gregory David,20,0,30,10
1657209916008,MATH 10A,A03,083737,Patchell; Gregory David,16,0,30,14
1657209922045,MATH 10B,A01,083207,Lim; Seonhee,7,0,34,27
1657209922045,MATH 10B,A02,083208,Lim; Seonhee,9,0,35,26
1657209922045,MATH 10B,A03,093472,Lim; Seonhee,5,0,34,29
1657209922045,MATH 10B,B01,083739,Sinha; Shubham,10,0,30,20
1657209928094,MATH 18,A01,083743,Cinel; Cameron Alexander,6,0,30,24
1657209928094,MATH 18,A02,083744,Cinel; Cameron Alexander,15,0,30,15
1657209928094,MATH 18,A03,083745,Cinel; Cameron Alexander,8,0,30,22
1657209928094,MATH 18,B01,083748,Rideout; David Porter,4,0,37,33
1657209928094,MATH 18,B02,083749,Rideout; David Porter,4,0,36,32
1657209928094,MATH 18,B03,083750,Rideout; David Porter,2,0,37,35
1657209928094,MATH 18,B04,083751,Rideout; David Porter,5,0,36,31
1657209928094,MATH 18,B05,093473,Rideout; David Porter,5,0,36,31
1657209928094,MATH 18,B06,093474,Rideout; David Porter,5,0,36,31
1657209934119,MATH 20A,A01,083754,Zheng; Zequn,13,0,40,27
1657209940152,MATH 20B,A01,083756,Briones; Jor-el Thomas Caparas,2,0,36,34
1657209940152,MATH 20B,A02,083757,Briones; Jor-el Thomas Caparas,1,0,36,35
1657209940152,MATH 20B,A03,093475,Briones; Jor-el Thomas Caparas,1,0,36,35
1657209946190,MATH 20C,A01,083760,Briones; Jor-el Thomas Caparas,1,0,35,34
1657209946190,MATH 20C,A02,083761,Briones; Jor-el Thomas Caparas,8,0,35,27
1657209946190,MATH 20C,A03,093476,Briones; Jor-el Thomas Caparas,0,1,36,36
1657209946190,MATH 20C,B01,083762,Bach; Quang Tran,1,0,30,29
1657209952233,MATH 20D,A01,083765,Tran; Brian Kha,4,0,30,26
1657209952233,MATH 20D,A02,083766,Tran; Brian Kha,5,0,30,25
1657209952233,MATH 20D,A03,083767,Tran; Brian Kha,4,0,30,26
1657209958264,MATH 20E,A01,083771,Ganguly; Soumya,7,0,32,25
1657209958264,MATH 20E,A02,083772,Ganguly; Soumya,7,0,32,25
1657209958264,MATH 20E,B01,083773,Ciotti; Benjamin,19,0,35,16
1657209958264,MATH 20E,B02,083774,Ciotti; Benjamin,17,0,35,18
1657209964295,MATH 103A,A01,083777,Greenfeld; Be'Eri,2,0,36,34
1657209964295,MATH 103A,A02,083778,Greenfeld; Be'Eri,5,0,36,31
1657209964295,MATH 103A,A03,093561,Greenfeld; Be'Eri,4,0,36,32
1657209964295,MATH 103A,B01,083779,Greenfeld; Be'Eri,6,0,36,30
1657209964295,MATH 103A,B02,083780,Greenfeld; Be'Eri,3,0,36,33
1657209964295,MATH 103A,B03,093562,Greenfeld; Be'Eri,3,0,36,33
1657209970320,MATH 105,A01,085443,Carter; Anne Toulson,15,0,35,20
1657209970320,MATH 105,A02,093477,Carter; Anne Toulson,20,0,35,15
1657209976354,MATH 109,A01,083213,Ganzberger; Geoffrey Michael,2,0,34,32
1657209976354,MATH 109,A02,083214,Ganzberger; Geoffrey Michael,4,0,34,30
1657209976354,MATH 109,A03,093478,Ganzberger; Geoffrey Michael,2,0,34,32
1657209976354,MATH 109,B01,083215,Ganzberger; Geoffrey Michael,1,0,32,31
1657209976354,MATH 109,B02,083216,Ganzberger; Geoffrey Michael,1,0,32,31
1657209976354,MATH 109,B03,093479,Ganzberger; Geoffrey Michael,7,0,32,25
1657209982394,MATH 142A,A01,083219,Chow; Bennett,6,0,32,26
1657209982394,MATH 142A,A02,083220,Chow; Bennett,10,0,32,22
1657209982394,MATH 142A,A03,093480,Chow; Bennett,7,0,32,25
1657209982394,MATH 142A,B03,093481,Chow; Bennett,8,0,32,24
1657209982394,MATH 142A,B04,093558,Chow; Bennett,11,0,32,21
1657209982394,MATH 142A,B05,093559,Chow; Bennett,6,0,32,26
1657209988419,MATH 193A,A01,083224,Rotar; Vladimir,7,0,34,27
1657209988419,MATH 193A,A02,083225,Rotar; Vladimir,5,0,34,29
1657209988419,MATH 193A,A03,083781,Rotar; Vladimir,1,0,34,33
1657209988419,MATH 193A,A04,083782,Rotar; Vladimir,8,0,34,26
1657209988419,MATH 193A,A05,093482,Rotar; Vladimir,6,0,34,28
1657209994461,MATH 197,001,091859,McAuley; Julian John,9999,0,9999,0
1657209994461,MATH 197,002,095566,Kedlaya; Kiran S.,9997,0,9999,2
1657209994461,MATH 197,003,095567,Xiao; Ming,9999,0,9999,0
1657209994461,MATH 197,004,095571,Perols; Johan Lars,9998,0,9999,1
1657210001519,COGS 9,A01,083615,Shannon; Kyle Michael,7,0,75,68
1657210007546,COGS 11,A01,083617,Boyle; Mary E. T.,22,0,48,26
1657210013574,COGS 13,A01,083071,Bastos; Amalia Pinkusfeld,9,0,71,62
1657210019599,COGS 14A,A01,092681,Semenuks; Arturs,1,1,100,99
1657210025624,COGS 14B,A01,083073,Cheng; Tzu-Han,6,0,63,57
1657210031646,COGS 17,A01,092677,Semenuks; Arturs,4,0,81,77
1657210037694,COGS 100,A01,083619,Allen; Michael Gordon,15,0,70,55
1657210043742,COGS 101A,A01,083621,Davis; Joshua Daniel,9,0,68,59
1657210049770,COGS 101B,A01,091572,Allen; Michael Gordon,9,0,65,56
1657210055795,COGS 101C,A01,083625,Delgado; Tania,17,0,35,18
1657210061819,COGS 107A,A01,083627,Boyle; Mary E. T.,13,0,60,47
1657210067858,COGS 118A,A01,083075,Gupta; Anjum,16,0,76,60
1657210073888,CSE 3,A50,083646,Miranda; Gregory Joseph,24,0,50,26
1657210079913,CSE 8A,A50,083650,Miranda; Gregory Joseph,17,1,56,39
1657210085946,CSE 11,A01,083080,Cao; Yingjun,5,15,40,35
1657210091971,CSE 12,A01,083652,Krause-Levy; Sophia Louisa,24,1,120,96
1657210097998,CSE 15L,A01,083654,Morris; Justin Loren,9,0,50,41
1657210097998,CSE 15L,A02,083655,Morris; Justin Loren,9,0,50,41
1657210104021,CSE 20,A01,083657,Tran; Khoa Dang,38,0,80,42
1657210110049,CSE 21,A01,095574,Bach; Quang Tran,22,0,48,26
1657210116078,CSE 30,A01,083084,Eldon; John,4,0,80,76
1657210116078,CSE 30,B01,095061,Bhaskar; Nishant,7,0,50,43
1657210122123,CSE 100,A01,083659,Cao; Yingjun,4,4,70,66
1657210128157,CSE 134B,A01,083661,Powell; Thomas Allan,20,0,100,80
1657210134179,CSE 140,A01,083663,Gungor; Onat,13,0,85,72
1657210140286,CSE 140L,A01,083088,Eldon; John,17,0,100,83
1657210146321,CSE 175,A01,083665,Kumar; Rakesh,3,0,25,22
1657210152356,CSE 190,A00,092507,Dubnov; Shlomo,7,0,20,13
1657210158388,ECE 45,A01,083139,Congero; Spencer William,5,0,75,70
1657210164436,ECE 65,A50,083695,Saad; Andrew S,12,0,30,18
1657210164436,ECE 65,A51,095125,Saad; Andrew S,25,0,26,1
1657210170470,ECE 109,A01,091882,Touri; Behrouz,19,0,70,51
1657210176502,ECE 180,A00,083140,Abi Samra; Nicholas Camill,1,0,30,29
1657210176502,ECE 180,B00,083141,Abi Samra; Nicholas Camill,0,0,30,30
1657210182540,MATH 10A,A01,083735,Patchell; Gregory David,2,0,30,28
1657210182540,MATH 10A,A02,083736,Patchell; Gregory David,20,0,30,10
1657210182540,MATH 10A,A03,083737,Patchell; Gregory David,16,0,30,14
1657210188573,MATH 10B,A01,083207,Lim; Seonhee,7,0,34,27
1657210188573,MATH 10B,A02,083208,Lim; Seonhee,9,0,35,26
1657210188573,MATH 10B,A03,093472,Lim; Seonhee,5,0,34,29
1657210188573,MATH 10B,B01,083739,Sinha; Shubham,10,0,30,20
1657210194609,MATH 18,A01,083743,Cinel; Cameron Alexander,6,0,30,24
1657210194609,MATH 18,A02,083744,Cinel; Cameron Alexander,15,0,30,15
1657210194609,MATH 18,A03,083745,Cinel; Cameron Alexander,8,0,30,22
1657210194609,MATH 18,B01,083748,Rideout; David Porter,4,0,37,33
1657210194609,MATH 18,B02,083749,Rideout; David Porter,4,0,36,32
1657210194609,MATH 18,B03,083750,Rideout; David Porter,2,0,37,35
1657210194609,MATH 18,B04,083751,Rideout; David Porter,5,0,36,31
1657210194609,MATH 18,B05,093473,Rideout; David Porter,5,0,36,31
1657210194609,MATH 18,B06,093474,Rideout; David Porter,5,0,36,31
1657210200644,MATH 20A,A01,083754,Zheng; Zequn,13,0,40,27
1657210206684,MATH 20B,A01,083756,Briones; Jor-el Thomas Caparas,2,0,36,34
1657210206684,MATH 20B,A02,083757,Briones; Jor-el Thomas Caparas,1,0,36,35
1657210206684,MATH 20B,A03,093475,Briones; Jor-el Thomas Caparas,1,0,36,35
1657210212725,MATH 20C,A01,083760,Briones; Jor-el Thomas Caparas,1,0,35,34
1657210212725,MATH 20C,A02,083761,Briones; Jor-el Thomas Caparas,8,0,35,27
1657210212725,MATH 20C,A03,093476,Briones; Jor-el Thomas Caparas,0,1,36,36
1657210212725,MATH 20C,B01,083762,Bach; Quang Tran,1,0,30,29
1657210218775,MATH 20D,A01,083765,Tran; Brian Kha,4,0,30,26
1657210218775,MATH 20D,A02,083766,Tran; Brian Kha,5,0,30,25
1657210218775,MATH 20D,A03,083767,Tran; Brian Kha,4,0,30,26
1657210224817,MATH 20E,A01,083771,Ganguly; Soumya,7,0,32,25
1657210224817,MATH 20E,A02,083772,Ganguly; Soumya,7,0,32,25
1657210224817,MATH 20E,B01,083773,Ciotti; Benjamin,19,0,35,16
1657210224817,MATH 20E,B02,083774,Ciotti; Benjamin,17,0,35,18
1657210230860,MATH 103A,A01,083777,Greenfeld; Be'Eri,2,0,36,34
1657210230860,MATH 103A,A02,083778,Greenfeld; Be'Eri,5,0,36,31
1657210230860,MATH 103A,A03,093561,Greenfeld; Be'Eri,4,0,36,32
1657210230860,MATH 103A,B01,083779,Greenfeld; Be'Eri,6,0,36,30
1657210230860,MATH 103A,B02,083780,Greenfeld; Be'Eri,3,0,36,33
1657210230860,MATH 103A,B03,093562,Greenfeld; Be'Eri,3,0,36,33
1657210236887,MATH 105,A01,085443,Carter; Anne Toulson,15,0,35,20
1657210236887,MATH 105,A02,093477,Carter; Anne Toulson,20,0,35,15
1657210242937,MATH 109,A01,083213,Ganzberger; Geoffrey Michael,2,0,34,32
1657210242937,MATH 109,A02,083214,Ganzberger; Geoffrey Michael,4,0,34,30
1657210242937,MATH 109,A03,093478,Ganzberger; Geoffrey Michael,2,0,34,32
1657210242937,MATH 109,B01,083215,Ganzberger; Geoffrey Michael,1,0,32,31
1657210242937,MATH 109,B02,083216,Ganzberger; Geoffrey Michael,1,0,32,31
1657210242937,MATH 109,B03,093479,Ganzberger; Geoffrey Michael,7,0,32,25
1657210249004,MATH 142A,A01,083219,Chow; Bennett,6,0,32,26
1657210249004,MATH 142A,A02,083220,Chow; Bennett,10,0,32,22
1657210249004,MATH 142A,A03,093480,Chow; Bennett,7,0,32,25
1657210249004,MATH 142A,B03,093481,Chow; Bennett,8,0,32,24
1657210249004,MATH 142A,B04,093558,Chow; Bennett,11,0,32,21
1657210249004,MATH 142A,B05,093559,Chow; Bennett,6,0,32,26
1657210255048,MATH 193A,A01,083224,Rotar; Vladimir,7,0,34,27
1657210255048,MATH 193A,A02,083225,Rotar; Vladimir,5,0,34,29
1657210255048,MATH 193A,A03,083781,Rotar; Vladimir,1,0,34,33
1657210255048,MATH 193A,A04,083782,Rotar; Vladimir,8,0,34,26
1657210255048,MATH 193A,A05,093482,Rotar; Vladimir,6,0,34,28
1657210261085,MATH 197,001,091859,McAuley; Julian John,9999,0,9999,0
1657210261085,MATH 197,002,095566,Kedlaya; Kiran S.,9997,0,9999,2
1657210261085,MATH 197,003,095567,Xiao; Ming,9999,0,9999,0
1657210261085,MATH 197,004,095571,Perols; Johan Lars,9998,0,9999,1
1657210268267,COGS 9,A01,083615,Shannon; Kyle Michael,7,0,75,68
1657210274291,COGS 11,A01,083617,Boyle; Mary E. T.,22,0,48,26
1657210280318,COGS 13,A01,083071,Bastos; Amalia Pinkusfeld,9,0,71,62
1657210286343,COGS 14A,A01,092681,Semenuks; Arturs,1,1,100,99
1657210292383,COGS 14B,A01,083073,Cheng; Tzu-Han,6,0,63,57
1657210298438,COGS 17,A01,092677,Semenuks; Arturs,4,0,81,77
1657210304468,COGS 100,A01,083619,Allen; Michael Gordon,15,0,70,55
1657210310506,COGS 101A,A01,083621,Davis; Joshua Daniel,9,0,68,59
1657210316536,COGS 101B,A01,091572,Allen; Michael Gordon,9,0,65,56
1657210322560,COGS 101C,A01,083625,Delgado; Tania,17,0,35,18
1657210328587,COGS 107A,A01,083627,Boyle; Mary E. T.,13,0,60,47
1657210334635,COGS 118A,A01,083075,Gupta; Anjum,16,0,76,60
1657210340678,CSE 3,A50,083646,Miranda; Gregory Joseph,24,0,50,26
1657210346706,CSE 8A,A50,083650,Miranda; Gregory Joseph,17,1,56,39
1657210352745,CSE 11,A01,083080,Cao; Yingjun,5,15,40,35
1657210358769,CSE 12,A01,083652,Krause-Levy; Sophia Louisa,24,1,120,96
1657210364793,CSE 15L,A01,083654,Morris; Justin Loren,9,0,50,41
1657210364793,CSE 15L,A02,083655,Morris; Justin Loren,9,0,50,41
1657210370817,CSE 20,A01,083657,Tran; Khoa Dang,38,0,80,42
1657210376861,CSE 21,A01,095574,Bach; Quang Tran,22,0,48,26
1657210382912,CSE 30,A01,083084,Eldon; John,4,0,80,76
1657210382912,CSE 30,B01,095061,Bhaskar; Nishant,7,0,50,43
1657210388952,CSE 100,A01,083659,Cao; Yingjun,4,4,70,66
1657210395006,CSE 134B,A01,083661,Powell; Thomas Allan,20,0,100,80
1657210401039,CSE 140,A01,083663,Gungor; Onat,13,0,85,72
1657210407073,CSE 140L,A01,083088,Eldon; John,17,0,100,83
1657210413107,CSE 175,A01,083665,Kumar; Rakesh,3,0,25,22
1657210419150,CSE 190,A00,092507,Dubnov; Shlomo,7,0,20,13
1657210425185,ECE 45,A01,083139,Congero; Spencer William,5,0,75,70
1657210431208,ECE 65,A50,083695,Saad; Andrew S,12,0,30,18
1657210431208,ECE 65,A51,095125,Saad; Andrew S,25,0,26,1
1657210437231,ECE 109,A01,091882,Touri; Behrouz,19,0,70,51
1657210443252,ECE 180,A00,083140,Abi Samra; Nicholas Camill,1,0,30,29
1657210443252,ECE 180,B00,083141,Abi Samra; Nicholas Camill,0,0,30,30
1657210449289,MATH 10A,A01,083735,Patchell; Gregory David,2,0,30,28
1657210449289,MATH 10A,A02,083736,Patchell; Gregory David,20,0,30,10
1657210449289,MATH 10A,A03,083737,Patchell; Gregory David,16,0,30,14
1657210455335,MATH 10B,A01,083207,Lim; Seonhee,7,0,34,27
1657210455335,MATH 10B,A02,083208,Lim; Seonhee,9,0,35,26
1657210455335,MATH 10B,A03,093472,Lim; Seonhee,5,0,34,29
1657210455335,MATH 10B,B01,083739,Sinha; Shubham,10,0,30,20
1657210461362,MATH 18,A01,083743,Cinel; Cameron Alexander,6,0,30,24
1657210461362,MATH 18,A02,083744,Cinel; Cameron Alexander,15,0,30,15
1657210461362,MATH 18,A03,083745,Cinel; Cameron Alexander,8,0,30,22
1657210461362,MATH 18,B01,083748,Rideout; David Porter,4,0,37,33
1657210461362,MATH 18,B02,083749,Rideout; David Porter,4,0,36,32
1657210461362,MATH 18,B03,083750,Rideout; David Porter,2,0,37,35
1657210461362,MATH 18,B04,083751,Rideout; David Porter,5,0,36,31
1657210461362,MATH 18,B05,093473,Rideout; David Porter,5,0,36,31
1657210461362,MATH 18,B06,093474,Rideout; David Porter,5,0,36,31
1657210467385,MATH 20A,A01,083754,Zheng; Zequn,13,0,40,27
1657210473427,MATH 20B,A01,083756,Briones; Jor-el Thomas Caparas,2,0,36,34
1657210473427,MATH 20B,A02,083757,Briones; Jor-el Thomas Caparas,1,0,36,35
1657210473427,MATH 20B,A03,093475,Briones; Jor-el Thomas Caparas,1,0,36,35
1657210479461,MATH 20C,A01,083760,Briones; Jor-el Thomas Caparas,1,0,35,34
1657210479461,MATH 20C,A02,083761,Briones; Jor-el Thomas Caparas,8,0,35,27
1657210479461,MATH 20C,A03,093476,Briones; Jor-el Thomas Caparas,0,1,36,36
1657210479461,MATH 20C,B01,083762,Bach; Quang Tran,1,0,30,29
1657210485489,MATH 20D,A01,083765,Tran; Brian Kha,4,0,30,26
1657210485489,MATH 20D,A02,083766,Tran; Brian Kha,5,0,30,25
1657210485489,MATH 20D,A03,083767,Tran; Brian Kha,4,0,30,26
1657210491539,MATH 20E,A01,083771,Ganguly; Soumya,7,0,32,25
1657210491539,MATH 20E,A02,083772,Ganguly; Soumya,7,0,32,25
1657210491539,MATH 20E,B01,083773,Ciotti; Benjamin,19,0,35,16
1657210491539,MATH 20E,B02,083774,Ciotti; Benjamin,17,0,35,18
1657210497569,MATH 103A,A01,083777,Greenfeld; Be'Eri,2,0,36,34
1657210497569,MATH 103A,A02,083778,Greenfeld; Be'Eri,5,0,36,31
1657210497569,MATH 103A,A03,093561,Greenfeld; Be'Eri,4,0,36,32
1657210497569,MATH 103A,B01,083779,Greenfeld; Be'Eri,6,0,36,30
1657210497569,MATH 103A,B02,083780,Greenfeld; Be'Eri,3,0,36,33
1657210497569,MATH 103A,B03,093562,Greenfeld; Be'Eri,3,0,36,33
1657210503601,MATH 105,A01,085443,Carter; Anne Toulson,15,0,35,20
1657210503601,MATH 105,A02,093477,Carter; Anne Toulson,20,0,35,15
1657210509642,MATH 109,A01,083213,Ganzberger; Geoffrey Michael,2,0,34,32
1657210509642,MATH 109,A02,083214,Ganzberger; Geoffrey Michael,4,0,34,30
1657210509642,MATH 109,A03,093478,Ganzberger; Geoffrey Michael,2,0,34,32
1657210509642,MATH 109,B01,083215,Ganzberger; Geoffrey Michael,1,0,32,31
1657210509642,MATH 109,B02,083216,Ganzberger; Geoffrey Michael,1,0,32,31
1657210509642,MATH 109,B03,093479,Ganzberger; Geoffrey Michael,7,0,32,25
1657210515691,MATH 142A,A01,083219,Chow; Bennett,6,0,32,26
1657210515691,MATH 142A,A02,083220,Chow; Bennett,10,0,32,22
1657210515691,MATH 142A,A03,093480,Chow; Bennett,7,0,32,25
1657210515691,MATH 142A,B03,093481,Chow; Bennett,8,0,32,24
1657210515691,MATH 142A,B04,093558,Chow; Bennett,11,0,32,21
1657210515691,MATH 142A,B05,093559,Chow; Bennett,6,0,32,26
1657210521718,MATH 193A,A01,083224,Rotar; Vladimir,7,0,34,27
1657210521718,MATH 193A,A02,083225,Rotar; Vladimir,5,0,34,29
1657210521718,MATH 193A,A03,083781,Rotar; Vladimir,1,0,34,33
1657210521718,MATH 193A,A04,083782,Rotar; Vladimir,8,0,34,26
1657210521718,MATH 193A,A05,093482,Rotar; Vladimir,6,0,34,28
1657210527760,MATH 197,001,091859,McAuley; Julian John,9999,0,9999,0
1657210527760,MATH 197,002,095566,Kedlaya; Kiran S.,9997,0,9999,2
1657210527760,MATH 197,003,095567,Xiao; Ming,9999,0,9999,0
1657210527760,MATH 197,004,095571,Perols; Johan Lars,9998,0,9999,1
1657210534863,COGS 9,A01,083615,Shannon; Kyle Michael,7,0,75,68
1657210540891,COGS 11,A01,083617,Boyle; Mary E. T.,22,0,48,26
1657210546941,COGS 13,A01,083071,Bastos; Amalia Pinkusfeld,9,0,71,62
1657210552965,COGS 14A,A01,092681,Semenuks; Arturs,1,1,100,99
1657210558994,COGS 14B,A01,083073,Cheng; Tzu-Han,6,0,63,57
1657210565029,COGS 17,A01,092677,Semenuks; Arturs,4,0,81,77
1657210571053,COGS 100,A01,083619,Allen; Michael Gordon,15,0,70,55
1657210577080,COGS 101A,A01,083621,Davis; Joshua Daniel,9,0,68,59
1657210583108,COGS 101B,A01,091572,Allen; Michael Gordon,9,0,65,56
1657210589139,COGS 101C,A01,083625,Delgado; Tania,17,0,35,18
1657210595171,COGS 107A,A01,083627,Boyle; Mary E. T.,13,0,60,47
1657210601209,COGS 118A,A01,083075,Gupta; Anjum,16,0,76,60
1657210607248,CSE 3,A50,083646,Miranda; Gregory Joseph,24,0,50,26
1657210613296,CSE 8A,A50,083650,Miranda; Gregory Joseph,17,1,56,39
1657210619337,CSE 11,A01,083080,Cao; Yingjun,5,15,40,35
1657210625368,CSE 12,A01,083652,Krause-Levy; Sophia Louisa,24,1,120,96
1657210631413,CSE 15L,A01,083654,Morris; Justin Loren,9,0,50,41
1657210631413,CSE 15L,A02,083655,Morris; Justin Loren,9,0,50,41
1657210637436,CSE 20,A01,083657,Tran; Khoa Dang,38,0,80,42
1657210643476,CSE 21,A01,095574,Bach; Quang Tran,22,0,48,26
1657210649505,CSE 30,A01,083084,Eldon; John,4,0,80,76
1657210649505,CSE 30,B01,095061,Bhaskar; Nishant,7,0,50,43
1657210655530,CSE 100,A01,083659,Cao; Yingjun,4,4,70,66
1657210661552,CSE 134B,A01,083661,Powell; Thomas Allan,20,0,100,80
1657210667578,CSE 140,A01,083663,Gungor; Onat,13,0,85,72
1657210673611,CSE 140L,A01,083088,Eldon; John,17,0,100,83
1657210679640,CSE 175,A01,083665,Kumar; Rakesh,3,0,25,22
1657210685674,CSE 190,A00,092507,Dubnov; Shlomo,7,0,20,13
1657210691698,ECE 45,A01,083139,Congero; Spencer William,5,0,75,70
1657210697731,ECE 65,A50,083695,Saad; Andrew S,12,0,30,18
1657210697731,ECE 65,A51,095125,Saad; Andrew S,25,0,26,1
1657210703765,ECE 109,A01,091882,Touri; Behrouz,19,0,70,51
1657210709789,ECE 180,A00,083140,Abi Samra; Nicholas Camill,1,0,30,29
1657210709789,ECE 180,B00,083141,Abi Samra; Nicholas Camill,0,0,30,30
1657210715820,MATH 10A,A01,083735,Patchell; Gregory David,2,0,30,28
1657210715820,MATH 10A,A02,083736,Patchell; Gregory David,20,0,30,10
1657210715820,MATH 10A,A03,083737,Patchell; Gregory David,16,0,30,14
1657210721855,MATH 10B,A01,083207,Lim; Seonhee,7,0,34,27
1657210721855,MATH 10B,A02,083208,Lim; Seonhee,9,0,35,26
1657210721855,MATH 10B,A03,093472,Lim; Seonhee,5,0,34,29
1657210721855,MATH 10B,B01,083739,Sinha; Shubham,10,0,30,20
1657210727883,MATH 18,A01,083743,Cinel; Cameron Alexander,6,0,30,24
1657210727883,MATH 18,A02,083744,Cinel; Cameron Alexander,15,0,30,15
1657210727883,MATH 18,A03,083745,Cinel; Cameron Alexander,8,0,30,22
1657210727883,MATH 18,B01,083748,Rideout; David Porter,4,0,37,33
1657210727883,MATH 18,B02,083749,Rideout; David Porter,4,0,36,32
1657210727883,MATH 18,B03,083750,Rideout; David Porter,2,0,37,35
1657210727883,MATH 18,B04,083751,Rideout; David Porter,5,0,36,31
1657210727883,MATH 18,B05,093473,Rideout; David Porter,5,0,36,31
1657210727883,MATH 18,B06,093474,Rideout; David Porter,5,0,36,31
1657210733918,MATH 20A,A01,083754,Zheng; Zequn,13,0,40,27
1657210739949,MATH 20B,A01,083756,Briones; Jor-el Thomas Caparas,2,0,36,34
1657210739949,MATH 20B,A02,083757,Briones; Jor-el Thomas Caparas,1,0,36,35
1657210739949,MATH 20B,A03,093475,Briones; Jor-el Thomas Caparas,1,0,36,35
1657210746004,MATH 20C,A01,083760,Briones; Jor-el Thomas Caparas,1,0,35,34
1657210746004,MATH 20C,A02,083761,Briones; Jor-el Thomas Caparas,8,0,35,27
1657210746004,MATH 20C,A03,093476,Briones; Jor-el Thomas Caparas,0,1,36,36
1657210746004,MATH 20C,B01,083762,Bach; Quang Tran,1,0,30,29
1657210752030,MATH 20D,A01,083765,Tran; Brian Kha,4,0,30,26
1657210752030,MATH 20D,A02,083766,Tran; Brian Kha,5,0,30,25
1657210752030,MATH 20D,A03,083767,Tran; Brian Kha,4,0,30,26
1657210758060,MATH 20E,A01,083771,Ganguly; Soumya,7,0,32,25
1657210758060,MATH 20E,A02,083772,Ganguly; Soumya,7,0,32,25
1657210758060,MATH 20E,B01,083773,Ciotti; Benjamin,19,0,35,16
1657210758060,MATH 20E,B02,083774,Ciotti; Benjamin,17,0,35,18
1657210764087,MATH 103A,A01,083777,Greenfeld; Be'Eri,2,0,36,34
1657210764087,MATH 103A,A02,083778,Greenfeld; Be'Eri,5,0,36,31
1657210764087,MATH 103A,A03,093561,Greenfeld; Be'Eri,4,0,36,32
1657210764087,MATH 103A,B01,083779,Greenfeld; Be'Eri,6,0,36,30
1657210764087,MATH 103A,B02,083780,Greenfeld; Be'Eri,3,0,36,33
1657210764087,MATH 103A,B03,093562,Greenfeld; Be'Eri,3,0,36,33
1657210770116,MATH 105,A01,085443,Carter; Anne Toulson,15,0,35,20
1657210770116,MATH 105,A02,093477,Carter; Anne Toulson,20,0,35,15
1657210776144,MATH 109,A01,083213,Ganzberger; Geoffrey Michael,2,0,34,32
1657210776144,MATH 109,A02,083214,Ganzberger; Geoffrey Michael,4,0,34,30
1657210776144,MATH 109,A03,093478,Ganzberger; Geoffrey Michael,2,0,34,32
1657210776144,MATH 109,B01,083215,Ganzberger; Geoffrey Michael,1,0,32,31
1657210776144,MATH 109,B02,083216,Ganzberger; Geoffrey Michael,1,0,32,31
1657210776144,MATH 109,B03,093479,Ganzberger; Geoffrey Michael,7,0,32,25
1657210782176,MATH 142A,A01,083219,Chow; Bennett,6,0,32,26
1657210782176,MATH 142A,A02,083220,Chow; Bennett,10,0,32,22
1657210782176,MATH 142A,A03,093480,Chow; Bennett,7,0,32,25
1657210782176,MATH 142A,B03,093481,Chow; Bennett,8,0,32,24
1657210782176,MATH 142A,B04,093558,Chow; Bennett,11,0,32,21
1657210782176,MATH 142A,B05,093559,Chow; Bennett,6,0,32,26
1657210788214,MATH 193A,A01,083224,Rotar; Vladimir,7,0,34,27
1657210788214,MATH 193A,A02,083225,Rotar; Vladimir,5,0,34,29
1657210788214,MATH 193A,A03,083781,Rotar; Vladimir,1,0,34,33
1657210788214,MATH 193A,A04,083782,Rotar; Vladimir,8,0,34,26
1657210788214,MATH 193A,A05,093482,Rotar; Vladimir,6,0,34,28
1657210794253,MATH 197,001,091859,McAuley; Julian John,9999,0,9999,0
1657210794253,MATH 197,002,095566,Kedlaya; Kiran S.,9997,0,9999,2
1657210794253,MATH 197,003,095567,Xiao; Ming,9999,0,9999,0
1657210794253,MATH 197,004,095571,Perols; Johan Lars,9998,0,9999,1
1657210801320,COGS 9,A01,083615,Shannon; Kyle Michael,7,0,75,68
1657210807343,COGS 11,A01,083617,Boyle; Mary E. T.,22,0,48,26
1657210813376,COGS 13,A01,083071,Bastos; Amalia Pinkusfeld,9,0,71,62
1657210819401,COGS 14A,A01,092681,Semenuks; Arturs,1,1,100,99
1657210825425,COGS 14B,A01,083073,Cheng; Tzu-Han,6,0,63,57
1657210831454,COGS 17,A01,092677,Semenuks; Arturs,4,0,81,77
1657210837480,COGS 100,A01,083619,Allen; Michael Gordon,15,0,70,55
1657210843504,COGS 101A,A01,083621,Davis; Joshua Daniel,9,0,68,59
1657210849548,COGS 101B,A01,091572,Allen; Michael Gordon,9,0,65,56
1657210855591,COGS 101C,A01,083625,Delgado; Tania,17,0,35,18
1657210861618,COGS 107A,A01,083627,Boyle; Mary E. T.,13,0,60,47
1657210867749,COGS 118A,A01,083075,Gupta; Anjum,16,0,76,60
1657210873796,CSE 3,A50,083646,Miranda; Gregory Joseph,24,0,50,26
1657210879827,CSE 8A,A50,083650,Miranda; Gregory Joseph,17,1,56,39
1657210885862,CSE 11,A01,083080,Cao; Yingjun,5,15,40,35
1657210891886,CSE 12,A01,083652,Krause-Levy; Sophia Louisa,24,1,120,96
1657210897921,CSE 15L,A01,083654,Morris; Justin Loren,9,0,50,41
1657210897921,CSE 15L,A02,083655,Morris; Justin Loren,9,0,50,41
1657210903952,CSE 20,A01,083657,Tran; Khoa Dang,38,0,80,42
1657210909978,CSE 21,A01,095574,Bach; Quang Tran,22,0,48,26
1657210916003,CSE 30,A01,083084,Eldon; John,4,0,80,76
1657210916003,CSE 30,B01,095061,Bhaskar; Nishant,7,0,50,43
1657210922033,CSE 100,A01,083659,Cao; Yingjun,4,4,70,66
1657210928064,CSE 134B,A01,083661,Powell; Thomas Allan,20,0,100,80
1657210934087,CSE 140,A01,083663,Gungor; Onat,13,0,85,72
1657210940114,CSE 140L,A01,083088,Eldon; John,17,0,100,83
1657210946140,CSE 175,A01,083665,Kumar; Rakesh,3,0,25,22
1657210952175,CSE 190,A00,092507,Dubnov; Shlomo,7,0,20,13
1657210958202,ECE 45,A01,083139,Congero; Spencer William,5,0,75,70
1657210964225,ECE 65,A50,083695,Saad; Andrew S,12,0,30,18
1657210964225,ECE 65,A51,095125,Saad; Andrew S,25,0,26,1
1657210970247,ECE 109,A01,091882,Touri; Behrouz,19,0,70,51
1657210976292,ECE 180,A00,083140,Abi Samra; Nicholas Camill,1,0,30,29
1657210976292,ECE 180,B00,083141,Abi Samra; Nicholas Camill,0,0,30,30
1657210982315,MATH 10A,A01,083735,Patchell; Gregory David,2,0,30,28
1657210982315,MATH 10A,A02,083736,Patchell; Gregory David,20,0,30,10
1657210982315,MATH 10A,A03,083737,Patchell; Gregory David,16,0,30,14
1657210988340,MATH 10B,A01,083207,Lim; Seonhee,7,0,34,27
1657210988340,MATH 10B,A02,083208,Lim; Seonhee,9,0,35,26
1657210988340,MATH 10B,A03,093472,Lim; Seonhee,5,0,34,29
1657210988340,MATH 10B,B01,083739,Sinha; Shubham,10,0,30,20
1657210994379,MATH 18,A01,083743,Cinel; Cameron Alexander,6,0,30,24
1657210994379,MATH 18,A02,083744,Cinel; Cameron Alexander,15,0,30,15
1657210994379,MATH 18,A03,083745,Cinel; Cameron Alexander,8,0,30,22
1657210994379,MATH 18,B01,083748,Rideout; David Porter,4,0,37,33
1657210994379,MATH 18,B02,083749,Rideout; David Porter,4,0,36,32
1657210994379,MATH 18,B03,083750,Rideout; David Porter,2,0,37,35
1657210994379,MATH 18,B04,083751,Rideout; David Porter,5,0,36,31
1657210994379,MATH 18,B05,093473,Rideout; David Porter,5,0,36,31
1657210994379,MATH 18,B06,093474,Rideout; David Porter,5,0,36,31
1657211000412,MATH 20A,A01,083754,Zheng; Zequn,13,0,40,27
1657211006439,MATH 20B,A01,083756,Briones; Jor-el Thomas Caparas,2,0,36,34
1657211006439,MATH 20B,A02,083757,Briones; Jor-el Thomas Caparas,1,0,36,35
1657211006439,MATH 20B,A03,093475,Briones; Jor-el Thomas Caparas,1,0,36,35
1657211012478,MATH 20C,A01,083760,Briones; Jor-el Thomas Caparas,1,0,35,34
1657211012478,MATH 20C,A02,083761,Briones; Jor-el Thomas Caparas,8,0,35,27
1657211012478,MATH 20C,A03,093476,Briones; Jor-el Thomas Caparas,0,1,36,36
1657211012478,MATH 20C,B01,083762,Bach; Quang Tran,1,0,30,29
1657211018531,MATH 20D,A01,083765,Tran; Brian Kha,4,0,30,26
1657211018531,MATH 20D,A02,083766,Tran; Brian Kha,5,0,30,25
1657211018531,MATH 20D,A03,083767,Tran; Brian Kha,4,0,30,26
1657211024566,MATH 20E,A01,083771,Ganguly; Soumya,7,0,32,25
1657211024566,MATH 20E,A02,083772,Ganguly; Soumya,7,0,32,25
1657211024566,MATH 20E,B01,083773,Ciotti; Benjamin,19,0,35,16
1657211024566,MATH 20E,B02,083774,Ciotti; Benjamin,17,0,35,18
1657211030601,MATH 103A,A01,083777,Greenfeld; Be'Eri,2,0,36,34
1657211030601,MATH 103A,A02,083778,Greenfeld; Be'Eri,5,0,36,31
1657211030601,MATH 103A,A03,093561,Greenfeld; Be'Eri,4,0,36,32
1657211030601,MATH 103A,B01,083779,Greenfeld; Be'Eri,6,0,36,30
1657211030601,MATH 103A,B02,083780,Greenfeld; Be'Eri,3,0,36,33
1657211030601,MATH 103A,B03,093562,Greenfeld; Be'Eri,3,0,36,33
1657211036644,MATH 105,A01,085443,Carter; Anne Toulson,15,0,35,20
1657211036644,MATH 105,A02,093477,Carter; Anne Toulson,20,0,35,15
1657211042679,MATH 109,A01,083213,Ganzberger; Geoffrey Michael,2,0,34,32
1657211042679,MATH 109,A02,083214,Ganzberger; Geoffrey Michael,4,0,34,30
1657211042679,MATH 109,A03,093478,Ganzberger; Geoffrey Michael,2,0,34,32
1657211042679,MATH 109,B01,083215,Ganzberger; Geoffrey Michael,1,0,32,31
1657211042679,MATH 109,B02,083216,Ganzberger; Geoffrey Michael,1,0,32,31
1657211042679,MATH 109,B03,093479,Ganzberger; Geoffrey Michael,7,0,32,25
1657211048729,MATH 142A,A01,083219,Chow; Bennett,6,0,32,26
1657211048729,MATH 142A,A02,083220,Chow; Bennett,10,0,32,22
1657211048729,MATH 142A,A03,093480,Chow; Bennett,7,0,32,25
1657211048729,MATH 142A,B03,093481,Chow; Bennett,8,0,32,24
1657211048729,MATH 142A,B04,093558,Chow; Bennett,11,0,32,21
1657211048729,MATH 142A,B05,093559,Chow; Bennett,6,0,32,26
1657211054758,MATH 193A,A01,083224,Rotar; Vladimir,7,0,34,27
1657211054758,MATH 193A,A02,083225,Rotar; Vladimir,5,0,34,29
1657211054758,MATH 193A,A03,083781,Rotar; Vladimir,1,0,34,33
1657211054758,MATH 193A,A04,083782,Rotar; Vladimir,8,0,34,26
1657211054758,MATH 193A,A05,093482,Rotar; Vladimir,6,0,34,28
1657211060803,MATH 197,001,091859,McAuley; Julian John,9999,0,9999,0
1657211060803,MATH 197,002,095566,Kedlaya; Kiran S.,9997,0,9999,2
1657211060803,MATH 197,003,095567,Xiao; Ming,9999,0,9999,0
1657211060803,MATH 197,004,095571,Perols; Johan Lars,9998,0,9999,1
1657211067889,COGS 9,A01,083615,Shannon; Kyle Michael,7,0,75,68
1657211073944,COGS 11,A01,083617,Boyle; Mary E. T.,22,0,48,26
1657211079969,COGS 13,A01,083071,Bastos; Amalia Pinkusfeld,9,0,71,62
1657211086000,COGS 14A,A01,092681,Semenuks; Arturs,1,1,100,99
1657211092022,COGS 14B,A01,083073,Cheng; Tzu-Han,6,0,63,57
1657211098067,COGS 17,A01,092677,Semenuks; Arturs,4,0,81,77
1657211104110,COGS 100,A01,083619,Allen; Michael Gordon,15,0,70,55
1657211110138,COGS 101A,A01,083621,Davis; Joshua Daniel,9,0,68,59
1657211116178,COGS 101B,A01,091572,Allen; Michael Gordon,9,0,65,56
1657211122206,COGS 101C,A01,083625,Delgado; Tania,17,0,35,18
1657211128246,COGS 107A,A01,083627,Boyle; Mary E. T.,13,0,60,47
1657211134283,COGS 118A,A01,083075,Gupta; Anjum,16,0,76,60
1657211140316,CSE 3,A50,083646,Miranda; Gregory Joseph,24,0,50,26
1657211146350,CSE 8A,A50,083650,Miranda; Gregory Joseph,17,1,56,39
1657211152384,CSE 11,A01,083080,Cao; Yingjun,5,15,40,35
1657211158408,CSE 12,A01,083652,Krause-Levy; Sophia Louisa,24,1,120,96
1657211164432,CSE 15L,A01,083654,Morris; Justin Loren,9,0,50,41
1657211164432,CSE 15L,A02,083655,Morris; Justin Loren,9,0,50,41
1657211170456,CSE 20,A01,083657,Tran; Khoa Dang,38,0,80,42
1657211176481,CSE 21,A01,095574,Bach; Quang Tran,22,0,48,26
1657211182527,CSE 30,A01,083084,Eldon; John,4,0,80,76
1657211182527,CSE 30,B01,095061,Bhaskar; Nishant,7,0,50,43
1657211188554,CSE 100,A01,083659,Cao; Yingjun,4,4,70,66
1657211194600,CSE 134B,A01,083661,Powell; Thomas Allan,20,0,100,80
1657211200627,CSE 140,A01,083663,Gungor; Onat,13,0,85,72
1657211206667,CSE 140L,A01,083088,Eldon; John,17,0,100,83
1657211212701,CSE 175,A01,083665,Kumar; Rakesh,3,0,25,22
1657211218739,CSE 190,A00,092507,Dubnov; Shlomo,7,0,20,13
1657211224765,ECE 45,A01,083139,Congero; Spencer William,5,0,75,70
1657211230796,ECE 65,A50,083695,Saad; Andrew S,12,0,30,18
1657211230796,ECE 65,A51,095125,Saad; Andrew S,25,0,26,1
1657211236845,ECE 109,A01,091882,Touri; Behrouz,19,0,70,51
1657211242892,ECE 180,A00,083140,Abi Samra; Nicholas Camill,1,0,30,29
1657211242892,ECE 180,B00,083141,Abi Samra; Nicholas Camill,0,0,30,30
1657211248922,MATH 10A,A01,083735,Patchell; Gregory David,2,0,30,28
1657211248922,MATH 10A,A02,083736,Patchell; Gregory David,20,0,30,10
1657211248922,MATH 10A,A03,083737,Patchell; Gregory David,16,0,30,14
1657211254950,MATH 10B,A01,083207,Lim; Seonhee,7,0,34,27
1657211254950,MATH 10B,A02,083208,Lim; Seonhee,9,0,35,26
1657211254950,MATH 10B,A03,093472,Lim; Seonhee,5,0,34,29
1657211254950,MATH 10B,B01,083739,Sinha; Shubham,10,0,30,20
1657211260977,MATH 18,A01,083743,Cinel; Cameron Alexander,6,0,30,24
1657211260977,MATH 18,A02,083744,Cinel; Cameron Alexander,15,0,30,15
1657211260977,MATH 18,A03,083745,Cinel; Cameron Alexander,8,0,30,22
1657211260977,MATH 18,B01,083748,Rideout; David Porter,4,0,37,33
1657211260977,MATH 18,B02,083749,Rideout; David Porter,4,0,36,32
1657211260977,MATH 18,B03,083750,Rideout; David Porter,2,0,37,35
1657211260977,MATH 18,B04,083751,Rideout; David Porter,5,0,36,31
1657211260977,MATH 18,B05,093473,Rideout; David Porter,5,0,36,31
1657211260977,MATH 18,B06,093474,Rideout; David Porter,5,0,36,31
1657211267007,MATH 20A,A01,083754,Zheng; Zequn,13,0,40,27
1657211273046,MATH 20B,A01,083756,Briones; Jor-el Thomas Caparas,2,0,36,34
1657211273046,MATH 20B,A02,083757,Briones; Jor-el Thomas Caparas,1,0,36,35
1657211273046,MATH 20B,A03,093475,Briones; Jor-el Thomas Caparas,1,0,36,35
1657211279093,MATH 20C,A01,083760,Briones; Jor-el Thomas Caparas,1,0,35,34
1657211279093,MATH 20C,A02,083761,Briones; Jor-el Thomas Caparas,8,0,35,27
1657211279093,MATH 20C,A03,093476,Briones; Jor-el Thomas Caparas,0,1,36,36
1657211279093,MATH 20C,B01,083762,Bach; Quang Tran,1,0,30,29
1657211285122,MATH 20D,A01,083765,Tran; Brian Kha,4,0,30,26
1657211285122,MATH 20D,A02,083766,Tran; Brian Kha,5,0,30,25
1657211285122,MATH 20D,A03,083767,Tran; Brian Kha,4,0,30,26
1657211291156,MATH 20E,A01,083771,Ganguly; Soumya,7,0,32,25
1657211291156,MATH 20E,A02,083772,Ganguly; Soumya,7,0,32,25
1657211291156,MATH 20E,B01,083773,Ciotti; Benjamin,19,0,35,16
1657211291156,MATH 20E,B02,083774,Ciotti; Benjamin,17,0,35,18
1657211297200,MATH 103A,A01,083777,Greenfeld; Be'Eri,2,0,36,34
1657211297200,MATH 103A,A02,083778,Greenfeld; Be'Eri,5,0,36,31
1657211297200,MATH 103A,A03,093561,Greenfeld; Be'Eri,4,0,36,32
1657211297200,MATH 103A,B01,083779,Greenfeld; Be'Eri,6,0,36,30
1657211297200,MATH 103A,B02,083780,Greenfeld; Be'Eri,3,0,36,33
1657211297200,MATH 103A,B03,093562,Greenfeld; Be'Eri,3,0,36,33
1657211303233,MATH 105,A01,085443,Carter; Anne Toulson,15,0,35,20
1657211303233,MATH 105,A02,093477,Carter; Anne Toulson,20,0,35,15
1657211309264,MATH 109,A01,083213,Ganzberger; Geoffrey Michael,2,0,34,32
1657211309264,MATH 109,A02,083214,Ganzberger; Geoffrey Michael,4,0,34,30
1657211309264,MATH 109,A03,093478,Ganzberger; Geoffrey Michael,2,0,34,32
1657211309264,MATH 109,B01,083215,Ganzberger; Geoffrey Michael,1,0,32,31
1657211309264,MATH 109,B02,083216,Ganzberger; Geoffrey Michael,1,0,32,31
1657211309264,MATH 109,B03,093479,Ganzberger; Geoffrey Michael,7,0,32,25
1657211315304,MATH 142A,A01,083219,Chow; Bennett,6,0,32,26
1657211315304,MATH 142A,A02,083220,Chow; Bennett,10,0,32,22
1657211315304,MATH 142A,A03,093480,Chow; Bennett,7,0,32,25
1657211315304,MATH 142A,B03,093481,Chow; Bennett,8,0,32,24
1657211315304,MATH 142A,B04,093558,Chow; Bennett,11,0,32,21
1657211315304,MATH 142A,B05,093559,Chow; Bennett,6,0,32,26
1657211321356,MATH 193A,A01,083224,Rotar; Vladimir,7,0,34,27
1657211321356,MATH 193A,A02,083225,Rotar; Vladimir,5,0,34,29
1657211321356,MATH 193A,A03,083781,Rotar; Vladimir,1,0,34,33
1657211321356,MATH 193A,A04,083782,Rotar; Vladimir,8,0,34,26
1657211321356,MATH 193A,A05,093482,Rotar; Vladimir,6,0,34,28
1657211327379,MATH 197,001,091859,McAuley; Julian John,9999,0,9999,0
1657211327379,MATH 197,002,095566,Kedlaya; Kiran S.,9997,0,9999,2
1657211327379,MATH 197,003,095567,Xiao; Ming,9999,0,9999,0
1657211327379,MATH 197,004,095571,Perols; Johan Lars,9998,0,9999,1
1657211334504,COGS 9,A01,083615,Shannon; Kyle Michael,7,0,75,68
1657211340527,COGS 11,A01,083617,Boyle; Mary E. T.,22,0,48,26
1657211346563,COGS 13,A01,083071,Bastos; Amalia Pinkusfeld,9,0,71,62
1657211352620,COGS 14A,A01,092681,Semenuks; Arturs,1,1,100,99
1657211358649,COGS 14B,A01,083073,Cheng; Tzu-Han,6,0,63,57
1657211364679,COGS 17,A01,092677,Semenuks; Arturs,4,0,81,77
1657211370709,COGS 100,A01,083619,Allen; Michael Gordon,15,0,70,55
1657211376741,COGS 101A,A01,083621,Davis; Joshua Daniel,9,0,68,59
1657211382766,COGS 101B,A01,091572,Allen; Michael Gordon,9,0,65,56
1657211388807,COGS 101C,A01,083625,Delgado; Tania,17,0,35,18
1657211394857,COGS 107A,A01,083627,Boyle; Mary E. T.,13,0,60,47
1657211400881,COGS 118A,A01,083075,Gupta; Anjum,16,0,76,60
1657211406933,CSE 3,A50,083646,Miranda; Gregory Joseph,24,0,50,26
1657211412976,CSE 8A,A50,083650,Miranda; Gregory Joseph,17,1,56,39
1657211418999,CSE 11,A01,083080,Cao; Yingjun,5,15,40,35
1657211425037,CSE 12,A01,083652,Krause-Levy; Sophia Louisa,24,1,120,96
1657211431071,CSE 15L,A01,083654,Morris; Justin Loren,9,0,50,41
1657211431071,CSE 15L,A02,083655,Morris; Justin Loren,9,0,50,41
1657211437098,CSE 20,A01,083657,Tran; Khoa Dang,38,0,80,42
1657211443131,CSE 21,A01,095574,Bach; Quang Tran,22,0,48,26
1657211449157,CSE 30,A01,083084,Eldon; John,4,0,80,76
1657211449157,CSE 30,B01,095061,Bhaskar; Nishant,7,0,50,43
1657211455182,CSE 100,A01,083659,Cao; Yingjun,4,4,70,66
1657211461221,CSE 134B,A01,083661,Powell; Thomas Allan,20,0,100,80
1657211467371,CSE 140,A01,083663,Gungor; Onat,13,0,85,72
1657211473398,CSE 140L,A01,083088,Eldon; John,17,0,100,83
1657211479424,CSE 175,A01,083665,Kumar; Rakesh,3,0,25,22
1657211485459,CSE 190,A00,092507,Dubnov; Shlomo,7,0,20,13
1657211491492,ECE 45,A01,083139,Congero; Spencer William,5,0,75,70
1657211497529,ECE 65,A50,083695,Saad; Andrew S,12,0,30,18
1657211497529,ECE 65,A51,095125,Saad; Andrew S,25,0,26,1
1657211503558,ECE 109,A01,091882,Touri; Behrouz,19,0,70,51
1657211509592,ECE 180,A00,083140,Abi Samra; Nicholas Camill,1,0,30,29
1657211509592,ECE 180,B00,083141,Abi Samra; Nicholas Camill,0,0,30,30
1657211515648,MATH 10A,A01,083735,Patchell; Gregory David,2,0,30,28
1657211515648,MATH 10A,A02,083736,Patchell; Gregory David,20,0,30,10
1657211515648,MATH 10A,A03,083737,Patchell; Gregory David,16,0,30,14
1657211521697,MATH 10B,A01,083207,Lim; Seonhee,7,0,34,27
1657211521697,MATH 10B,A02,083208,Lim; Seonhee,9,0,35,26
1657211521697,MATH 10B,A03,093472,Lim; Seonhee,5,0,34,29
1657211521697,MATH 10B,B01,083739,Sinha; Shubham,10,0,30,20
1657211527724,MATH 18,A01,083743,Cinel; Cameron Alexander,6,0,30,24
1657211527724,MATH 18,A02,083744,Cinel; Cameron Alexander,15,0,30,15
1657211527724,MATH 18,A03,083745,Cinel; Cameron Alexander,8,0,30,22
1657211527724,MATH 18,B01,083748,Rideout; David Porter,4,0,37,33
1657211527724,MATH 18,B02,083749,Rideout; David Porter,4,0,36,32
1657211527724,MATH 18,B03,083750,Rideout; David Porter,2,0,37,35
1657211527724,MATH 18,B04,083751,Rideout; David Porter,5,0,36,31
1657211527724,MATH 18,B05,093473,Rideout; David Porter,5,0,36,31
1657211527724,MATH 18,B06,093474,Rideout; David Porter,5,0,36,31
1657211533760,MATH 20A,A01,083754,Zheng; Zequn,13,0,40,27
1657211539801,MATH 20B,A01,083756,Briones; Jor-el Thomas Caparas,2,0,36,34
1657211539801,MATH 20B,A02,083757,Briones; Jor-el Thomas Caparas,1,0,36,35
1657211539801,MATH 20B,A03,093475,Briones; Jor-el Thomas Caparas,1,0,36,35
1657211545832,MATH 20C,A01,083760,Briones; Jor-el Thomas Caparas,1,0,35,34
1657211545832,MATH 20C,A02,083761,Briones; Jor-el Thomas Caparas,8,0,35,27
1657211545832,MATH 20C,A03,093476,Briones; Jor-el Thomas Caparas,0,1,36,36
1657211545832,MATH 20C,B01,083762,Bach; Quang Tran,1,0,30,29
1657211551889,MATH 20D,A01,083765,Tran; Brian Kha,4,0,30,26
1657211551889,MATH 20D,A02,083766,Tran; Brian Kha,5,0,30,25
1657211551889,MATH 20D,A03,083767,Tran; Brian Kha,4,0,30,26
1657211557928,MATH 20E,A01,083771,Ganguly; Soumya,7,0,32,25
1657211557928,MATH 20E,A02,083772,Ganguly; Soumya,7,0,32,25
1657211557928,MATH 20E,B01,083773,Ciotti; Benjamin,19,0,35,16
1657211557928,MATH 20E,B02,083774,Ciotti; Benjamin,17,0,35,18
1657211563965,MATH 103A,A01,083777,Greenfeld; Be'Eri,2,0,36,34
1657211563965,MATH 103A,A02,083778,Greenfeld; Be'Eri,5,0,36,31
1657211563965,MATH 103A,A03,093561,Greenfeld; Be'Eri,4,0,36,32
1657211563965,MATH 103A,B01,083779,Greenfeld; Be'Eri,6,0,36,30
1657211563965,MATH 103A,B02,083780,Greenfeld; Be'Eri,3,0,36,33
1657211563965,MATH 103A,B03,093562,Greenfeld; Be'Eri,3,0,36,33
1657211570007,MATH 105,A01,085443,Carter; Anne Toulson,15,0,35,20
1657211570007,MATH 105,A02,093477,Carter; Anne Toulson,20,0,35,15
1657211576036,MATH 109,A01,083213,Ganzberger; Geoffrey Michael,2,0,34,32
1657211576036,MATH 109,A02,083214,Ganzberger; Geoffrey Michael,4,0,34,30
1657211576036,MATH 109,A03,093478,Ganzberger; Geoffrey Michael,2,0,34,32
1657211576036,MATH 109,B01,083215,Ganzberger; Geoffrey Michael,1,0,32,31
1657211576036,MATH 109,B02,083216,Ganzberger; Geoffrey Michael,1,0,32,31
1657211576036,MATH 109,B03,093479,Ganzberger; Geoffrey Michael,7,0,32,25
1657211582071,MATH 142A,A01,083219,Chow; Bennett,6,0,32,26
1657211582071,MATH 142A,A02,083220,Chow; Bennett,10,0,32,22
1657211582071,MATH 142A,A03,093480,Chow; Bennett,7,0,32,25
1657211582071,MATH 142A,B03,093481,Chow; Bennett,8,0,32,24
1657211582071,MATH 142A,B04,093558,Chow; Bennett,11,0,32,21
1657211582071,MATH 142A,B05,093559,Chow; Bennett,6,0,32,26
1657211588102,MATH 193A,A01,083224,Rotar; Vladimir,7,0,34,27
1657211588102,MATH 193A,A02,083225,Rotar; Vladimir,5,0,34,29
1657211588102,MATH 193A,A03,083781,Rotar; Vladimir,1,0,34,33
1657211588102,MATH 193A,A04,083782,Rotar; Vladimir,8,0,34,26
1657211588102,MATH 193A,A05,093482,Rotar; Vladimir,6,0,34,28
1657211594147,MATH 197,001,091859,McAuley; Julian John,9999,0,9999,0
1657211594147,MATH 197,002,095566,Kedlaya; Kiran S.,9997,0,9999,2
1657211594147,MATH 197,003,095567,Xiao; Ming,9999,0,9999,0
1657211594147,MATH 197,004,095571,Perols; Johan Lars,9998,0,9999,1
1657211601257,COGS 9,A01,083615,Shannon; Kyle Michael,7,0,75,68
1657211607286,COGS 11,A01,083617,Boyle; Mary E. T.,22,0,48,26
1657211613316,COGS 13,A01,083071,Bastos; Amalia Pinkusfeld,9,0,71,62
1657211619359,COGS 14A,A01,092681,Semenuks; Arturs,1,1,100,99
1657211625383,COGS 14B,A01,083073,Cheng; Tzu-Han,6,0,63,57
1657211631407,COGS 17,A01,092677,Semenuks; Arturs,4,0,81,77
1657211637468,COGS 100,A01,083619,Allen; Michael Gordon,15,0,70,55
1657211643494,COGS 101A,A01,083621,Davis; Joshua Daniel,9,0,68,59
1657211649530,COGS 101B,A01,091572,Allen; Michael Gordon,9,0,65,56
1657211655554,COGS 101C,A01,083625,Delgado; Tania,17,0,35,18
1657211661584,COGS 107A,A01,083627,Boyle; Mary E. T.,13,0,60,47
1657211667632,COGS 118A,A01,083075,Gupta; Anjum,16,0,76,60
1657211673661,CSE 3,A50,083646,Miranda; Gregory Joseph,24,0,50,26
1657211679690,CSE 8A,A50,083650,Miranda; Gregory Joseph,17,1,56,39
1657211685718,CSE 11,A01,083080,Cao; Yingjun,5,15,40,35
1657211691752,CSE 12,A01,083652,Krause-Levy; Sophia Louisa,24,1,120,96
1657211697776,CSE 15L,A01,083654,Morris; Justin Loren,9,0,50,41
1657211697776,CSE 15L,A02,083655,Morris; Justin Loren,9,0,50,41
1657211703812,CSE 20,A01,083657,Tran; Khoa Dang,38,0,80,42
1657211709835,CSE 21,A01,095574,Bach; Quang Tran,22,0,48,26
1657211715894,CSE 30,A01,083084,Eldon; John,4,0,80,76
1657211715894,CSE 30,B01,095061,Bhaskar; Nishant,7,0,50,43
1657211721922,CSE 100,A01,083659,Cao; Yingjun,4,4,70,66
1657211727970,CSE 134B,A01,083661,Powell; Thomas Allan,20,0,100,80
1657211734000,CSE 140,A01,083663,Gungor; Onat,13,0,85,72
1657211740032,CSE 140L,A01,083088,Eldon; John,17,0,100,83
1657211746061,CSE 175,A01,083665,Kumar; Rakesh,3,0,25,22
1657211752085,CSE 190,A00,092507,Dubnov; Shlomo,7,0,20,13
1657211758115,ECE 45,A01,083139,Congero; Spencer William,5,0,75,70
1657211764160,ECE 65,A50,083695,Saad; Andrew S,12,0,30,18
1657211764160,ECE 65,A51,095125,Saad; Andrew S,25,0,26,1
1657211770191,ECE 109,A01,091882,Touri; Behrouz,19,0,70,51
1657211776220,ECE 180,A00,083140,Abi Samra; Nicholas Camill,1,0,30,29
1657211776220,ECE 180,B00,083141,Abi Samra; Nicholas Camill,0,0,30,30
1657211782246,MATH 10A,A01,083735,Patchell; Gregory David,2,0,30,28
1657211782246,MATH 10A,A02,083736,Patchell; Gregory David,20,0,30,10
1657211782246,MATH 10A,A03,083737,Patchell; Gregory David,16,0,30,14
1657211788273,MATH 10B,A01,083207,Lim; Seonhee,7,0,34,27
1657211788273,MATH 10B,A02,083208,Lim; Seonhee,9,0,35,26
1657211788273,MATH 10B,A03,093472,Lim; Seonhee,5,0,34,29
1657211788273,MATH 10B,B01,083739,Sinha; Shubham,10,0,30,20
1657211794313,MATH 18,A01,083743,Cinel; Cameron Alexander,6,0,30,24
1657211794313,MATH 18,A02,083744,Cinel; Cameron Alexander,15,0,30,15
1657211794313,MATH 18,A03,083745,Cinel; Cameron Alexander,8,0,30,22
1657211794313,MATH 18,B01,083748,Rideout; David Porter,4,0,37,33
1657211794313,MATH 18,B02,083749,Rideout; David Porter,4,0,36,32
1657211794313,MATH 18,B03,083750,Rideout; David Porter,2,0,37,35
1657211794313,MATH 18,B04,083751,Rideout; David Porter,5,0,36,31
1657211794313,MATH 18,B05,093473,Rideout; David Porter,5,0,36,31
1657211794313,MATH 18,B06,093474,Rideout; David Porter,5,0,36,31
1657211800372,MATH 20A,A01,083754,Zheng; Zequn,13,0,40,27
1657211806417,MATH 20B,A01,083756,Briones; Jor-el Thomas Caparas,2,0,36,34
1657211806417,MATH 20B,A02,083757,Briones; Jor-el Thomas Caparas,1,0,36,35
1657211806417,MATH 20B,A03,093475,Briones; Jor-el Thomas Caparas,1,0,36,35
1657211812454,MATH 20C,A01,083760,Briones; Jor-el Thomas Caparas,1,0,35,34
1657211812454,MATH 20C,A02,083761,Briones; Jor-el Thomas Caparas,8,0,35,27
1657211812454,MATH 20C,A03,093476,Briones; Jor-el Thomas Caparas,0,1,36,36
1657211812454,MATH 20C,B01,083762,Bach; Quang Tran,1,0,30,29
1657211818480,MATH 20D,A01,083765,Tran; Brian Kha,4,0,30,26
1657211818480,MATH 20D,A02,083766,Tran; Brian Kha,5,0,30,25
1657211818480,MATH 20D,A03,083767,Tran; Brian Kha,4,0,30,26
1657211824511,MATH 20E,A01,083771,Ganguly; Soumya,7,0,32,25
1657211824511,MATH 20E,A02,083772,Ganguly; Soumya,7,0,32,25
1657211824511,MATH 20E,B01,083773,Ciotti; Benjamin,19,0,35,16
1657211824511,MATH 20E,B02,083774,Ciotti; Benjamin,17,0,35,18
1657211830553,MATH 103A,A01,083777,Greenfeld; Be'Eri,2,0,36,34
1657211830553,MATH 103A,A02,083778,Greenfeld; Be'Eri,5,0,36,31
1657211830553,MATH 103A,A03,093561,Greenfeld; Be'Eri,4,0,36,32
1657211830553,MATH 103A,B01,083779,Greenfeld; Be'Eri,6,0,36,30
1657211830553,MATH 103A,B02,083780,Greenfeld; Be'Eri,3,0,36,33
1657211830553,MATH 103A,B03,093562,Greenfeld; Be'Eri,3,0,36,33
1657211836577,MATH 105,A01,085443,Carter; Anne Toulson,15,0,35,20
1657211836577,MATH 105,A02,093477,Carter; Anne Toulson,20,0,35,15
1657211842627,MATH 109,A01,083213,Ganzberger; Geoffrey Michael,2,0,34,32
1657211842627,MATH 109,A02,083214,Ganzberger; Geoffrey Michael,4,0,34,30
1657211842627,MATH 109,A03,093478,Ganzberger; Geoffrey Michael,2,0,34,32
1657211842627,MATH 109,B01,083215,Ganzberger; Geoffrey Michael,1,0,32,31
1657211842627,MATH 109,B02,083216,Ganzberger; Geoffrey Michael,1,0,32,31
1657211842627,MATH 109,B03,093479,Ganzberger; Geoffrey Michael,7,0,32,25
1657211848649,MATH 142A,A01,083219,Chow; Bennett,6,0,32,26
1657211848649,MATH 142A,A02,083220,Chow; Bennett,10,0,32,22
1657211848649,MATH 142A,A03,093480,Chow; Bennett,7,0,32,25
1657211848649,MATH 142A,B03,093481,Chow; Bennett,8,0,32,24
1657211848649,MATH 142A,B04,093558,Chow; Bennett,11,0,32,21
1657211848649,MATH 142A,B05,093559,Chow; Bennett,6,0,32,26
1657211854680,MATH 193A,A01,083224,Rotar; Vladimir,7,0,34,27
1657211854680,MATH 193A,A02,083225,Rotar; Vladimir,5,0,34,29
1657211854680,MATH 193A,A03,083781,Rotar; Vladimir,1,0,34,33
1657211854680,MATH 193A,A04,083782,Rotar; Vladimir,8,0,34,26
1657211854680,MATH 193A,A05,093482,Rotar; Vladimir,6,0,34,28
1657211860704,MATH 197,001,091859,McAuley; Julian John,9999,0,9999,0
1657211860704,MATH 197,002,095566,Kedlaya; Kiran S.,9997,0,9999,2
1657211860704,MATH 197,003,095567,Xiao; Ming,9999,0,9999,0
1657211860704,MATH 197,004,095571,Perols; Johan Lars,9998,0,9999,1
1657211867779,COGS 9,A01,083615,Shannon; Kyle Michael,7,0,75,68
1657211873804,COGS 11,A01,083617,Boyle; Mary E. T.,22,0,48,26
1657211879855,COGS 13,A01,083071,Bastos; Amalia Pinkusfeld,9,0,71,62
1657211885885,COGS 14A,A01,092681,Semenuks; Arturs,1,1,100,99
1657211891920,COGS 14B,A01,083073,Cheng; Tzu-Han,6,0,63,57
1657211897949,COGS 17,A01,092677,Semenuks; Arturs,4,0,81,77
1657211903989,COGS 100,A01,083619,Allen; Michael Gordon,15,0,70,55
1657211910015,COGS 101A,A01,083621,Davis; Joshua Daniel,9,0,68,59
1657211916038,COGS 101B,A01,091572,Allen; Michael Gordon,9,0,65,56
1657211922064,COGS 101C,A01,083625,Delgado; Tania,17,0,35,18
1657211928088,COGS 107A,A01,083627,Boyle; Mary E. T.,13,0,60,47
1657211934109,COGS 118A,A01,083075,Gupta; Anjum,16,0,76,60
1657211940139,CSE 3,A50,083646,Miranda; Gregory Joseph,24,0,50,26
1657211946166,CSE 8A,A50,083650,Miranda; Gregory Joseph,17,1,56,39
1657211952189,CSE 11,A01,083080,Cao; Yingjun,5,15,40,35
1657211958215,CSE 12,A01,083652,Krause-Levy; Sophia Louisa,24,1,120,96
1657211964238,CSE 15L,A01,083654,Morris; Justin Loren,9,0,50,41
1657211964238,CSE 15L,A02,083655,Morris; Justin Loren,9,0,50,41
1657211970264,CSE 20,A01,083657,Tran; Khoa Dang,38,0,80,42
1657211976345,CSE 21,A01,095574,Bach; Quang Tran,22,0,48,26
1657211982388,CSE 30,A01,083084,Eldon; John,4,0,80,76
1657211982388,CSE 30,B01,095061,Bhaskar; Nishant,7,0,50,43
1657211988410,CSE 100,A01,083659,Cao; Yingjun,4,4,70,66
1657211994437,CSE 134B,A01,083661,Powell; Thomas Allan,20,0,100,80
1657212000465,CSE 140,A01,083663,Gungor; Onat,13,0,85,72
1657212006492,CSE 140L,A01,083088,Eldon; John,17,0,100,83
1657212012533,CSE 175,A01,083665,Kumar; Rakesh,3,0,25,22
1657212018558,CSE 190,A00,092507,Dubnov; Shlomo,7,0,20,13
1657212024581,ECE 45,A01,083139,Congero; Spencer William,5,0,75,70
1657212030605,ECE 65,A50,083695,Saad; Andrew S,12,0,30,18
1657212030605,ECE 65,A51,095125,Saad; Andrew S,25,0,26,1
1657212036633,ECE 109,A01,091882,Touri; Behrouz,19,0,70,51
1657212042666,ECE 180,A00,083140,Abi Samra; Nicholas Camill,1,0,30,29
1657212042666,ECE 180,B00,083141,Abi Samra; Nicholas Camill,0,0,30,30
1657212048699,MATH 10A,A01,083735,Patchell; Gregory David,2,0,30,28
1657212048699,MATH 10A,A02,083736,Patchell; Gregory David,20,0,30,10
1657212048699,MATH 10A,A03,083737,Patchell; Gregory David,16,0,30,14
1657212054723,MATH 10B,A01,083207,Lim; Seonhee,7,0,34,27
1657212054723,MATH 10B,A02,083208,Lim; Seonhee,9,0,35,26
1657212054723,MATH 10B,A03,093472,Lim; Seonhee,5,0,34,29
1657212054723,MATH 10B,B01,083739,Sinha; Shubham,10,0,30,20
1657212060757,MATH 18,A01,083743,Cinel; Cameron Alexander,6,0,30,24
1657212060757,MATH 18,A02,083744,Cinel; Cameron Alexander,15,0,30,15
1657212060757,MATH 18,A03,083745,Cinel; Cameron Alexander,8,0,30,22
1657212060757,MATH 18,B01,083748,Rideout; David Porter,4,0,37,33
1657212060757,MATH 18,B02,083749,Rideout; David Porter,4,0,36,32
1657212060757,MATH 18,B03,083750,Rideout; David Porter,2,0,37,35
1657212060757,MATH 18,B04,083751,Rideout; David Porter,5,0,36,31
1657212060757,MATH 18,B05,093473,Rideout; David Porter,5,0,36,31
1657212060757,MATH 18,B06,093474,Rideout; David Porter,5,0,36,31
1657212066897,MATH 20A,A01,083754,Zheng; Zequn,13,0,40,27
1657212072934,MATH 20B,A01,083756,Briones; Jor-el Thomas Caparas,2,0,36,34
1657212072934,MATH 20B,A02,083757,Briones; Jor-el Thomas Caparas,1,0,36,35
1657212072934,MATH 20B,A03,093475,Briones; Jor-el Thomas Caparas,1,0,36,35
1657212078963,MATH 20C,A01,083760,Briones; Jor-el Thomas Caparas,1,0,35,34
1657212078963,MATH 20C,A02,083761,Briones; Jor-el Thomas Caparas,8,0,35,27
1657212078963,MATH 20C,A03,093476,Briones; Jor-el Thomas Caparas,0,1,36,36
1657212078963,MATH 20C,B01,083762,Bach; Quang Tran,1,0,30,29
1657212085001,MATH 20D,A01,083765,Tran; Brian Kha,4,0,30,26
1657212085001,MATH 20D,A02,083766,Tran; Brian Kha,5,0,30,25
1657212085001,MATH 20D,A03,083767,Tran; Brian Kha,4,0,30,26
1657212091032,MATH 20E,A01,083771,Ganguly; Soumya,7,0,32,25
1657212091032,MATH 20E,A02,083772,Ganguly; Soumya,7,0,32,25
1657212091032,MATH 20E,B01,083773,Ciotti; Benjamin,19,0,35,16
1657212091032,MATH 20E,B02,083774,Ciotti; Benjamin,17,0,35,18
1657212097055,MATH 103A,A01,083777,Greenfeld; Be'Eri,2,0,36,34
1657212097055,MATH 103A,A02,083778,Greenfeld; Be'Eri,5,0,36,31
1657212097055,MATH 103A,A03,093561,Greenfeld; Be'Eri,4,0,36,32
1657212097055,MATH 103A,B01,083779,Greenfeld; Be'Eri,6,0,36,30
1657212097055,MATH 103A,B02,083780,Greenfeld; Be'Eri,3,0,36,33
1657212097055,MATH 103A,B03,093562,Greenfeld; Be'Eri,3,0,36,33
1657212103107,MATH 105,A01,085443,Carter; Anne Toulson,15,0,35,20
1657212103107,MATH 105,A02,093477,Carter; Anne Toulson,20,0,35,15
1657212109135,MATH 109,A01,083213,Ganzberger; Geoffrey Michael,2,0,34,32
1657212109135,MATH 109,A02,083214,Ganzberger; Geoffrey Michael,4,0,34,30
1657212109135,MATH 109,A03,093478,Ganzberger; Geoffrey Michael,2,0,34,32
1657212109135,MATH 109,B01,083215,Ganzberger; Geoffrey Michael,1,0,32,31
1657212109135,MATH 109,B02,083216,Ganzberger; Geoffrey Michael,1,0,32,31
1657212109135,MATH 109,B03,093479,Ganzberger; Geoffrey Michael,7,0,32,25
1657212115192,MATH 142A,A01,083219,Chow; Bennett,6,0,32,26
1657212115192,MATH 142A,A02,083220,Chow; Bennett,10,0,32,22
1657212115192,MATH 142A,A03,093480,Chow; Bennett,7,0,32,25
1657212115192,MATH 142A,B03,093481,Chow; Bennett,8,0,32,24
1657212115192,MATH 142A,B04,093558,Chow; Bennett,11,0,32,21
1657212115192,MATH 142A,B05,093559,Chow; Bennett,6,0,32,26
1657212121236,MATH 193A,A01,083224,Rotar; Vladimir,7,0,34,27
1657212121236,MATH 193A,A02,083225,Rotar; Vladimir,5,0,34,29
1657212121236,MATH 193A,A03,083781,Rotar; Vladimir,1,0,34,33
1657212121236,MATH 193A,A04,083782,Rotar; Vladimir,8,0,34,26
1657212121236,MATH 193A,A05,093482,Rotar; Vladimir,6,0,34,28
1657212127263,MATH 197,001,091859,McAuley; Julian John,9999,0,9999,0
1657212127263,MATH 197,002,095566,Kedlaya; Kiran S.,9997,0,9999,2
1657212127263,MATH 197,003,095567,Xiao; Ming,9999,0,9999,0
1657212127263,MATH 197,004,095571,Perols; Johan Lars,9998,0,9999,1
1657212134347,COGS 9,A01,083615,Shannon; Kyle Michael,7,0,75,68
1657212140370,COGS 11,A01,083617,Boyle; Mary E. T.,22,0,48,26
1657212146420,COGS 13,A01,083071,Bastos; Amalia Pinkusfeld,9,0,71,62
1657212152459,COGS 14A,A01,092681,Semenuks; Arturs,1,1,100,99
1657212158488,COGS 14B,A01,083073,Cheng; Tzu-Han,6,0,63,57
1657212164527,COGS 17,A01,092677,Semenuks; Arturs,4,0,81,77
1657212170551,COGS 100,A01,083619,Allen; Michael Gordon,15,0,70,55
1657212176589,COGS 101A,A01,083621,Davis; Joshua Daniel,9,0,68,59
1657212182638,COGS 101B,A01,091572,Allen; Michael Gordon,9,0,65,56
1657212188674,COGS 101C,A01,083625,Delgado; Tania,17,0,35,18
1657212194712,COGS 107A,A01,083627,Boyle; Mary E. T.,13,0,60,47
1657212200738,COGS 118A,A01,083075,Gupta; Anjum,16,0,76,60
1657212206775,CSE 3,A50,083646,Miranda; Gregory Joseph,24,0,50,26
1657212212804,CSE 8A,A50,083650,Miranda; Gregory Joseph,17,1,56,39
1657212218834,CSE 11,A01,083080,Cao; Yingjun,5,15,40,35
1657212224862,CSE 12,A01,083652,Krause-Levy; Sophia Louisa,24,1,120,96
1657212230893,CSE 15L,A01,083654,Morris; Justin Loren,9,0,50,41
1657212230893,CSE 15L,A02,083655,Morris; Justin Loren,9,0,50,41
1657212236931,CSE 20,A01,083657,Tran; Khoa Dang,38,0,80,42
1657212242963,CSE 21,A01,095574,Bach; Quang Tran,22,0,48,26
1657212248986,CSE 30,A01,083084,Eldon; John,4,0,80,76
1657212248986,CSE 30,B01,095061,Bhaskar; Nishant,7,0,50,43
1657212255036,CSE 100,A01,083659,Cao; Yingjun,4,4,70,66
1657212261066,CSE 134B,A01,083661,Powell; Thomas Allan,20,0,100,80
1657212267090,CSE 140,A01,083663,Gungor; Onat,13,0,85,72
1657212273114,CSE 140L,A01,083088,Eldon; John,17,0,100,83
1657212279159,CSE 175,A01,083665,Kumar; Rakesh,3,0,25,22
1657212285183,CSE 190,A00,092507,Dubnov; Shlomo,7,0,20,13
1657212291219,ECE 45,A01,083139,Congero; Spencer William,5,0,75,70
1657212305494,ECE 65,A50,083695,Saad; Andrew S,12,0,30,18
1657212305494,ECE 65,A51,095125,Saad; Andrew S,25,0,26,1
1657212311519,ECE 109,A01,091882,Touri; Behrouz,19,0,70,51
1657212317544,ECE 180,A00,083140,Abi Samra; Nicholas Camill,1,0,30,29
1657212317544,ECE 180,B00,083141,Abi Samra; Nicholas Camill,0,0,30,30
1657212323584,MATH 10A,A01,083735,Patchell; Gregory David,2,0,30,28
1657212323584,MATH 10A,A02,083736,Patchell; Gregory David,20,0,30,10
1657212323584,MATH 10A,A03,083737,Patchell; Gregory David,16,0,30,14
1657212329610,MATH 10B,A01,083207,Lim; Seonhee,7,0,34,27
1657212329610,MATH 10B,A02,083208,Lim; Seonhee,9,0,35,26
1657212329610,MATH 10B,A03,093472,Lim; Seonhee,5,0,34,29
1657212329610,MATH 10B,B01,083739,Sinha; Shubham,10,0,30,20
1657212335676,MATH 18,A01,083743,Cinel; Cameron Alexander,6,0,30,24
1657212335676,MATH 18,A02,083744,Cinel; Cameron Alexander,15,0,30,15
1657212335676,MATH 18,A03,083745,Cinel; Cameron Alexander,8,0,30,22
1657212335676,MATH 18,B01,083748,Rideout; David Porter,4,0,37,33
1657212335676,MATH 18,B02,083749,Rideout; David Porter,4,0,36,32
1657212335676,MATH 18,B03,083750,Rideout; David Porter,2,0,37,35
1657212335676,MATH 18,B04,083751,Rideout; David Porter,5,0,36,31
1657212335676,MATH 18,B05,093473,Rideout; David Porter,5,0,36,31
1657212335676,MATH 18,B06,093474,Rideout; David Porter,5,0,36,31
1657212341714,MATH 20A,A01,083754,Zheng; Zequn,13,0,40,27
1657212347744,MATH 20B,A01,083756,Briones; Jor-el Thomas Caparas,2,0,36,34
1657212347744,MATH 20B,A02,083757,Briones; Jor-el Thomas Caparas,1,0,36,35
1657212347744,MATH 20B,A03,093475,Briones; Jor-el Thomas Caparas,1,0,36,35
1657212353782,MATH 20C,A01,083760,Briones; Jor-el Thomas Caparas,1,0,35,34
1657212353782,MATH 20C,A02,083761,Briones; Jor-el Thomas Caparas,8,0,35,27
1657212353782,MATH 20C,A03,093476,Briones; Jor-el Thomas Caparas,0,1,36,36
1657212353782,MATH 20C,B01,083762,Bach; Quang Tran,1,0,30,29
1657212359813,MATH 20D,A01,083765,Tran; Brian Kha,4,0,30,26
1657212359813,MATH 20D,A02,083766,Tran; Brian Kha,5,0,30,25
1657212359813,MATH 20D,A03,083767,Tran; Brian Kha,4,0,30,26
1657212365848,MATH 20E,A01,083771,Ganguly; Soumya,7,0,32,25
1657212365848,MATH 20E,A02,083772,Ganguly; Soumya,7,0,32,25
1657212365848,MATH 20E,B01,083773,Ciotti; Benjamin,19,0,35,16
1657212365848,MATH 20E,B02,083774,Ciotti; Benjamin,17,0,35,18
1657212371887,MATH 103A,A01,083777,Greenfeld; Be'Eri,2,0,36,34
1657212371887,MATH 103A,A02,083778,Greenfeld; Be'Eri,5,0,36,31
1657212371887,MATH 103A,A03,093561,Greenfeld; Be'Eri,4,0,36,32
1657212371887,MATH 103A,B01,083779,Greenfeld; Be'Eri,6,0,36,30
1657212371887,MATH 103A,B02,083780,Greenfeld; Be'Eri,3,0,36,33
1657212371887,MATH 103A,B03,093562,Greenfeld; Be'Eri,3,0,36,33
1657212377918,MATH 105,A01,085443,Carter; Anne Toulson,15,0,35,20
1657212377918,MATH 105,A02,093477,Carter; Anne Toulson,20,0,35,15
1657212383978,MATH 109,A01,083213,Ganzberger; Geoffrey Michael,2,0,34,32
1657212383978,MATH 109,A02,083214,Ganzberger; Geoffrey Michael,4,0,34,30
1657212383978,MATH 109,A03,093478,Ganzberger; Geoffrey Michael,2,0,34,32
1657212383978,MATH 109,B01,083215,Ganzberger; Geoffrey Michael,1,0,32,31
1657212383978,MATH 109,B02,083216,Ganzberger; Geoffrey Michael,1,0,32,31
1657212383978,MATH 109,B03,093479,Ganzberger; Geoffrey Michael,7,0,32,25
1657212390023,MATH 142A,A01,083219,Chow; Bennett,6,0,32,26
1657212390023,MATH 142A,A02,083220,Chow; Bennett,10,0,32,22
1657212390023,MATH 142A,A03,093480,Chow; Bennett,7,0,32,25
1657212390023,MATH 142A,B03,093481,Chow; Bennett,8,0,32,24
1657212390023,MATH 142A,B04,093558,Chow; Bennett,11,0,32,21
1657212390023,MATH 142A,B05,093559,Chow; Bennett,6,0,32,26
1657212396064,MATH 193A,A01,083224,Rotar; Vladimir,7,0,34,27
1657212396064,MATH 193A,A02,083225,Rotar; Vladimir,5,0,34,29
1657212396064,MATH 193A,A03,083781,Rotar; Vladimir,1,0,34,33
1657212396064,MATH 193A,A04,083782,Rotar; Vladimir,8,0,34,26
1657212396064,MATH 193A,A05,093482,Rotar; Vladimir,6,0,34,28
1657212402089,MATH 197,001,091859,McAuley; Julian John,9999,0,9999,0
1657212402089,MATH 197,002,095566,Kedlaya; Kiran S.,9997,0,9999,2
1657212402089,MATH 197,003,095567,Xiao; Ming,9999,0,9999,0
1657212402089,MATH 197,004,095571,Perols; Johan Lars,9998,0,9999,1
1657212409170,COGS 9,A01,083615,Shannon; Kyle Michael,7,0,75,68
1657212415205,COGS 11,A01,083617,Boyle; Mary E. T.,22,0,48,26
1657212421232,COGS 13,A01,083071,Bastos; Amalia Pinkusfeld,9,0,71,62
1657212427276,COGS 14A,A01,092681,Semenuks; Arturs,1,1,100,99
1657212433299,COGS 14B,A01,083073,Cheng; Tzu-Han,6,0,63,57
1657212439337,COGS 17,A01,092677,Semenuks; Arturs,4,0,81,77
1657212445390,COGS 100,A01,083619,Allen; Michael Gordon,15,0,70,55
1657212451422,COGS 101A,A01,083621,Davis; Joshua Daniel,9,0,68,59
1657212457458,COGS 101B,A01,091572,Allen; Michael Gordon,9,0,65,56
1657212463497,COGS 101C,A01,083625,Delgado; Tania,17,0,35,18
1657212469532,COGS 107A,A01,083627,Boyle; Mary E. T.,13,0,60,47
1657212475558,COGS 118A,A01,083075,Gupta; Anjum,16,0,76,60
1657212481597,CSE 3,A50,083646,Miranda; Gregory Joseph,24,0,50,26
1657212487621,CSE 8A,A50,083650,Miranda; Gregory Joseph,17,1,56,39
1657212493657,CSE 11,A01,083080,Cao; Yingjun,5,15,40,35
1657212499688,CSE 12,A01,083652,Krause-Levy; Sophia Louisa,24,1,120,96
1657212505714,CSE 15L,A01,083654,Morris; Justin Loren,9,0,50,41
1657212505714,CSE 15L,A02,083655,Morris; Justin Loren,9,0,50,41
1657212511750,CSE 20,A01,083657,Tran; Khoa Dang,38,0,80,42
1657212517774,CSE 21,A01,095574,Bach; Quang Tran,22,0,48,26
1657212523798,CSE 30,A01,083084,Eldon; John,4,0,80,76
1657212523798,CSE 30,B01,095061,Bhaskar; Nishant,7,0,50,43
1657212529829,CSE 100,A01,083659,Cao; Yingjun,4,4,70,66
1657212535877,CSE 134B,A01,083661,Powell; Thomas Allan,20,0,100,80
1657212541909,CSE 140,A01,083663,Gungor; Onat,13,0,85,72
1657212547960,CSE 140L,A01,083088,Eldon; John,17,0,100,83
1657212553988,CSE 175,A01,083665,Kumar; Rakesh,3,0,25,22
1657212560024,CSE 190,A00,092507,Dubnov; Shlomo,7,0,20,13
1657212566089,ECE 45,A01,083139,Congero; Spencer William,5,0,75,70
1657212572126,ECE 65,A50,083695,Saad; Andrew S,12,0,30,18
1657212572126,ECE 65,A51,095125,Saad; Andrew S,25,0,26,1
1657212578170,ECE 109,A01,091882,Touri; Behrouz,19,0,70,51
1657212584198,ECE 180,A00,083140,Abi Samra; Nicholas Camill,1,0,30,29
1657212584198,ECE 180,B00,083141,Abi Samra; Nicholas Camill,0,0,30,30
1657212590242,MATH 10A,A01,083735,Patchell; Gregory David,2,0,30,28
1657212590242,MATH 10A,A02,083736,Patchell; Gregory David,20,0,30,10
1657212590242,MATH 10A,A03,083737,Patchell; Gregory David,16,0,30,14
1657212596289,MATH 10B,A01,083207,Lim; Seonhee,7,0,34,27
1657212596289,MATH 10B,A02,083208,Lim; Seonhee,9,0,35,26
1657212596289,MATH 10B,A03,093472,Lim; Seonhee,5,0,34,29
1657212596289,MATH 10B,B01,083739,Sinha; Shubham,10,0,30,20
1657212602328,MATH 18,A01,083743,Cinel; Cameron Alexander,6,0,30,24
1657212602328,MATH 18,A02,083744,Cinel; Cameron Alexander,15,0,30,15
1657212602328,MATH 18,A03,083745,Cinel; Cameron Alexander,8,0,30,22
1657212602328,MATH 18,B01,083748,Rideout; David Porter,4,0,37,33
1657212602328,MATH 18,B02,083749,Rideout; David Porter,4,0,36,32
1657212602328,MATH 18,B03,083750,Rideout; David Porter,2,0,37,35
1657212602328,MATH 18,B04,083751,Rideout; David Porter,5,0,36,31
1657212602328,MATH 18,B05,093473,Rideout; David Porter,5,0,36,31
1657212602328,MATH 18,B06,093474,Rideout; David Porter,5,0,36,31
1657212608354,MATH 20A,A01,083754,Zheng; Zequn,13,0,40,27
1657212614387,MATH 20B,A01,083756,Briones; Jor-el Thomas Caparas,2,0,36,34
1657212614387,MATH 20B,A02,083757,Briones; Jor-el Thomas Caparas,1,0,36,35
1657212614387,MATH 20B,A03,093475,Briones; Jor-el Thomas Caparas,1,0,36,35
1657212620414,MATH 20C,A01,083760,Briones; Jor-el Thomas Caparas,1,0,35,34
1657212620414,MATH 20C,A02,083761,Briones; Jor-el Thomas Caparas,8,0,35,27
1657212620414,MATH 20C,A03,093476,Briones; Jor-el Thomas Caparas,0,1,36,36
1657212620414,MATH 20C,B01,083762,Bach; Quang Tran,1,0,30,29
1657212626449,MATH 20D,A01,083765,Tran; Brian Kha,4,0,30,26
1657212626449,MATH 20D,A02,083766,Tran; Brian Kha,5,0,30,25
1657212626449,MATH 20D,A03,083767,Tran; Brian Kha,4,0,30,26
1657212632500,MATH 20E,A01,083771,Ganguly; Soumya,7,0,32,25
1657212632500,MATH 20E,A02,083772,Ganguly; Soumya,7,0,32,25
1657212632500,MATH 20E,B01,083773,Ciotti; Benjamin,19,0,35,16
1657212632500,MATH 20E,B02,083774,Ciotti; Benjamin,17,0,35,18
1657212638539,MATH 103A,A01,083777,Greenfeld; Be'Eri,2,0,36,34
1657212638539,MATH 103A,A02,083778,Greenfeld; Be'Eri,5,0,36,31
1657212638539,MATH 103A,A03,093561,Greenfeld; Be'Eri,4,0,36,32
1657212638539,MATH 103A,B01,083779,Greenfeld; Be'Eri,6,0,36,30
1657212638539,MATH 103A,B02,083780,Greenfeld; Be'Eri,3,0,36,33
1657212638539,MATH 103A,B03,093562,Greenfeld; Be'Eri,3,0,36,33
1657212644565,MATH 105,A01,085443,Carter; Anne Toulson,15,0,35,20
1657212644565,MATH 105,A02,093477,Carter; Anne Toulson,20,0,35,15
1657212650595,MATH 109,A01,083213,Ganzberger; Geoffrey Michael,2,0,34,32
1657212650595,MATH 109,A02,083214,Ganzberger; Geoffrey Michael,4,0,34,30
1657212650595,MATH 109,A03,093478,Ganzberger; Geoffrey Michael,2,0,34,32
1657212650595,MATH 109,B01,083215,Ganzberger; Geoffrey Michael,1,0,32,31
1657212650595,MATH 109,B02,083216,Ganzberger; Geoffrey Michael,1,0,32,31
1657212650595,MATH 109,B03,093479,Ganzberger; Geoffrey Michael,7,0,32,25
1657212656621,MATH 142A,A01,083219,Chow; Bennett,6,0,32,26
1657212656621,MATH 142A,A02,083220,Chow; Bennett,10,0,32,22
1657212656621,MATH 142A,A03,093480,Chow; Bennett,7,0,32,25
1657212656621,MATH 142A,B03,093481,Chow; Bennett,8,0,32,24
1657212656621,MATH 142A,B04,093558,Chow; Bennett,11,0,32,21
1657212656621,MATH 142A,B05,093559,Chow; Bennett,6,0,32,26
1657212662647,MATH 193A,A01,083224,Rotar; Vladimir,7,0,34,27
1657212662647,MATH 193A,A02,083225,Rotar; Vladimir,5,0,34,29
1657212662647,MATH 193A,A03,083781,Rotar; Vladimir,1,0,34,33
1657212662647,MATH 193A,A04,083782,Rotar; Vladimir,8,0,34,26
1657212662647,MATH 193A,A05,093482,Rotar; Vladimir,6,0,34,28
1657212668675,MATH 197,001,091859,McAuley; Julian John,9999,0,9999,0
1657212668675,MATH 197,002,095566,Kedlaya; Kiran S.,9997,0,9999,2
1657212668675,MATH 197,003,095567,Xiao; Ming,9999,0,9999,0
1657212668675,MATH 197,004,095571,Perols; Johan Lars,9998,0,9999,1
1657212675877,COGS 9,A01,083615,Shannon; Kyle Michael,7,0,75,68
1657212681927,COGS 11,A01,083617,Boyle; Mary E. T.,22,0,48,26
1657212687951,COGS 13,A01,083071,Bastos; Amalia Pinkusfeld,9,0,71,62
1657212693989,COGS 14A,A01,092681,Semenuks; Arturs,1,1,100,99
1657212700017,COGS 14B,A01,083073,Cheng; Tzu-Han,6,0,63,57
1657212706045,COGS 17,A01,092677,Semenuks; Arturs,4,0,81,77
1657212712084,COGS 100,A01,083619,Allen; Michael Gordon,15,0,70,55
1657212718122,COGS 101A,A01,083621,Davis; Joshua Daniel,9,0,68,59
1657212724164,COGS 101B,A01,091572,Allen; Michael Gordon,9,0,65,56
1657212730192,COGS 101C,A01,083625,Delgado; Tania,17,0,35,18
1657212736217,COGS 107A,A01,083627,Boyle; Mary E. T.,13,0,60,47
1657212742240,COGS 118A,A01,083075,Gupta; Anjum,16,0,76,60
1657212748296,CSE 3,A50,083646,Miranda; Gregory Joseph,24,0,50,26
1657212754327,CSE 8A,A50,083650,Miranda; Gregory Joseph,17,1,56,39
1657212760354,CSE 11,A01,083080,Cao; Yingjun,5,15,40,35
1657212766390,CSE 12,A01,083652,Krause-Levy; Sophia Louisa,24,1,120,96
1657212772441,CSE 15L,A01,083654,Morris; Justin Loren,9,0,50,41
1657212772441,CSE 15L,A02,083655,Morris; Justin Loren,9,0,50,41
1657212778480,CSE 20,A01,083657,Tran; Khoa Dang,38,0,80,42
1657212784520,CSE 21,A01,095574,Bach; Quang Tran,22,0,48,26
1657212790573,CSE 30,A01,083084,Eldon; John,4,0,80,76
1657212790573,CSE 30,B01,095061,Bhaskar; Nishant,7,0,50,43
1657212796603,CSE 100,A01,083659,Cao; Yingjun,4,4,70,66
1657212802641,CSE 134B,A01,083661,Powell; Thomas Allan,20,0,100,80
1657212808694,CSE 140,A01,083663,Gungor; Onat,13,0,85,72
1657212814717,CSE 140L,A01,083088,Eldon; John,17,0,100,83
1657212820769,CSE 175,A01,083665,Kumar; Rakesh,3,0,25,22
1657212826804,CSE 190,A00,092507,Dubnov; Shlomo,7,0,20,13
1657212832851,ECE 45,A01,083139,Congero; Spencer William,5,0,75,70
1657212838883,ECE 65,A50,083695,Saad; Andrew S,12,0,30,18
1657212838883,ECE 65,A51,095125,Saad; Andrew S,25,0,26,1
1657212844914,ECE 109,A01,091882,Touri; Behrouz,19,0,70,51
1657212850956,ECE 180,A00,083140,Abi Samra; Nicholas Camill,1,0,30,29
1657212850956,ECE 180,B00,083141,Abi Samra; Nicholas Camill,0,0,30,30
1657212856980,MATH 10A,A01,083735,Patchell; Gregory David,2,0,30,28
1657212856980,MATH 10A,A02,083736,Patchell; Gregory David,20,0,30,10
1657212856980,MATH 10A,A03,083737,Patchell; Gregory David,16,0,30,14
1657212863016,MATH 10B,A01,083207,Lim; Seonhee,7,0,34,27
1657212863016,MATH 10B,A02,083208,Lim; Seonhee,9,0,35,26
1657212863016,MATH 10B,A03,093472,Lim; Seonhee,5,0,34,29
1657212863016,MATH 10B,B01,083739,Sinha; Shubham,10,0,30,20
1657212869063,MATH 18,A01,083743,Cinel; Cameron Alexander,6,0,30,24
1657212869063,MATH 18,A02,083744,Cinel; Cameron Alexander,15,0,30,15
1657212869063,MATH 18,A03,083745,Cinel; Cameron Alexander,8,0,30,22
1657212869063,MATH 18,B01,083748,Rideout; David Porter,4,0,37,33
1657212869063,MATH 18,B02,083749,Rideout; David Porter,4,0,36,32
1657212869063,MATH 18,B03,083750,Rideout; David Porter,2,0,37,35
1657212869063,MATH 18,B04,083751,Rideout; David Porter,5,0,36,31
1657212869063,MATH 18,B05,093473,Rideout; David Porter,5,0,36,31
1657212869063,MATH 18,B06,093474,Rideout; David Porter,5,0,36,31
1657212875097,MATH 20A,A01,083754,Zheng; Zequn,13,0,40,27
1657212881128,MATH 20B,A01,083756,Briones; Jor-el Thomas Caparas,2,0,36,34
1657212881128,MATH 20B,A02,083757,Briones; Jor-el Thomas Caparas,1,0,36,35
1657212881128,MATH 20B,A03,093475,Briones; Jor-el Thomas Caparas,1,0,36,35
1657212887173,MATH 20C,A01,083760,Briones; Jor-el Thomas Caparas,1,0,35,34
1657212887173,MATH 20C,A02,083761,Briones; Jor-el Thomas Caparas,8,0,35,27
1657212887173,MATH 20C,A03,093476,Briones; Jor-el Thomas Caparas,0,1,36,36
1657212887173,MATH 20C,B01,083762,Bach; Quang Tran,1,0,30,29
1657212893209,MATH 20D,A01,083765,Tran; Brian Kha,4,0,30,26
1657212893209,MATH 20D,A02,083766,Tran; Brian Kha,5,0,30,25
1657212893209,MATH 20D,A03,083767,Tran; Brian Kha,4,0,30,26
1657212899254,MATH 20E,A01,083771,Ganguly; Soumya,7,0,32,25
1657212899254,MATH 20E,A02,083772,Ganguly; Soumya,7,0,32,25
1657212899254,MATH 20E,B01,083773,Ciotti; Benjamin,19,0,35,16
1657212899254,MATH 20E,B02,083774,Ciotti; Benjamin,17,0,35,18
1657212905287,MATH 103A,A01,083777,Greenfeld; Be'Eri,2,0,36,34
1657212905287,MATH 103A,A02,083778,Greenfeld; Be'Eri,5,0,36,31
1657212905287,MATH 103A,A03,093561,Greenfeld; Be'Eri,4,0,36,32
1657212905287,MATH 103A,B01,083779,Greenfeld; Be'Eri,6,0,36,30
1657212905287,MATH 103A,B02,083780,Greenfeld; Be'Eri,3,0,36,33
1657212905287,MATH 103A,B03,093562,Greenfeld; Be'Eri,3,0,36,33
1657212911340,MATH 105,A01,085443,Carter; Anne Toulson,15,0,35,20
1657212911340,MATH 105,A02,093477,Carter; Anne Toulson,20,0,35,15
1657212917379,MATH 109,A01,083213,Ganzberger; Geoffrey Michael,2,0,34,32
1657212917379,MATH 109,A02,083214,Ganzberger; Geoffrey Michael,4,0,34,30
1657212917379,MATH 109,A03,093478,Ganzberger; Geoffrey Michael,2,0,34,32
1657212917379,MATH 109,B01,083215,Ganzberger; Geoffrey Michael,1,0,32,31
1657212917379,MATH 109,B02,083216,Ganzberger; Geoffrey Michael,1,0,32,31
1657212917379,MATH 109,B03,093479,Ganzberger; Geoffrey Michael,7,0,32,25
1657212923409,MATH 142A,A01,083219,Chow; Bennett,6,0,32,26
1657212923409,MATH 142A,A02,083220,Chow; Bennett,10,0,32,22
1657212923409,MATH 142A,A03,093480,Chow; Bennett,7,0,32,25
1657212923409,MATH 142A,B03,093481,Chow; Bennett,8,0,32,24
1657212923409,MATH 142A,B04,093558,Chow; Bennett,11,0,32,21
1657212923409,MATH 142A,B05,093559,Chow; Bennett,6,0,32,26
1657212929445,MATH 193A,A01,083224,Rotar; Vladimir,7,0,34,27
1657212929445,MATH 193A,A02,083225,Rotar; Vladimir,5,0,34,29
1657212929445,MATH 193A,A03,083781,Rotar; Vladimir,1,0,34,33
1657212929445,MATH 193A,A04,083782,Rotar; Vladimir,8,0,34,26
1657212929445,MATH 193A,A05,093482,Rotar; Vladimir,6,0,34,28
1657212935492,MATH 197,001,091859,McAuley; Julian John,9999,0,9999,0
1657212935492,MATH 197,002,095566,Kedlaya; Kiran S.,9997,0,9999,2
1657212935492,MATH 197,003,095567,Xiao; Ming,9999,0,9999,0
1657212935492,MATH 197,004,095571,Perols; Johan Lars,9998,0,9999,1
1657212942595,COGS 9,A01,083615,Shannon; Kyle Michael,7,0,75,68
1657212948620,COGS 11,A01,083617,Boyle; Mary E. T.,22,0,48,26
1657212954646,COGS 13,A01,083071,Bastos; Amalia Pinkusfeld,9,0,71,62
1657212960681,COGS 14A,A01,092681,Semenuks; Arturs,1,1,100,99
1657212966707,COGS 14B,A01,083073,Cheng; Tzu-Han,6,0,63,57
1657212972732,COGS 17,A01,092677,Semenuks; Arturs,4,0,81,77
1657212978764,COGS 100,A01,083619,Allen; Michael Gordon,15,0,70,55
1657212984806,COGS 101A,A01,083621,Davis; Joshua Daniel,9,0,68,59
1657212990838,COGS 101B,A01,091572,Allen; Michael Gordon,9,0,65,56
1657212996877,COGS 101C,A01,083625,Delgado; Tania,17,0,35,18
1657213002919,COGS 107A,A01,083627,Boyle; Mary E. T.,13,0,60,47
1657213008963,COGS 118A,A01,083075,Gupta; Anjum,16,0,76,60
1657213014995,CSE 3,A50,083646,Miranda; Gregory Joseph,24,0,50,26
1657213021038,CSE 8A,A50,083650,Miranda; Gregory Joseph,17,1,56,39
1657213027065,CSE 11,A01,083080,Cao; Yingjun,5,15,40,35
1657213033106,CSE 12,A01,083652,Krause-Levy; Sophia Louisa,24,1,120,96
1657213039144,CSE 15L,A01,083654,Morris; Justin Loren,9,0,50,41
1657213039144,CSE 15L,A02,083655,Morris; Justin Loren,9,0,50,41
1657213045174,CSE 20,A01,083657,Tran; Khoa Dang,38,0,80,42
1657213051218,CSE 21,A01,095574,Bach; Quang Tran,22,0,48,26
1657213057248,CSE 30,A01,083084,Eldon; John,4,0,80,76
1657213057248,CSE 30,B01,095061,Bhaskar; Nishant,7,0,50,43
1657213063272,CSE 100,A01,083659,Cao; Yingjun,4,4,70,66
1657213069301,CSE 134B,A01,083661,Powell; Thomas Allan,20,0,100,80
1657213075325,CSE 140,A01,083663,Gungor; Onat,13,0,85,72
1657213081348,CSE 140L,A01,083088,Eldon; John,17,0,100,83
1657213087375,CSE 175,A01,083665,Kumar; Rakesh,3,0,25,22
1657213093401,CSE 190,A00,092507,Dubnov; Shlomo,7,0,20,13
1657213099444,ECE 45,A01,083139,Congero; Spencer William,5,0,75,70
1657213105470,ECE 65,A50,083695,Saad; Andrew S,12,0,30,18
1657213105470,ECE 65,A51,095125,Saad; Andrew S,25,0,26,1
1657213111527,ECE 109,A01,091882,Touri; Behrouz,19,0,70,51
1657213117558,ECE 180,A00,083140,Abi Samra; Nicholas Camill,1,0,30,29
1657213117558,ECE 180,B00,083141,Abi Samra; Nicholas Camill,0,0,30,30
1657213123592,MATH 10A,A01,083735,Patchell; Gregory David,2,0,30,28
1657213123592,MATH 10A,A02,083736,Patchell; Gregory David,20,0,30,10
1657213123592,MATH 10A,A03,083737,Patchell; Gregory David,16,0,30,14
1657213129632,MATH 10B,A01,083207,Lim; Seonhee,7,0,34,27
1657213129632,MATH 10B,A02,083208,Lim; Seonhee,9,0,35,26
1657213129632,MATH 10B,A03,093472,Lim; Seonhee,5,0,34,29
1657213129632,MATH 10B,B01,083739,Sinha; Shubham,10,0,30,20
1657213135670,MATH 18,A01,083743,Cinel; Cameron Alexander,6,0,30,24
1657213135670,MATH 18,A02,083744,Cinel; Cameron Alexander,15,0,30,15
1657213135670,MATH 18,A03,083745,Cinel; Cameron Alexander,8,0,30,22
1657213135670,MATH 18,B01,083748,Rideout; David Porter,4,0,37,33
1657213135670,MATH 18,B02,083749,Rideout; David Porter,4,0,36,32
1657213135670,MATH 18,B03,083750,Rideout; David Porter,2,0,37,35
1657213135670,MATH 18,B04,083751,Rideout; David Porter,5,0,36,31
1657213135670,MATH 18,B05,093473,Rideout; David Porter,5,0,36,31
1657213135670,MATH 18,B06,093474,Rideout; David Porter,5,0,36,31
1657213141703,MATH 20A,A01,083754,Zheng; Zequn,13,0,40,27
1657213147748,MATH 20B,A01,083756,Briones; Jor-el Thomas Caparas,2,0,36,34
1657213147748,MATH 20B,A02,083757,Briones; Jor-el Thomas Caparas,1,0,36,35
1657213147748,MATH 20B,A03,093475,Briones; Jor-el Thomas Caparas,1,0,36,35
1657213153782,MATH 20C,A01,083760,Briones; Jor-el Thomas Caparas,1,0,35,34
1657213153782,MATH 20C,A02,083761,Briones; Jor-el Thomas Caparas,8,0,35,27
1657213153782,MATH 20C,A03,093476,Briones; Jor-el Thomas Caparas,0,1,36,36
1657213153782,MATH 20C,B01,083762,Bach; Quang Tran,1,0,30,29
1657213159827,MATH 20D,A01,083765,Tran; Brian Kha,4,0,30,26
1657213159827,MATH 20D,A02,083766,Tran; Brian Kha,5,0,30,25
1657213159827,MATH 20D,A03,083767,Tran; Brian Kha,4,0,30,26
1657213165867,MATH 20E,A01,083771,Ganguly; Soumya,7,0,32,25
1657213165867,MATH 20E,A02,083772,Ganguly; Soumya,7,0,32,25
1657213165867,MATH 20E,B01,083773,Ciotti; Benjamin,19,0,35,16
1657213165867,MATH 20E,B02,083774,Ciotti; Benjamin,17,0,35,18
1657213171893,MATH 103A,A01,083777,Greenfeld; Be'Eri,2,0,36,34
1657213171893,MATH 103A,A02,083778,Greenfeld; Be'Eri,5,0,36,31
1657213171893,MATH 103A,A03,093561,Greenfeld; Be'Eri,4,0,36,32
1657213171893,MATH 103A,B01,083779,Greenfeld; Be'Eri,6,0,36,30
1657213171893,MATH 103A,B02,083780,Greenfeld; Be'Eri,3,0,36,33
1657213171893,MATH 103A,B03,093562,Greenfeld; Be'Eri,3,0,36,33
1657213177925,MATH 105,A01,085443,Carter; Anne Toulson,15,0,35,20
1657213177925,MATH 105,A02,093477,Carter; Anne Toulson,20,0,35,15
1657213183949,MATH 109,A01,083213,Ganzberger; Geoffrey Michael,2,0,34,32
1657213183949,MATH 109,A02,083214,Ganzberger; Geoffrey Michael,4,0,34,30
1657213183949,MATH 109,A03,093478,Ganzberger; Geoffrey Michael,2,0,34,32
1657213183949,MATH 109,B01,083215,Ganzberger; Geoffrey Michael,1,0,32,31
1657213183949,MATH 109,B02,083216,Ganzberger; Geoffrey Michael,1,0,32,31
1657213183949,MATH 109,B03,093479,Ganzberger; Geoffrey Michael,7,0,32,25
1657213189977,MATH 142A,A01,083219,Chow; Bennett,6,0,32,26
1657213189977,MATH 142A,A02,083220,Chow; Bennett,10,0,32,22
1657213189977,MATH 142A,A03,093480,Chow; Bennett,7,0,32,25
1657213189977,MATH 142A,B03,093481,Chow; Bennett,8,0,32,24
1657213189977,MATH 142A,B04,093558,Chow; Bennett,11,0,32,21
1657213189977,MATH 142A,B05,093559,Chow; Bennett,6,0,32,26
1657213195999,MATH 193A,A01,083224,Rotar; Vladimir,7,0,34,27
1657213195999,MATH 193A,A02,083225,Rotar; Vladimir,5,0,34,29
1657213195999,MATH 193A,A03,083781,Rotar; Vladimir,1,0,34,33
1657213195999,MATH 193A,A04,083782,Rotar; Vladimir,8,0,34,26
1657213195999,MATH 193A,A05,093482,Rotar; Vladimir,6,0,34,28
1657213202031,MATH 197,001,091859,McAuley; Julian John,9999,0,9999,0
1657213202031,MATH 197,002,095566,Kedlaya; Kiran S.,9997,0,9999,2
1657213202031,MATH 197,003,095567,Xiao; Ming,9999,0,9999,0
1657213202031,MATH 197,004,095571,Perols; Johan Lars,9998,0,9999,1
1657213209095,COGS 9,A01,083615,Shannon; Kyle Michael,7,0,75,68
1657213215140,COGS 11,A01,083617,Boyle; Mary E. T.,22,0,48,26
1657213221180,COGS 13,A01,083071,Bastos; Amalia Pinkusfeld,9,0,71,62
1657213227229,COGS 14A,A01,092681,Semenuks; Arturs,1,1,100,99
1657213233251,COGS 14B,A01,083073,Cheng; Tzu-Han,6,0,63,57
1657213239288,COGS 17,A01,092677,Semenuks; Arturs,4,0,81,77
1657213245320,COGS 100,A01,083619,Allen; Michael Gordon,15,0,70,55
1657213251352,COGS 101A,A01,083621,Davis; Joshua Daniel,9,0,68,59
1657213257381,COGS 101B,A01,091572,Allen; Michael Gordon,9,0,65,56
1657213263412,COGS 101C,A01,083625,Delgado; Tania,17,0,35,18
1657213269508,COGS 107A,A01,083627,Boyle; Mary E. T.,13,0,60,47
1657213275545,COGS 118A,A01,083075,Gupta; Anjum,16,0,76,60
1657213281585,CSE 3,A50,083646,Miranda; Gregory Joseph,24,0,50,26
1657213287608,CSE 8A,A50,083650,Miranda; Gregory Joseph,17,1,56,39
1657213293631,CSE 11,A01,083080,Cao; Yingjun,5,15,40,35
1657213299655,CSE 12,A01,083652,Krause-Levy; Sophia Louisa,24,1,120,96
1657213305691,CSE 15L,A01,083654,Morris; Justin Loren,9,0,50,41
1657213305691,CSE 15L,A02,083655,Morris; Justin Loren,9,0,50,41
1657213311721,CSE 20,A01,083657,Tran; Khoa Dang,38,0,80,42
1657213317761,CSE 21,A01,095574,Bach; Quang Tran,22,0,48,26
1657213323788,CSE 30,A01,083084,Eldon; John,4,0,80,76
1657213323788,CSE 30,B01,095061,Bhaskar; Nishant,7,0,50,43
1657213329834,CSE 100,A01,083659,Cao; Yingjun,4,4,70,66
1657213335862,CSE 134B,A01,083661,Powell; Thomas Allan,20,0,100,80
1657213341888,CSE 140,A01,083663,Gungor; Onat,13,0,85,72
1657213347912,CSE 140L,A01,083088,Eldon; John,17,0,100,83
1657213353958,CSE 175,A01,083665,Kumar; Rakesh,3,0,25,22
1657213360013,CSE 190,A00,092507,Dubnov; Shlomo,7,0,20,13
1657213366037,ECE 45,A01,083139,Congero; Spencer William,5,0,75,70
1657213372073,ECE 65,A50,083695,Saad; Andrew S,12,0,30,18
1657213372073,ECE 65,A51,095125,Saad; Andrew S,25,0,26,1
1657213378101,ECE 109,A01,091882,Touri; Behrouz,19,0,70,51
1657213384125,ECE 180,A00,083140,Abi Samra; Nicholas Camill,1,0,30,29
1657213384125,ECE 180,B00,083141,Abi Samra; Nicholas Camill,0,0,30,30
1657213390160,MATH 10A,A01,083735,Patchell; Gregory David,2,0,30,28
1657213390160,MATH 10A,A02,083736,Patchell; Gregory David,20,0,30,10
1657213390160,MATH 10A,A03,083737,Patchell; Gregory David,16,0,30,14
1657213396189,MATH 10B,A01,083207,Lim; Seonhee,7,0,34,27
1657213396189,MATH 10B,A02,083208,Lim; Seonhee,9,0,35,26
1657213396189,MATH 10B,A03,093472,Lim; Seonhee,5,0,34,29
1657213396189,MATH 10B,B01,083739,Sinha; Shubham,10,0,30,20
1657213402235,MATH 18,A01,083743,Cinel; Cameron Alexander,6,0,30,24
1657213402235,MATH 18,A02,083744,Cinel; Cameron Alexander,15,0,30,15
1657213402235,MATH 18,A03,083745,Cinel; Cameron Alexander,8,0,30,22
1657213402235,MATH 18,B01,083748,Rideout; David Porter,4,0,37,33
1657213402235,MATH 18,B02,083749,Rideout; David Porter,4,0,36,32
1657213402235,MATH 18,B03,083750,Rideout; David Porter,2,0,37,35
1657213402235,MATH 18,B04,083751,Rideout; David Porter,5,0,36,31
1657213402235,MATH 18,B05,093473,Rideout; David Porter,5,0,36,31
1657213402235,MATH 18,B06,093474,Rideout; David Porter,5,0,36,31
1657213408267,MATH 20A,A01,083754,Zheng; Zequn,13,0,40,27
1657213414323,MATH 20B,A01,083756,Briones; Jor-el Thomas Caparas,2,0,36,34
1657213414323,MATH 20B,A02,083757,Briones; Jor-el Thomas Caparas,1,0,36,35
1657213414323,MATH 20B,A03,093475,Briones; Jor-el Thomas Caparas,1,0,36,35
1657213420376,MATH 20C,A01,083760,Briones; Jor-el Thomas Caparas,1,0,35,34
1657213420376,MATH 20C,A02,083761,Briones; Jor-el Thomas Caparas,8,0,35,27
1657213420376,MATH 20C,A03,093476,Briones; Jor-el Thomas Caparas,0,1,36,36
1657213420376,MATH 20C,B01,083762,Bach; Quang Tran,1,0,30,29
1657213426407,MATH 20D,A01,083765,Tran; Brian Kha,4,0,30,26
1657213426407,MATH 20D,A02,083766,Tran; Brian Kha,5,0,30,25
1657213426407,MATH 20D,A03,083767,Tran; Brian Kha,4,0,30,26
1657213432432,MATH 20E,A01,083771,Ganguly; Soumya,7,0,32,25
1657213432432,MATH 20E,A02,083772,Ganguly; Soumya,7,0,32,25
1657213432432,MATH 20E,B01,083773,Ciotti; Benjamin,19,0,35,16
1657213432432,MATH 20E,B02,083774,Ciotti; Benjamin,17,0,35,18
1657213438463,MATH 103A,A01,083777,Greenfeld; Be'Eri,2,0,36,34
1657213438463,MATH 103A,A02,083778,Greenfeld; Be'Eri,5,0,36,31
1657213438463,MATH 103A,A03,093561,Greenfeld; Be'Eri,4,0,36,32
1657213438463,MATH 103A,B01,083779,Greenfeld; Be'Eri,6,0,36,30
1657213438463,MATH 103A,B02,083780,Greenfeld; Be'Eri,3,0,36,33
1657213438463,MATH 103A,B03,093562,Greenfeld; Be'Eri,3,0,36,33
1657213444517,MATH 105,A01,085443,Carter; Anne Toulson,15,0,35,20
1657213444517,MATH 105,A02,093477,Carter; Anne Toulson,20,0,35,15
1657213450547,MATH 109,A01,083213,Ganzberger; Geoffrey Michael,2,0,34,32
1657213450547,MATH 109,A02,083214,Ganzberger; Geoffrey Michael,4,0,34,30
1657213450547,MATH 109,A03,093478,Ganzberger; Geoffrey Michael,2,0,34,32
1657213450547,MATH 109,B01,083215,Ganzberger; Geoffrey Michael,1,0,32,31
1657213450547,MATH 109,B02,083216,Ganzberger; Geoffrey Michael,1,0,32,31
1657213450547,MATH 109,B03,093479,Ganzberger; Geoffrey Michael,7,0,32,25
1657213456572,MATH 142A,A01,083219,Chow; Bennett,6,0,32,26
1657213456572,MATH 142A,A02,083220,Chow; Bennett,10,0,32,22
1657213456572,MATH 142A,A03,093480,Chow; Bennett,7,0,32,25
1657213456572,MATH 142A,B03,093481,Chow; Bennett,8,0,32,24
1657213456572,MATH 142A,B04,093558,Chow; Bennett,11,0,32,21
1657213456572,MATH 142A,B05,093559,Chow; Bennett,6,0,32,26
1657213462601,MATH 193A,A01,083224,Rotar; Vladimir,7,0,34,27
1657213462601,MATH 193A,A02,083225,Rotar; Vladimir,5,0,34,29
1657213462601,MATH 193A,A03,083781,Rotar; Vladimir,1,0,34,33
1657213462601,MATH 193A,A04,083782,Rotar; Vladimir,8,0,34,26
1657213462601,MATH 193A,A05,093482,Rotar; Vladimir,6,0,34,28
1657213468628,MATH 197,001,091859,McAuley; Julian John,9999,0,9999,0
1657213468628,MATH 197,002,095566,Kedlaya; Kiran S.,9997,0,9999,2
1657213468628,MATH 197,003,095567,Xiao; Ming,9999,0,9999,0
1657213468628,MATH 197,004,095571,Perols; Johan Lars,9998,0,9999,1
1657213475708,COGS 9,A01,083615,Shannon; Kyle Michael,7,0,75,68
1657213481735,COGS 11,A01,083617,Boyle; Mary E. T.,22,0,48,26
1657213487782,COGS 13,A01,083071,Bastos; Amalia Pinkusfeld,9,0,71,62
1657213493805,COGS 14A,A01,092681,Semenuks; Arturs,1,1,100,99
1657213499829,COGS 14B,A01,083073,Cheng; Tzu-Han,6,0,63,57
1657213505860,COGS 17,A01,092677,Semenuks; Arturs,4,0,81,77
1657213511885,COGS 100,A01,083619,Allen; Michael Gordon,15,0,70,55
1657213517920,COGS 101A,A01,083621,Davis; Joshua Daniel,9,0,68,59
1657213523954,COGS 101B,A01,091572,Allen; Michael Gordon,9,0,65,56
1657213529980,COGS 101C,A01,083625,Delgado; Tania,17,0,35,18
1657213536015,COGS 107A,A01,083627,Boyle; Mary E. T.,13,0,60,47
1657213542042,COGS 118A,A01,083075,Gupta; Anjum,16,0,76,60
1657213548077,CSE 3,A50,083646,Miranda; Gregory Joseph,24,0,50,26
1657213554111,CSE 8A,A50,083650,Miranda; Gregory Joseph,17,1,56,39
1657213560146,CSE 11,A01,083080,Cao; Yingjun,5,15,40,35
1657213566192,CSE 12,A01,083652,Krause-Levy; Sophia Louisa,24,1,120,96
1657213572215,CSE 15L,A01,083654,Morris; Justin Loren,9,0,50,41
1657213572215,CSE 15L,A02,083655,Morris; Justin Loren,9,0,50,41
1657213578257,CSE 20,A01,083657,Tran; Khoa Dang,38,0,80,42
1657213584281,CSE 21,A01,095574,Bach; Quang Tran,22,0,48,26
1657213590305,CSE 30,A01,083084,Eldon; John,4,0,80,76
1657213590305,CSE 30,B01,095061,Bhaskar; Nishant,7,0,50,43
1657213596336,CSE 100,A01,083659,Cao; Yingjun,4,4,70,66
1657213602365,CSE 134B,A01,083661,Powell; Thomas Allan,20,0,100,80
1657213608387,CSE 140,A01,083663,Gungor; Onat,13,0,85,72
1657213614412,CSE 140L,A01,083088,Eldon; John,17,0,100,83
1657213620439,CSE 175,A01,083665,Kumar; Rakesh,3,0,25,22
1657213626465,CSE 190,A00,092507,Dubnov; Shlomo,7,0,20,13
1657213632520,ECE 45,A01,083139,Congero; Spencer William,5,0,75,70
1657213638564,ECE 65,A50,083695,Saad; Andrew S,12,0,30,18
1657213638564,ECE 65,A51,095125,Saad; Andrew S,25,0,26,1
1657213644587,ECE 109,A01,091882,Touri; Behrouz,19,0,70,51
1657213650614,ECE 180,A00,083140,Abi Samra; Nicholas Camill,1,0,30,29
1657213650614,ECE 180,B00,083141,Abi Samra; Nicholas Camill,0,0,30,30
1657213656651,MATH 10A,A01,083735,Patchell; Gregory David,2,0,30,28
1657213656651,MATH 10A,A02,083736,Patchell; Gregory David,20,0,30,10
1657213656651,MATH 10A,A03,083737,Patchell; Gregory David,16,0,30,14
1657213662682,MATH 10B,A01,083207,Lim; Seonhee,7,0,34,27
1657213662682,MATH 10B,A02,083208,Lim; Seonhee,9,0,35,26
1657213662682,MATH 10B,A03,093472,Lim; Seonhee,5,0,34,29
1657213662682,MATH 10B,B01,083739,Sinha; Shubham,10,0,30,20
1657213668706,MATH 18,A01,083743,Cinel; Cameron Alexander,6,0,30,24
1657213668706,MATH 18,A02,083744,Cinel; Cameron Alexander,15,0,30,15
1657213668706,MATH 18,A03,083745,Cinel; Cameron Alexander,8,0,30,22
1657213668706,MATH 18,B01,083748,Rideout; David Porter,4,0,37,33
1657213668706,MATH 18,B02,083749,Rideout; David Porter,4,0,36,32
1657213668706,MATH 18,B03,083750,Rideout; David Porter,2,0,37,35
1657213668706,MATH 18,B04,083751,Rideout; David Porter,5,0,36,31
1657213668706,MATH 18,B05,093473,Rideout; David Porter,5,0,36,31
1657213668706,MATH 18,B06,093474,Rideout; David Porter,5,0,36,31
1657213674728,MATH 20A,A01,083754,Zheng; Zequn,13,0,40,27
1657213680760,MATH 20B,A01,083756,Briones; Jor-el Thomas Caparas,2,0,36,34
1657213680760,MATH 20B,A02,083757,Briones; Jor-el Thomas Caparas,1,0,36,35
1657213680760,MATH 20B,A03,093475,Briones; Jor-el Thomas Caparas,1,0,36,35
1657213686798,MATH 20C,A01,083760,Briones; Jor-el Thomas Caparas,1,0,35,34
1657213686798,MATH 20C,A02,083761,Briones; Jor-el Thomas Caparas,8,0,35,27
1657213686798,MATH 20C,A03,093476,Briones; Jor-el Thomas Caparas,0,1,36,36
1657213686798,MATH 20C,B01,083762,Bach; Quang Tran,1,0,30,29
1657213692847,MATH 20D,A01,083765,Tran; Brian Kha,4,0,30,26
1657213692847,MATH 20D,A02,083766,Tran; Brian Kha,5,0,30,25
1657213692847,MATH 20D,A03,083767,Tran; Brian Kha,4,0,30,26
1657213698870,MATH 20E,A01,083771,Ganguly; Soumya,7,0,32,25
1657213698870,MATH 20E,A02,083772,Ganguly; Soumya,7,0,32,25
1657213698870,MATH 20E,B01,083773,Ciotti; Benjamin,19,0,35,16
1657213698870,MATH 20E,B02,083774,Ciotti; Benjamin,17,0,35,18
1657213704904,MATH 103A,A01,083777,Greenfeld; Be'Eri,2,0,36,34
1657213704904,MATH 103A,A02,083778,Greenfeld; Be'Eri,5,0,36,31
1657213704904,MATH 103A,A03,093561,Greenfeld; Be'Eri,4,0,36,32
1657213704904,MATH 103A,B01,083779,Greenfeld; Be'Eri,6,0,36,30
1657213704904,MATH 103A,B02,083780,Greenfeld; Be'Eri,3,0,36,33
1657213704904,MATH 103A,B03,093562,Greenfeld; Be'Eri,3,0,36,33
1657213710927,MATH 105,A01,085443,Carter; Anne Toulson,15,0,35,20
1657213710927,MATH 105,A02,093477,Carter; Anne Toulson,20,0,35,15
1657213716971,MATH 109,A01,083213,Ganzberger; Geoffrey Michael,2,0,34,32
1657213716971,MATH 109,A02,083214,Ganzberger; Geoffrey Michael,4,0,34,30
1657213716971,MATH 109,A03,093478,Ganzberger; Geoffrey Michael,2,0,34,32
1657213716971,MATH 109,B01,083215,Ganzberger; Geoffrey Michael,1,0,32,31
1657213716971,MATH 109,B02,083216,Ganzberger; Geoffrey Michael,1,0,32,31
1657213716971,MATH 109,B03,093479,Ganzberger; Geoffrey Michael,7,0,32,25
1657213722998,MATH 142A,A01,083219,Chow; Bennett,6,0,32,26
1657213722998,MATH 142A,A02,083220,Chow; Bennett,10,0,32,22
1657213722998,MATH 142A,A03,093480,Chow; Bennett,7,0,32,25
1657213722998,MATH 142A,B03,093481,Chow; Bennett,8,0,32,24
1657213722998,MATH 142A,B04,093558,Chow; Bennett,11,0,32,21
1657213722998,MATH 142A,B05,093559,Chow; Bennett,6,0,32,26
1657213729028,MATH 193A,A01,083224,Rotar; Vladimir,7,0,34,27
1657213729028,MATH 193A,A02,083225,Rotar; Vladimir,5,0,34,29
1657213729028,MATH 193A,A03,083781,Rotar; Vladimir,1,0,34,33
1657213729028,MATH 193A,A04,083782,Rotar; Vladimir,8,0,34,26
1657213729028,MATH 193A,A05,093482,Rotar; Vladimir,6,0,34,28
1657213735051,MATH 197,001,091859,McAuley; Julian John,9999,0,9999,0
1657213735051,MATH 197,002,095566,Kedlaya; Kiran S.,9997,0,9999,2
1657213735051,MATH 197,003,095567,Xiao; Ming,9999,0,9999,0
1657213735051,MATH 197,004,095571,Perols; Johan Lars,9998,0,9999,1
1657213742142,COGS 9,A01,083615,Shannon; Kyle Michael,7,0,75,68
1657213748168,COGS 11,A01,083617,Boyle; Mary E. T.,22,0,48,26
1657213754203,COGS 13,A01,083071,Bastos; Amalia Pinkusfeld,9,0,71,62
1657213760234,COGS 14A,A01,092681,Semenuks; Arturs,1,1,100,99
1657213766272,COGS 14B,A01,083073,Cheng; Tzu-Han,6,0,63,57
1657213772298,COGS 17,A01,092677,Semenuks; Arturs,4,0,81,77
1657213778331,COGS 100,A01,083619,Allen; Michael Gordon,15,0,70,55
1657213784359,COGS 101A,A01,083621,Davis; Joshua Daniel,9,0,68,59
1657213790401,COGS 101B,A01,091572,Allen; Michael Gordon,9,0,65,56
1657213796440,COGS 101C,A01,083625,Delgado; Tania,17,0,35,18
1657213802463,COGS 107A,A01,083627,Boyle; Mary E. T.,13,0,60,47
1657213808504,COGS 118A,A01,083075,Gupta; Anjum,16,0,76,60
1657213814529,CSE 3,A50,083646,Miranda; Gregory Joseph,24,0,50,26
1657213820580,CSE 8A,A50,083650,Miranda; Gregory Joseph,17,1,56,39
1657213826609,CSE 11,A01,083080,Cao; Yingjun,5,15,40,35
1657213832648,CSE 12,A01,083652,Krause-Levy; Sophia Louisa,24,1,120,96
1657213838674,CSE 15L,A01,083654,Morris; Justin Loren,9,0,50,41
1657213838674,CSE 15L,A02,083655,Morris; Justin Loren,9,0,50,41
1657213844718,CSE 20,A01,083657,Tran; Khoa Dang,38,0,80,42
1657213850753,CSE 21,A01,095574,Bach; Quang Tran,22,0,48,26
1657213856780,CSE 30,A01,083084,Eldon; John,4,0,80,76
1657213856780,CSE 30,B01,095061,Bhaskar; Nishant,7,0,50,43
1657213862813,CSE 100,A01,083659,Cao; Yingjun,4,4,70,66
1657213868947,CSE 134B,A01,083661,Powell; Thomas Allan,20,0,100,80
1657213874981,CSE 140,A01,083663,Gungor; Onat,13,0,85,72
1657213881017,CSE 140L,A01,083088,Eldon; John,17,0,100,83
1657213887051,CSE 175,A01,083665,Kumar; Rakesh,3,0,25,22
1657213893109,CSE 190,A00,092507,Dubnov; Shlomo,7,0,20,13
1657213899140,ECE 45,A01,083139,Congero; Spencer William,5,0,75,70
1657213905169,ECE 65,A50,083695,Saad; Andrew S,12,0,30,18
1657213905169,ECE 65,A51,095125,Saad; Andrew S,25,0,26,1
1657213911192,ECE 109,A01,091882,Touri; Behrouz,19,0,70,51
1657213917214,ECE 180,A00,083140,Abi Samra; Nicholas Camill,1,0,30,29
1657213917214,ECE 180,B00,083141,Abi Samra; Nicholas Camill,0,0,30,30
1657213923241,MATH 10A,A01,083735,Patchell; Gregory David,2,0,30,28
1657213923241,MATH 10A,A02,083736,Patchell; Gregory David,20,0,30,10
1657213923241,MATH 10A,A03,083737,Patchell; Gregory David,16,0,30,14
1657213929290,MATH 10B,A01,083207,Lim; Seonhee,7,0,34,27
1657213929290,MATH 10B,A02,083208,Lim; Seonhee,9,0,35,26
1657213929290,MATH 10B,A03,093472,Lim; Seonhee,5,0,34,29
1657213929290,MATH 10B,B01,083739,Sinha; Shubham,10,0,30,20
1657213935327,MATH 18,A01,083743,Cinel; Cameron Alexander,6,0,30,24
1657213935327,MATH 18,A02,083744,Cinel; Cameron Alexander,15,0,30,15
1657213935327,MATH 18,A03,083745,Cinel; Cameron Alexander,8,0,30,22
1657213935327,MATH 18,B01,083748,Rideout; David Porter,4,0,37,33
1657213935327,MATH 18,B02,083749,Rideout; David Porter,4,0,36,32
1657213935327,MATH 18,B03,083750,Rideout; David Porter,2,0,37,35
1657213935327,MATH 18,B04,083751,Rideout; David Porter,5,0,36,31
1657213935327,MATH 18,B05,093473,Rideout; David Porter,5,0,36,31
1657213935327,MATH 18,B06,093474,Rideout; David Porter,5,0,36,31
1657213941349,MATH 20A,A01,083754,Zheng; Zequn,13,0,40,27
1657213947373,MATH 20B,A01,083756,Briones; Jor-el Thomas Caparas,2,0,36,34
1657213947373,MATH 20B,A02,083757,Briones; Jor-el Thomas Caparas,1,0,36,35
1657213947373,MATH 20B,A03,093475,Briones; Jor-el Thomas Caparas,1,0,36,35
1657213953413,MATH 20C,A01,083760,Briones; Jor-el Thomas Caparas,1,0,35,34
1657213953413,MATH 20C,A02,083761,Briones; Jor-el Thomas Caparas,8,0,35,27
1657213953413,MATH 20C,A03,093476,Briones; Jor-el Thomas Caparas,0,1,36,36
1657213953413,MATH 20C,B01,083762,Bach; Quang Tran,1,0,30,29
1657213959446,MATH 20D,A01,083765,Tran; Brian Kha,4,0,30,26
1657213959446,MATH 20D,A02,083766,Tran; Brian Kha,5,0,30,25
1657213959446,MATH 20D,A03,083767,Tran; Brian Kha,4,0,30,26
1657213965476,MATH 20E,A01,083771,Ganguly; Soumya,7,0,32,25
1657213965476,MATH 20E,A02,083772,Ganguly; Soumya,7,0,32,25
1657213965476,MATH 20E,B01,083773,Ciotti; Benjamin,19,0,35,16
1657213965476,MATH 20E,B02,083774,Ciotti; Benjamin,17,0,35,18
1657213971518,MATH 103A,A01,083777,Greenfeld; Be'Eri,2,0,36,34
1657213971518,MATH 103A,A02,083778,Greenfeld; Be'Eri,5,0,36,31
1657213971518,MATH 103A,A03,093561,Greenfeld; Be'Eri,4,0,36,32
1657213971518,MATH 103A,B01,083779,Greenfeld; Be'Eri,6,0,36,30
1657213971518,MATH 103A,B02,083780,Greenfeld; Be'Eri,3,0,36,33
1657213971518,MATH 103A,B03,093562,Greenfeld; Be'Eri,3,0,36,33
1657213977554,MATH 105,A01,085443,Carter; Anne Toulson,15,0,35,20
1657213977554,MATH 105,A02,093477,Carter; Anne Toulson,20,0,35,15
1657213983608,MATH 109,A01,083213,Ganzberger; Geoffrey Michael,2,0,34,32
1657213983608,MATH 109,A02,083214,Ganzberger; Geoffrey Michael,4,0,34,30
1657213983608,MATH 109,A03,093478,Ganzberger; Geoffrey Michael,2,0,34,32
1657213983608,MATH 109,B01,083215,Ganzberger; Geoffrey Michael,1,0,32,31
1657213983608,MATH 109,B02,083216,Ganzberger; Geoffrey Michael,1,0,32,31
1657213983608,MATH 109,B03,093479,Ganzberger; Geoffrey Michael,7,0,32,25
1657213989643,MATH 142A,A01,083219,Chow; Bennett,6,0,32,26
1657213989643,MATH 142A,A02,083220,Chow; Bennett,10,0,32,22
1657213989643,MATH 142A,A03,093480,Chow; Bennett,7,0,32,25
1657213989643,MATH 142A,B03,093481,Chow; Bennett,8,0,32,24
1657213989643,MATH 142A,B04,093558,Chow; Bennett,11,0,32,21
1657213989643,MATH 142A,B05,093559,Chow; Bennett,6,0,32,26
1657213995673,MATH 193A,A01,083224,Rotar; Vladimir,7,0,34,27
1657213995673,MATH 193A,A02,083225,Rotar; Vladimir,5,0,34,29
1657213995673,MATH 193A,A03,083781,Rotar; Vladimir,1,0,34,33
1657213995673,MATH 193A,A04,083782,Rotar; Vladimir,8,0,34,26
1657213995673,MATH 193A,A05,093482,Rotar; Vladimir,6,0,34,28
1657214001705,MATH 197,001,091859,McAuley; Julian John,9999,0,9999,0
1657214001705,MATH 197,002,095566,Kedlaya; Kiran S.,9997,0,9999,2
1657214001705,MATH 197,003,095567,Xiao; Ming,9999,0,9999,0
1657214001705,MATH 197,004,095571,Perols; Johan Lars,9998,0,9999,1
1657214008790,COGS 9,A01,083615,Shannon; Kyle Michael,7,0,75,68
1657214014840,COGS 11,A01,083617,Boyle; Mary E. T.,22,0,48,26
1657214020870,COGS 13,A01,083071,Bastos; Amalia Pinkusfeld,9,0,71,62
1657214026892,COGS 14A,A01,092681,Semenuks; Arturs,1,1,100,99
1657214032947,COGS 14B,A01,083073,Cheng; Tzu-Han,6,0,63,57
1657214038970,COGS 17,A01,092677,Semenuks; Arturs,4,0,81,77
1657214045005,COGS 100,A01,083619,Allen; Michael Gordon,15,0,70,55
1657214051049,COGS 101A,A01,083621,Davis; Joshua Daniel,9,0,68,59
1657214057074,COGS 101B,A01,091572,Allen; Michael Gordon,9,0,65,56
1657214063127,COGS 101C,A01,083625,Delgado; Tania,17,0,35,18
1657214069153,COGS 107A,A01,083627,Boyle; Mary E. T.,13,0,60,47
1657214075181,COGS 118A,A01,083075,Gupta; Anjum,16,0,76,60
1657214081206,CSE 3,A50,083646,Miranda; Gregory Joseph,24,0,50,26
1657214087237,CSE 8A,A50,083650,Miranda; Gregory Joseph,17,1,56,39
1657214093262,CSE 11,A01,083080,Cao; Yingjun,5,15,40,35
1657214099302,CSE 12,A01,083652,Krause-Levy; Sophia Louisa,24,1,120,96
1657214105334,CSE 15L,A01,083654,Morris; Justin Loren,9,0,50,41
1657214105334,CSE 15L,A02,083655,Morris; Justin Loren,9,0,50,41
1657214111392,CSE 20,A01,083657,Tran; Khoa Dang,38,0,80,42
1657214117413,CSE 21,A01,095574,Bach; Quang Tran,22,0,48,26
1657214123448,CSE 30,A01,083084,Eldon; John,4,0,80,76
1657214123448,CSE 30,B01,095061,Bhaskar; Nishant,7,0,50,43
1657214129500,CSE 100,A01,083659,Cao; Yingjun,4,4,70,66
1657214135533,CSE 134B,A01,083661,Powell; Thomas Allan,20,0,100,80
1657214141565,CSE 140,A01,083663,Gungor; Onat,13,0,85,72
1657214147593,CSE 140L,A01,083088,Eldon; John,17,0,100,83
1657214153633,CSE 175,A01,083665,Kumar; Rakesh,3,0,25,22
1657214159668,CSE 190,A00,092507,Dubnov; Shlomo,7,0,20,13
1657214165703,ECE 45,A01,083139,Congero; Spencer William,5,0,75,70
1657214171728,ECE 65,A50,083695,Saad; Andrew S,12,0,30,18
1657214171728,ECE 65,A51,095125,Saad; Andrew S,25,0,26,1
1657214177782,ECE 109,A01,091882,Touri; Behrouz,19,0,70,51
1657214183838,ECE 180,A00,083140,Abi Samra; Nicholas Camill,1,0,30,29
1657214183838,ECE 180,B00,083141,Abi Samra; Nicholas Camill,0,0,30,30
1657214189876,MATH 10A,A01,083735,Patchell; Gregory David,2,0,30,28
1657214189876,MATH 10A,A02,083736,Patchell; Gregory David,20,0,30,10
1657214189876,MATH 10A,A03,083737,Patchell; Gregory David,16,0,30,14
1657214195907,MATH 10B,A01,083207,Lim; Seonhee,7,0,34,27
1657214195907,MATH 10B,A02,083208,Lim; Seonhee,9,0,35,26
1657214195907,MATH 10B,A03,093472,Lim; Seonhee,5,0,34,29
1657214195907,MATH 10B,B01,083739,Sinha; Shubham,10,0,30,20
1657214201946,MATH 18,A01,083743,Cinel; Cameron Alexander,6,0,30,24
1657214201946,MATH 18,A02,083744,Cinel; Cameron Alexander,15,0,30,15
1657214201946,MATH 18,A03,083745,Cinel; Cameron Alexander,8,0,30,22
1657214201946,MATH 18,B01,083748,Rideout; David Porter,4,0,37,33
1657214201946,MATH 18,B02,083749,Rideout; David Porter,4,0,36,32
1657214201946,MATH 18,B03,083750,Rideout; David Porter,2,0,37,35
1657214201946,MATH 18,B04,083751,Rideout; David Porter,5,0,36,31
1657214201946,MATH 18,B05,093473,Rideout; David Porter,5,0,36,31
1657214201946,MATH 18,B06,093474,Rideout; David Porter,5,0,36,31
1657214207976,MATH 20A,A01,083754,Zheng; Zequn,13,0,40,27
1657214214004,MATH 20B,A01,083756,Briones; Jor-el Thomas Caparas,2,0,36,34
1657214214004,MATH 20B,A02,083757,Briones; Jor-el Thomas Caparas,1,0,36,35
1657214214004,MATH 20B,A03,093475,Briones; Jor-el Thomas Caparas,1,0,36,35
1657214220027,MATH 20C,A01,083760,Briones; Jor-el Thomas Caparas,1,0,35,34
1657214220027,MATH 20C,A02,083761,Briones; Jor-el Thomas Caparas,8,0,35,27
1657214220027,MATH 20C,A03,093476,Briones; Jor-el Thomas Caparas,0,1,36,36
1657214220027,MATH 20C,B01,083762,Bach; Quang Tran,1,0,30,29
1657214226055,MATH 20D,A01,083765,Tran; Brian Kha,4,0,30,26
1657214226055,MATH 20D,A02,083766,Tran; Brian Kha,5,0,30,25
1657214226055,MATH 20D,A03,083767,Tran; Brian Kha,4,0,30,26
1657214232102,MATH 20E,A01,083771,Ganguly; Soumya,7,0,32,25
1657214232102,MATH 20E,A02,083772,Ganguly; Soumya,7,0,32,25
1657214232102,MATH 20E,B01,083773,Ciotti; Benjamin,19,0,35,16
1657214232102,MATH 20E,B02,083774,Ciotti; Benjamin,17,0,35,18
1657214238130,MATH 103A,A01,083777,Greenfeld; Be'Eri,2,0,36,34
1657214238130,MATH 103A,A02,083778,Greenfeld; Be'Eri,5,0,36,31
1657214238130,MATH 103A,A03,093561,Greenfeld; Be'Eri,4,0,36,32
1657214238130,MATH 103A,B01,083779,Greenfeld; Be'Eri,6,0,36,30
1657214238130,MATH 103A,B02,083780,Greenfeld; Be'Eri,3,0,36,33
1657214238130,MATH 103A,B03,093562,Greenfeld; Be'Eri,3,0,36,33
1657214244155,MATH 105,A01,085443,Carter; Anne Toulson,15,0,35,20
1657214244155,MATH 105,A02,093477,Carter; Anne Toulson,20,0,35,15
1657214250203,MATH 109,A01,083213,Ganzberger; Geoffrey Michael,2,0,34,32
1657214250203,MATH 109,A02,083214,Ganzberger; Geoffrey Michael,4,0,34,30
1657214250203,MATH 109,A03,093478,Ganzberger; Geoffrey Michael,2,0,34,32
1657214250203,MATH 109,B01,083215,Ganzberger; Geoffrey Michael,1,0,32,31
1657214250203,MATH 109,B02,083216,Ganzberger; Geoffrey Michael,1,0,32,31
1657214250203,MATH 109,B03,093479,Ganzberger; Geoffrey Michael,7,0,32,25
1657214256227,MATH 142A,A01,083219,Chow; Bennett,6,0,32,26
1657214256227,MATH 142A,A02,083220,Chow; Bennett,10,0,32,22
1657214256227,MATH 142A,A03,093480,Chow; Bennett,7,0,32,25
1657214256227,MATH 142A,B03,093481,Chow; Bennett,8,0,32,24
1657214256227,MATH 142A,B04,093558,Chow; Bennett,11,0,32,21
1657214256227,MATH 142A,B05,093559,Chow; Bennett,6,0,32,26
1657214262269,MATH 193A,A01,083224,Rotar; Vladimir,7,0,34,27
1657214262269,MATH 193A,A02,083225,Rotar; Vladimir,5,0,34,29
1657214262269,MATH 193A,A03,083781,Rotar; Vladimir,1,0,34,33
1657214262269,MATH 193A,A04,083782,Rotar; Vladimir,8,0,34,26
1657214262269,MATH 193A,A05,093482,Rotar; Vladimir,6,0,34,28
1657214268309,MATH 197,001,091859,McAuley; Julian John,9999,0,9999,0
1657214268309,MATH 197,002,095566,Kedlaya; Kiran S.,9997,0,9999,2
1657214268309,MATH 197,003,095567,Xiao; Ming,9999,0,9999,0
1657214268309,MATH 197,004,095571,Perols; Johan Lars,9998,0,9999,1
1657214275385,COGS 9,A01,083615,Shannon; Kyle Michael,8,0,75,67
1657214281411,COGS 11,A01,083617,Boyle; Mary E. T.,22,0,48,26
1657214287442,COGS 13,A01,083071,Bastos; Amalia Pinkusfeld,9,0,71,62
1657214293473,COGS 14A,A01,092681,Semenuks; Arturs,1,1,100,99
1657214299503,COGS 14B,A01,083073,Cheng; Tzu-Han,6,0,63,57
1657214305537,COGS 17,A01,092677,Semenuks; Arturs,4,0,81,77
1657214311561,COGS 100,A01,083619,Allen; Michael Gordon,15,0,70,55
1657214317583,COGS 101A,A01,083621,Davis; Joshua Daniel,9,0,68,59
1657214323605,COGS 101B,A01,091572,Allen; Michael Gordon,9,0,65,56
1657214329628,COGS 101C,A01,083625,Delgado; Tania,17,0,35,18
1657214335653,COGS 107A,A01,083627,Boyle; Mary E. T.,13,0,60,47
1657214341688,COGS 118A,A01,083075,Gupta; Anjum,16,0,76,60
1657214347731,CSE 3,A50,083646,Miranda; Gregory Joseph,24,0,50,26
1657214353758,CSE 8A,A50,083650,Miranda; Gregory Joseph,17,1,56,39
1657214359786,CSE 11,A01,083080,Cao; Yingjun,5,15,40,35
1657214365811,CSE 12,A01,083652,Krause-Levy; Sophia Louisa,24,1,120,96
1657214371837,CSE 15L,A01,083654,Morris; Justin Loren,9,0,50,41
1657214371837,CSE 15L,A02,083655,Morris; Justin Loren,9,0,50,41
1657214377866,CSE 20,A01,083657,Tran; Khoa Dang,38,0,80,42
1657214383892,CSE 21,A01,095574,Bach; Quang Tran,22,0,48,26
1657214389916,CSE 30,A01,083084,Eldon; John,4,0,80,76
1657214389916,CSE 30,B01,095061,Bhaskar; Nishant,7,0,50,43
1657214395942,CSE 100,A01,083659,Cao; Yingjun,4,4,70,66
1657214401970,CSE 134B,A01,083661,Powell; Thomas Allan,20,0,100,80
1657214407995,CSE 140,A01,083663,Gungor; Onat,13,0,85,72
1657214414036,CSE 140L,A01,083088,Eldon; John,17,0,100,83
1657214420071,CSE 175,A01,083665,Kumar; Rakesh,3,0,25,22
1657214426094,CSE 190,A00,092507,Dubnov; Shlomo,7,0,20,13
1657214432141,ECE 45,A01,083139,Congero; Spencer William,5,0,75,70
1657214438196,ECE 65,A50,083695,Saad; Andrew S,12,0,30,18
1657214438196,ECE 65,A51,095125,Saad; Andrew S,25,0,26,1
1657214444223,ECE 109,A01,091882,Touri; Behrouz,19,0,70,51
1657214450244,ECE 180,A00,083140,Abi Samra; Nicholas Camill,1,0,30,29
1657214450244,ECE 180,B00,083141,Abi Samra; Nicholas Camill,0,0,30,30
1657214456296,MATH 10A,A01,083735,Patchell; Gregory David,2,0,30,28
1657214456296,MATH 10A,A02,083736,Patchell; Gregory David,20,0,30,10
1657214456296,MATH 10A,A03,083737,Patchell; Gregory David,16,0,30,14
1657214462339,MATH 10B,A01,083207,Lim; Seonhee,7,0,34,27
1657214462339,MATH 10B,A02,083208,Lim; Seonhee,9,0,35,26
1657214462339,MATH 10B,A03,093472,Lim; Seonhee,5,0,34,29
1657214462339,MATH 10B,B01,083739,Sinha; Shubham,10,0,30,20
1657214468451,MATH 18,A01,083743,Cinel; Cameron Alexander,6,0,30,24
1657214468451,MATH 18,A02,083744,Cinel; Cameron Alexander,15,0,30,15
1657214468451,MATH 18,A03,083745,Cinel; Cameron Alexander,8,0,30,22
1657214468451,MATH 18,B01,083748,Rideout; David Porter,4,0,37,33
1657214468451,MATH 18,B02,083749,Rideout; David Porter,4,0,36,32
1657214468451,MATH 18,B03,083750,Rideout; David Porter,2,0,37,35
1657214468451,MATH 18,B04,083751,Rideout; David Porter,5,0,36,31
1657214468451,MATH 18,B05,093473,Rideout; David Porter,5,0,36,31
1657214468451,MATH 18,B06,093474,Rideout; David Porter,5,0,36,31
1657214474474,MATH 20A,A01,083754,Zheng; Zequn,13,0,40,27
1657214480497,MATH 20B,A01,083756,Briones; Jor-el Thomas Caparas,2,0,36,34
1657214480497,MATH 20B,A02,083757,Briones; Jor-el Thomas Caparas,1,0,36,35
1657214480497,MATH 20B,A03,093475,Briones; Jor-el Thomas Caparas,1,0,36,35
1657214486521,MATH 20C,A01,083760,Briones; Jor-el Thomas Caparas,1,0,35,34
1657214486521,MATH 20C,A02,083761,Briones; Jor-el Thomas Caparas,8,0,35,27
1657214486521,MATH 20C,A03,093476,Briones; Jor-el Thomas Caparas,0,1,36,36
1657214486521,MATH 20C,B01,083762,Bach; Quang Tran,1,0,30,29
1657214492548,MATH 20D,A01,083765,Tran; Brian Kha,4,0,30,26
1657214492548,MATH 20D,A02,083766,Tran; Brian Kha,5,0,30,25
1657214492548,MATH 20D,A03,083767,Tran; Brian Kha,4,0,30,26
1657214498580,MATH 20E,A01,083771,Ganguly; Soumya,7,0,32,25
1657214498580,MATH 20E,A02,083772,Ganguly; Soumya,7,0,32,25
1657214498580,MATH 20E,B01,083773,Ciotti; Benjamin,19,0,35,16
1657214498580,MATH 20E,B02,083774,Ciotti; Benjamin,17,0,35,18
1657214504612,MATH 103A,A01,083777,Greenfeld; Be'Eri,2,0,36,34
1657214504612,MATH 103A,A02,083778,Greenfeld; Be'Eri,5,0,36,31
1657214504612,MATH 103A,A03,093561,Greenfeld; Be'Eri,4,0,36,32
1657214504612,MATH 103A,B01,083779,Greenfeld; Be'Eri,6,0,36,30
1657214504612,MATH 103A,B02,083780,Greenfeld; Be'Eri,3,0,36,33
1657214504612,MATH 103A,B03,093562,Greenfeld; Be'Eri,3,0,36,33
1657214510640,MATH 105,A01,085443,Carter; Anne Toulson,15,0,35,20
1657214510640,MATH 105,A02,093477,Carter; Anne Toulson,20,0,35,15
1657214516672,MATH 109,A01,083213,Ganzberger; Geoffrey Michael,2,0,34,32
1657214516672,MATH 109,A02,083214,Ganzberger; Geoffrey Michael,4,0,34,30
1657214516672,MATH 109,A03,093478,Ganzberger; Geoffrey Michael,2,0,34,32
1657214516672,MATH 109,B01,083215,Ganzberger; Geoffrey Michael,1,0,32,31
1657214516672,MATH 109,B02,083216,Ganzberger; Geoffrey Michael,1,0,32,31
1657214516672,MATH 109,B03,093479,Ganzberger; Geoffrey Michael,7,0,32,25
1657214522702,MATH 142A,A01,083219,Chow; Bennett,6,0,32,26
1657214522702,MATH 142A,A02,083220,Chow; Bennett,10,0,32,22
1657214522702,MATH 142A,A03,093480,Chow; Bennett,7,0,32,25
1657214522702,MATH 142A,B03,093481,Chow; Bennett,8,0,32,24
1657214522702,MATH 142A,B04,093558,Chow; Bennett,11,0,32,21
1657214522702,MATH 142A,B05,093559,Chow; Bennett,6,0,32,26
1657214528758,MATH 193A,A01,083224,Rotar; Vladimir,7,0,34,27
1657214528758,MATH 193A,A02,083225,Rotar; Vladimir,5,0,34,29
1657214528758,MATH 193A,A03,083781,Rotar; Vladimir,1,0,34,33
1657214528758,MATH 193A,A04,083782,Rotar; Vladimir,8,0,34,26
1657214528758,MATH 193A,A05,093482,Rotar; Vladimir,6,0,34,28
1657214534784,MATH 197,001,091859,McAuley; Julian John,9999,0,9999,0
1657214534784,MATH 197,002,095566,Kedlaya; Kiran S.,9997,0,9999,2
1657214534784,MATH 197,003,095567,Xiao; Ming,9999,0,9999,0
1657214534784,MATH 197,004,095571,Perols; Johan Lars,9998,0,9999,1
1657214541852,COGS 9,A01,083615,Shannon; Kyle Michael,8,0,75,67
1657214547875,COGS 11,A01,083617,Boyle; Mary E. T.,22,0,48,26
1657214553897,COGS 13,A01,083071,Bastos; Amalia Pinkusfeld,9,0,71,62
1657214559929,COGS 14A,A01,092681,Semenuks; Arturs,1,1,100,99
1657214565971,COGS 14B,A01,083073,Cheng; Tzu-Han,6,0,63,57
1657214571999,COGS 17,A01,092677,Semenuks; Arturs,4,0,81,77
1657214578046,COGS 100,A01,083619,Allen; Michael Gordon,15,0,70,55
1657214584080,COGS 101A,A01,083621,Davis; Joshua Daniel,9,0,68,59
1657214590123,COGS 101B,A01,091572,Allen; Michael Gordon,9,0,65,56
1657214596145,COGS 101C,A01,083625,Delgado; Tania,17,0,35,18
1657214602193,COGS 107A,A01,083627,Boyle; Mary E. T.,13,0,60,47
1657214608239,COGS 118A,A01,083075,Gupta; Anjum,16,0,76,60
1657214614273,CSE 3,A50,083646,Miranda; Gregory Joseph,24,0,50,26
1657214620300,CSE 8A,A50,083650,Miranda; Gregory Joseph,17,1,56,39
1657214626323,CSE 11,A01,083080,Cao; Yingjun,5,15,40,35
1657214632347,CSE 12,A01,083652,Krause-Levy; Sophia Louisa,24,1,120,96
1657214638390,CSE 15L,A01,083654,Morris; Justin Loren,9,0,50,41
1657214638390,CSE 15L,A02,083655,Morris; Justin Loren,9,0,50,41
1657214644413,CSE 20,A01,083657,Tran; Khoa Dang,38,0,80,42
1657214650444,CSE 21,A01,095574,Bach; Quang Tran,22,0,48,26
1657214656467,CSE 30,A01,083084,Eldon; John,4,0,80,76
1657214656467,CSE 30,B01,095061,Bhaskar; Nishant,7,0,50,43
1657214662501,CSE 100,A01,083659,Cao; Yingjun,4,4,70,66
1657214668523,CSE 134B,A01,083661,Powell; Thomas Allan,20,0,100,80
1657214674549,CSE 140,A01,083663,Gungor; Onat,13,0,85,72
1657214680585,CSE 140L,A01,083088,Eldon; John,17,0,100,83
1657214686622,CSE 175,A01,083665,Kumar; Rakesh,3,0,25,22
1657214692649,CSE 190,A00,092507,Dubnov; Shlomo,7,0,20,13
1657214698682,ECE 45,A01,083139,Congero; Spencer William,5,0,75,70
1657214704720,ECE 65,A50,083695,Saad; Andrew S,12,0,30,18
1657214704720,ECE 65,A51,095125,Saad; Andrew S,25,0,26,1
1657214710743,ECE 109,A01,091882,Touri; Behrouz,19,0,70,51
1657214716775,ECE 180,A00,083140,Abi Samra; Nicholas Camill,1,0,30,29
1657214716775,ECE 180,B00,083141,Abi Samra; Nicholas Camill,0,0,30,30
1657214722800,MATH 10A,A01,083735,Patchell; Gregory David,2,0,30,28
1657214722800,MATH 10A,A02,083736,Patchell; Gregory David,20,0,30,10
1657214722800,MATH 10A,A03,083737,Patchell; Gregory David,16,0,30,14
1657214728823,MATH 10B,A01,083207,Lim; Seonhee,7,0,34,27
1657214728823,MATH 10B,A02,083208,Lim; Seonhee,9,0,35,26
1657214728823,MATH 10B,A03,093472,Lim; Seonhee,5,0,34,29
1657214728823,MATH 10B,B01,083739,Sinha; Shubham,10,0,30,20
1657214734877,MATH 18,A01,083743,Cinel; Cameron Alexander,6,0,30,24
1657214734877,MATH 18,A02,083744,Cinel; Cameron Alexander,15,0,30,15
1657214734877,MATH 18,A03,083745,Cinel; Cameron Alexander,8,0,30,22
1657214734877,MATH 18,B01,083748,Rideout; David Porter,4,0,37,33
1657214734877,MATH 18,B02,083749,Rideout; David Porter,4,0,36,32
1657214734877,MATH 18,B03,083750,Rideout; David Porter,2,0,37,35
1657214734877,MATH 18,B04,083751,Rideout; David Porter,5,0,36,31
1657214734877,MATH 18,B05,093473,Rideout; David Porter,5,0,36,31
1657214734877,MATH 18,B06,093474,Rideout; David Porter,5,0,36,31
1657214740901,MATH 20A,A01,083754,Zheng; Zequn,13,0,40,27
1657214746935,MATH 20B,A01,083756,Briones; Jor-el Thomas Caparas,2,0,36,34
1657214746935,MATH 20B,A02,083757,Briones; Jor-el Thomas Caparas,1,0,36,35
1657214746935,MATH 20B,A03,093475,Briones; Jor-el Thomas Caparas,1,0,36,35
1657214752978,MATH 20C,A01,083760,Briones; Jor-el Thomas Caparas,1,0,35,34
1657214752978,MATH 20C,A02,083761,Briones; Jor-el Thomas Caparas,8,0,35,27
1657214752978,MATH 20C,A03,093476,Briones; Jor-el Thomas Caparas,0,1,36,36
1657214752978,MATH 20C,B01,083762,Bach; Quang Tran,1,0,30,29
1657214759001,MATH 20D,A01,083765,Tran; Brian Kha,4,0,30,26
1657214759001,MATH 20D,A02,083766,Tran; Brian Kha,5,0,30,25
1657214759001,MATH 20D,A03,083767,Tran; Brian Kha,4,0,30,26
1657214765034,MATH 20E,A01,083771,Ganguly; Soumya,7,0,32,25
1657214765034,MATH 20E,A02,083772,Ganguly; Soumya,7,0,32,25
1657214765034,MATH 20E,B01,083773,Ciotti; Benjamin,19,0,35,16
1657214765034,MATH 20E,B02,083774,Ciotti; Benjamin,17,0,35,18
1657214771074,MATH 103A,A01,083777,Greenfeld; Be'Eri,2,0,36,34
1657214771074,MATH 103A,A02,083778,Greenfeld; Be'Eri,5,0,36,31
1657214771074,MATH 103A,A03,093561,Greenfeld; Be'Eri,4,0,36,32
1657214771074,MATH 103A,B01,083779,Greenfeld; Be'Eri,6,0,36,30
1657214771074,MATH 103A,B02,083780,Greenfeld; Be'Eri,3,0,36,33
1657214771074,MATH 103A,B03,093562,Greenfeld; Be'Eri,3,0,36,33
1657214777095,MATH 105,A01,085443,Carter; Anne Toulson,15,0,35,20
1657214777095,MATH 105,A02,093477,Carter; Anne Toulson,20,0,35,15
1657214783148,MATH 109,A01,083213,Ganzberger; Geoffrey Michael,2,0,34,32
1657214783148,MATH 109,A02,083214,Ganzberger; Geoffrey Michael,4,0,34,30
1657214783148,MATH 109,A03,093478,Ganzberger; Geoffrey Michael,2,0,34,32
1657214783148,MATH 109,B01,083215,Ganzberger; Geoffrey Michael,1,0,32,31
1657214783148,MATH 109,B02,083216,Ganzberger; Geoffrey Michael,1,0,32,31
1657214783148,MATH 109,B03,093479,Ganzberger; Geoffrey Michael,7,0,32,25
1657214789177,MATH 142A,A01,083219,Chow; Bennett,6,0,32,26
1657214789177,MATH 142A,A02,083220,Chow; Bennett,10,0,32,22
1657214789177,MATH 142A,A03,093480,Chow; Bennett,7,0,32,25
1657214789177,MATH 142A,B03,093481,Chow; Bennett,8,0,32,24
1657214789177,MATH 142A,B04,093558,Chow; Bennett,11,0,32,21
1657214789177,MATH 142A,B05,093559,Chow; Bennett,6,0,32,26
1657214795213,MATH 193A,A01,083224,Rotar; Vladimir,7,0,34,27
1657214795213,MATH 193A,A02,083225,Rotar; Vladimir,5,0,34,29
1657214795213,MATH 193A,A03,083781,Rotar; Vladimir,1,0,34,33
1657214795213,MATH 193A,A04,083782,Rotar; Vladimir,8,0,34,26
1657214795213,MATH 193A,A05,093482,Rotar; Vladimir,6,0,34,28
1657214801252,MATH 197,001,091859,McAuley; Julian John,9999,0,9999,0
1657214801252,MATH 197,002,095566,Kedlaya; Kiran S.,9997,0,9999,2
1657214801252,MATH 197,003,095567,Xiao; Ming,9999,0,9999,0
1657214801252,MATH 197,004,095571,Perols; Johan Lars,9998,0,9999,1
1657214808317,COGS 9,A01,083615,Shannon; Kyle Michael,8,0,75,67
1657214814351,COGS 11,A01,083617,Boyle; Mary E. T.,22,0,48,26
1657214820376,COGS 13,A01,083071,Bastos; Amalia Pinkusfeld,9,0,71,62
1657214826409,COGS 14A,A01,092681,Semenuks; Arturs,1,1,100,99
1657214832433,COGS 14B,A01,083073,Cheng; Tzu-Han,6,0,63,57
1657214838480,COGS 17,A01,092677,Semenuks; Arturs,4,0,81,77
1657214844506,COGS 100,A01,083619,Allen; Michael Gordon,15,0,70,55
1657214850537,COGS 101A,A01,083621,Davis; Joshua Daniel,9,0,68,59
1657214856578,COGS 101B,A01,091572,Allen; Michael Gordon,9,0,65,56
1657214862613,COGS 101C,A01,083625,Delgado; Tania,17,0,35,18
1657214868663,COGS 107A,A01,083627,Boyle; Mary E. T.,13,0,60,47
1657214874717,COGS 118A,A01,083075,Gupta; Anjum,16,0,76,60
1657214880746,CSE 3,A50,083646,Miranda; Gregory Joseph,24,0,50,26
1657214886770,CSE 8A,A50,083650,Miranda; Gregory Joseph,17,1,56,39
1657214892809,CSE 11,A01,083080,Cao; Yingjun,5,15,40,35
1657214898832,CSE 12,A01,083652,Krause-Levy; Sophia Louisa,24,1,120,96
1657214904855,CSE 15L,A01,083654,Morris; Justin Loren,9,0,50,41
1657214904855,CSE 15L,A02,083655,Morris; Justin Loren,9,0,50,41
1657214910883,CSE 20,A01,083657,Tran; Khoa Dang,38,0,80,42
1657214916926,CSE 21,A01,095574,Bach; Quang Tran,22,0,48,26
1657214922951,CSE 30,A01,083084,Eldon; John,4,0,80,76
1657214922951,CSE 30,B01,095061,Bhaskar; Nishant,7,0,50,43
1657214929007,CSE 100,A01,083659,Cao; Yingjun,4,4,70,66
1657214935031,CSE 134B,A01,083661,Powell; Thomas Allan,20,0,100,80
1657214941073,CSE 140,A01,083663,Gungor; Onat,13,0,85,72
1657214947114,CSE 140L,A01,083088,Eldon; John,17,0,100,83
1657214953141,CSE 175,A01,083665,Kumar; Rakesh,3,0,25,22
1657214959165,CSE 190,A00,092507,Dubnov; Shlomo,7,0,20,13
1657214965203,ECE 45,A01,083139,Congero; Spencer William,5,0,75,70
1657214971232,ECE 65,A50,083695,Saad; Andrew S,12,0,30,18
1657214971232,ECE 65,A51,095125,Saad; Andrew S,25,0,26,1
1657214977260,ECE 109,A01,091882,Touri; Behrouz,19,0,70,51
1657214983283,ECE 180,A00,083140,Abi Samra; Nicholas Camill,1,0,30,29
1657214983283,ECE 180,B00,083141,Abi Samra; Nicholas Camill,0,0,30,30
1657214989336,MATH 10A,A01,083735,Patchell; Gregory David,2,0,30,28
1657214989336,MATH 10A,A02,083736,Patchell; Gregory David,20,0,30,10
1657214989336,MATH 10A,A03,083737,Patchell; Gregory David,16,0,30,14
1657214995369,MATH 10B,A01,083207,Lim; Seonhee,7,0,34,27
1657214995369,MATH 10B,A02,083208,Lim; Seonhee,9,0,35,26
1657214995369,MATH 10B,A03,093472,Lim; Seonhee,5,0,34,29
1657214995369,MATH 10B,B01,083739,Sinha; Shubham,10,0,30,20
1657215001410,MATH 18,A01,083743,Cinel; Cameron Alexander,6,0,30,24
1657215001410,MATH 18,A02,083744,Cinel; Cameron Alexander,15,0,30,15
1657215001410,MATH 18,A03,083745,Cinel; Cameron Alexander,8,0,30,22
1657215001410,MATH 18,B01,083748,Rideout; David Porter,4,0,37,33
1657215001410,MATH 18,B02,083749,Rideout; David Porter,4,0,36,32
1657215001410,MATH 18,B03,083750,Rideout; David Porter,2,0,37,35
1657215001410,MATH 18,B04,083751,Rideout; David Porter,5,0,36,31
1657215001410,MATH 18,B05,093473,Rideout; David Porter,5,0,36,31
1657215001410,MATH 18,B06,093474,Rideout; David Porter,5,0,36,31
1657215007433,MATH 20A,A01,083754,Zheng; Zequn,13,0,40,27
1657215013477,MATH 20B,A01,083756,Briones; Jor-el Thomas Caparas,2,0,36,34
1657215013477,MATH 20B,A02,083757,Briones; Jor-el Thomas Caparas,1,0,36,35
1657215013477,MATH 20B,A03,093475,Briones; Jor-el Thomas Caparas,1,0,36,35
1657215019509,MATH 20C,A01,083760,Briones; Jor-el Thomas Caparas,1,0,35,34
1657215019509,MATH 20C,A02,083761,Briones; Jor-el Thomas Caparas,8,0,35,27
1657215019509,MATH 20C,A03,093476,Briones; Jor-el Thomas Caparas,0,1,36,36
1657215019509,MATH 20C,B01,083762,Bach; Quang Tran,1,0,30,29
1657215025541,MATH 20D,A01,083765,Tran; Brian Kha,4,0,30,26
1657215025541,MATH 20D,A02,083766,Tran; Brian Kha,5,0,30,25
1657215025541,MATH 20D,A03,083767,Tran; Brian Kha,4,0,30,26
1657215031597,MATH 20E,A01,083771,Ganguly; Soumya,7,0,32,25
1657215031597,MATH 20E,A02,083772,Ganguly; Soumya,7,0,32,25
1657215031597,MATH 20E,B01,083773,Ciotti; Benjamin,19,0,35,16
1657215031597,MATH 20E,B02,083774,Ciotti; Benjamin,17,0,35,18
1657215037634,MATH 103A,A01,083777,Greenfeld; Be'Eri,2,0,36,34
1657215037634,MATH 103A,A02,083778,Greenfeld; Be'Eri,5,0,36,31
1657215037634,MATH 103A,A03,093561,Greenfeld; Be'Eri,4,0,36,32
1657215037634,MATH 103A,B01,083779,Greenfeld; Be'Eri,6,0,36,30
1657215037634,MATH 103A,B02,083780,Greenfeld; Be'Eri,3,0,36,33
1657215037634,MATH 103A,B03,093562,Greenfeld; Be'Eri,3,0,36,33
1657215043676,MATH 105,A01,085443,Carter; Anne Toulson,15,0,35,20
1657215043676,MATH 105,A02,093477,Carter; Anne Toulson,20,0,35,15
1657215049711,MATH 109,A01,083213,Ganzberger; Geoffrey Michael,2,0,34,32
1657215049711,MATH 109,A02,083214,Ganzberger; Geoffrey Michael,4,0,34,30
1657215049711,MATH 109,A03,093478,Ganzberger; Geoffrey Michael,2,0,34,32
1657215049711,MATH 109,B01,083215,Ganzberger; Geoffrey Michael,1,0,32,31
1657215049711,MATH 109,B02,083216,Ganzberger; Geoffrey Michael,1,0,32,31
1657215049711,MATH 109,B03,093479,Ganzberger; Geoffrey Michael,7,0,32,25
1657215055734,MATH 142A,A01,083219,Chow; Bennett,6,0,32,26
1657215055734,MATH 142A,A02,083220,Chow; Bennett,10,0,32,22
1657215055734,MATH 142A,A03,093480,Chow; Bennett,7,0,32,25
1657215055734,MATH 142A,B03,093481,Chow; Bennett,8,0,32,24
1657215055734,MATH 142A,B04,093558,Chow; Bennett,11,0,32,21
1657215055734,MATH 142A,B05,093559,Chow; Bennett,6,0,32,26
1657215061772,MATH 193A,A01,083224,Rotar; Vladimir,7,0,34,27
1657215061772,MATH 193A,A02,083225,Rotar; Vladimir,5,0,34,29
1657215061772,MATH 193A,A03,083781,Rotar; Vladimir,1,0,34,33
1657215061772,MATH 193A,A04,083782,Rotar; Vladimir,8,0,34,26
1657215061772,MATH 193A,A05,093482,Rotar; Vladimir,6,0,34,28
1657215067912,MATH 197,001,091859,McAuley; Julian John,9999,0,9999,0
1657215067912,MATH 197,002,095566,Kedlaya; Kiran S.,9997,0,9999,2
1657215067912,MATH 197,003,095567,Xiao; Ming,9999,0,9999,0
1657215067912,MATH 197,004,095571,Perols; Johan Lars,9998,0,9999,1
1657215074982,COGS 9,A01,083615,Shannon; Kyle Michael,8,0,75,67
1657215081016,COGS 11,A01,083617,Boyle; Mary E. T.,22,0,48,26
1657215087044,COGS 13,A01,083071,Bastos; Amalia Pinkusfeld,9,0,71,62
1657215093074,COGS 14A,A01,092681,Semenuks; Arturs,1,1,100,99
1657215099114,COGS 14B,A01,083073,Cheng; Tzu-Han,6,0,63,57
1657215105144,COGS 17,A01,092677,Semenuks; Arturs,4,0,81,77
1657215111172,COGS 100,A01,083619,Allen; Michael Gordon,15,0,70,55
1657215117210,COGS 101A,A01,083621,Davis; Joshua Daniel,9,0,68,59
1657215123238,COGS 101B,A01,091572,Allen; Michael Gordon,9,0,65,56
1657215129284,COGS 101C,A01,083625,Delgado; Tania,17,0,35,18
1657215135322,COGS 107A,A01,083627,Boyle; Mary E. T.,13,0,60,47
1657215141347,COGS 118A,A01,083075,Gupta; Anjum,16,0,76,60
1657215147389,CSE 3,A50,083646,Miranda; Gregory Joseph,24,0,50,26
1657215153416,CSE 8A,A50,083650,Miranda; Gregory Joseph,17,1,56,39
1657215159446,CSE 11,A01,083080,Cao; Yingjun,5,15,40,35
1657215165479,CSE 12,A01,083652,Krause-Levy; Sophia Louisa,24,1,120,96
1657215171506,CSE 15L,A01,083654,Morris; Justin Loren,9,0,50,41
1657215171506,CSE 15L,A02,083655,Morris; Justin Loren,9,0,50,41
1657215177548,CSE 20,A01,083657,Tran; Khoa Dang,38,0,80,42
1657215183570,CSE 21,A01,095574,Bach; Quang Tran,22,0,48,26
1657215189596,CSE 30,A01,083084,Eldon; John,4,0,80,76
1657215189596,CSE 30,B01,095061,Bhaskar; Nishant,8,0,50,42
1657215195626,CSE 100,A01,083659,Cao; Yingjun,4,4,70,66
1657215201663,CSE 134B,A01,083661,Powell; Thomas Allan,20,0,100,80
1657215207704,CSE 140,A01,083663,Gungor; Onat,13,0,85,72
1657215213755,CSE 140L,A01,083088,Eldon; John,17,0,100,83
1657215219777,CSE 175,A01,083665,Kumar; Rakesh,3,0,25,22
1657215225817,CSE 190,A00,092507,Dubnov; Shlomo,7,0,20,13
1657215231846,ECE 45,A01,083139,Congero; Spencer William,5,0,75,70
1657215237885,ECE 65,A50,083695,Saad; Andrew S,12,0,30,18
1657215237885,ECE 65,A51,095125,Saad; Andrew S,25,0,26,1
1657215243918,ECE 109,A01,091882,Touri; Behrouz,19,0,70,51
1657215249945,ECE 180,A00,083140,Abi Samra; Nicholas Camill,1,0,30,29
1657215249945,ECE 180,B00,083141,Abi Samra; Nicholas Camill,0,0,30,30
1657215255974,MATH 10A,A01,083735,Patchell; Gregory David,2,0,30,28
1657215255974,MATH 10A,A02,083736,Patchell; Gregory David,20,0,30,10
1657215255974,MATH 10A,A03,083737,Patchell; Gregory David,16,0,30,14
1657215262002,MATH 10B,A01,083207,Lim; Seonhee,7,0,34,27
1657215262002,MATH 10B,A02,083208,Lim; Seonhee,9,0,35,26
1657215262002,MATH 10B,A03,093472,Lim; Seonhee,5,0,34,29
1657215262002,MATH 10B,B01,083739,Sinha; Shubham,10,0,30,20
1657215268030,MATH 18,A01,083743,Cinel; Cameron Alexander,6,0,30,24
1657215268030,MATH 18,A02,083744,Cinel; Cameron Alexander,15,0,30,15
1657215268030,MATH 18,A03,083745,Cinel; Cameron Alexander,8,0,30,22
1657215268030,MATH 18,B01,083748,Rideout; David Porter,4,0,37,33
1657215268030,MATH 18,B02,083749,Rideout; David Porter,4,0,36,32
1657215268030,MATH 18,B03,083750,Rideout; David Porter,2,0,37,35
1657215268030,MATH 18,B04,083751,Rideout; David Porter,5,0,36,31
1657215268030,MATH 18,B05,093473,Rideout; David Porter,5,0,36,31
1657215268030,MATH 18,B06,093474,Rideout; David Porter,5,0,36,31
1657215274081,MATH 20A,A01,083754,Zheng; Zequn,13,0,40,27
1657215280128,MATH 20B,A01,083756,Briones; Jor-el Thomas Caparas,2,0,36,34
1657215280128,MATH 20B,A02,083757,Briones; Jor-el Thomas Caparas,1,0,36,35
1657215280128,MATH 20B,A03,093475,Briones; Jor-el Thomas Caparas,1,0,36,35
1657215286168,MATH 20C,A01,083760,Briones; Jor-el Thomas Caparas,1,0,35,34
1657215286168,MATH 20C,A02,083761,Briones; Jor-el Thomas Caparas,8,0,35,27
1657215286168,MATH 20C,A03,093476,Briones; Jor-el Thomas Caparas,0,1,36,36
1657215286168,MATH 20C,B01,083762,Bach; Quang Tran,1,0,30,29
1657215292218,MATH 20D,A01,083765,Tran; Brian Kha,4,0,30,26
1657215292218,MATH 20D,A02,083766,Tran; Brian Kha,5,0,30,25
1657215292218,MATH 20D,A03,083767,Tran; Brian Kha,4,0,30,26
1657215298251,MATH 20E,A01,083771,Ganguly; Soumya,7,0,32,25
1657215298251,MATH 20E,A02,083772,Ganguly; Soumya,7,0,32,25
1657215298251,MATH 20E,B01,083773,Ciotti; Benjamin,19,0,35,16
1657215298251,MATH 20E,B02,083774,Ciotti; Benjamin,17,0,35,18
1657215304302,MATH 103A,A01,083777,Greenfeld; Be'Eri,2,0,36,34
1657215304302,MATH 103A,A02,083778,Greenfeld; Be'Eri,5,0,36,31
1657215304302,MATH 103A,A03,093561,Greenfeld; Be'Eri,4,0,36,32
1657215304302,MATH 103A,B01,083779,Greenfeld; Be'Eri,6,0,36,30
1657215304302,MATH 103A,B02,083780,Greenfeld; Be'Eri,3,0,36,33
1657215304302,MATH 103A,B03,093562,Greenfeld; Be'Eri,3,0,36,33
1657215310330,MATH 105,A01,085443,Carter; Anne Toulson,15,0,35,20
1657215310330,MATH 105,A02,093477,Carter; Anne Toulson,20,0,35,15
1657215316353,MATH 109,A01,083213,Ganzberger; Geoffrey Michael,2,0,34,32
1657215316353,MATH 109,A02,083214,Ganzberger; Geoffrey Michael,4,0,34,30
1657215316353,MATH 109,A03,093478,Ganzberger; Geoffrey Michael,2,0,34,32
1657215316353,MATH 109,B01,083215,Ganzberger; Geoffrey Michael,1,0,32,31
1657215316353,MATH 109,B02,083216,Ganzberger; Geoffrey Michael,1,0,32,31
1657215316353,MATH 109,B03,093479,Ganzberger; Geoffrey Michael,7,0,32,25
1657215322376,MATH 142A,A01,083219,Chow; Bennett,6,0,32,26
1657215322376,MATH 142A,A02,083220,Chow; Bennett,10,0,32,22
1657215322376,MATH 142A,A03,093480,Chow; Bennett,7,0,32,25
1657215322376,MATH 142A,B03,093481,Chow; Bennett,8,0,32,24
1657215322376,MATH 142A,B04,093558,Chow; Bennett,11,0,32,21
1657215322376,MATH 142A,B05,093559,Chow; Bennett,6,0,32,26
1657215328418,MATH 193A,A01,083224,Rotar; Vladimir,7,0,34,27
1657215328418,MATH 193A,A02,083225,Rotar; Vladimir,5,0,34,29
1657215328418,MATH 193A,A03,083781,Rotar; Vladimir,1,0,34,33
1657215328418,MATH 193A,A04,083782,Rotar; Vladimir,8,0,34,26
1657215328418,MATH 193A,A05,093482,Rotar; Vladimir,6,0,34,28
1657215334442,MATH 197,001,091859,McAuley; Julian John,9999,0,9999,0
1657215334442,MATH 197,002,095566,Kedlaya; Kiran S.,9997,0,9999,2
1657215334442,MATH 197,003,095567,Xiao; Ming,9999,0,9999,0
1657215334442,MATH 197,004,095571,Perols; Johan Lars,9998,0,9999,1
1657215341516,COGS 9,A01,083615,Shannon; Kyle Michael,8,0,75,67
1657215347554,COGS 11,A01,083617,Boyle; Mary E. T.,22,0,48,26
1657215353581,COGS 13,A01,083071,Bastos; Amalia Pinkusfeld,9,0,71,62
1657215359614,COGS 14A,A01,092681,Semenuks; Arturs,1,1,100,99
1657215365653,COGS 14B,A01,083073,Cheng; Tzu-Han,6,0,63,57
1657215371696,COGS 17,A01,092677,Semenuks; Arturs,4,0,81,77
1657215377727,COGS 100,A01,083619,Allen; Michael Gordon,15,0,70,55
1657215383754,COGS 101A,A01,083621,Davis; Joshua Daniel,9,0,68,59
1657215389798,COGS 101B,A01,091572,Allen; Michael Gordon,9,0,65,56
1657215395822,COGS 101C,A01,083625,Delgado; Tania,17,0,35,18
1657215401859,COGS 107A,A01,083627,Boyle; Mary E. T.,13,0,60,47
1657215407900,COGS 118A,A01,083075,Gupta; Anjum,16,0,76,60
1657215413923,CSE 3,A50,083646,Miranda; Gregory Joseph,24,0,50,26
1657215419950,CSE 8A,A50,083650,Miranda; Gregory Joseph,17,1,56,39
1657215425977,CSE 11,A01,083080,Cao; Yingjun,5,15,40,35
1657215432001,CSE 12,A01,083652,Krause-Levy; Sophia Louisa,24,1,120,96
1657215438024,CSE 15L,A01,083654,Morris; Justin Loren,9,0,50,41
1657215438024,CSE 15L,A02,083655,Morris; Justin Loren,9,0,50,41
1657215444061,CSE 20,A01,083657,Tran; Khoa Dang,38,0,80,42
1657215450083,CSE 21,A01,095574,Bach; Quang Tran,22,0,48,26
1657215456114,CSE 30,A01,083084,Eldon; John,4,0,80,76
1657215456114,CSE 30,B01,095061,Bhaskar; Nishant,8,0,50,42
1657215462137,CSE 100,A01,083659,Cao; Yingjun,4,4,70,66
1657215468168,CSE 134B,A01,083661,Powell; Thomas Allan,20,0,100,80
1657215474192,CSE 140,A01,083663,Gungor; Onat,13,0,85,72
1657215480216,CSE 140L,A01,083088,Eldon; John,17,0,100,83
1657215486261,CSE 175,A01,083665,Kumar; Rakesh,3,0,25,22
1657215492288,CSE 190,A00,092507,Dubnov; Shlomo,7,0,20,13
1657215498314,ECE 45,A01,083139,Congero; Spencer William,5,0,75,70
1657215504354,ECE 65,A50,083695,Saad; Andrew S,12,0,30,18
1657215504354,ECE 65,A51,095125,Saad; Andrew S,25,0,26,1
1657215510389,ECE 109,A01,091882,Touri; Behrouz,19,0,70,51
1657215516413,ECE 180,A00,083140,Abi Samra; Nicholas Camill,1,0,30,29
1657215516413,ECE 180,B00,083141,Abi Samra; Nicholas Camill,0,0,30,30
1657215522435,MATH 10A,A01,083735,Patchell; Gregory David,2,0,30,28
1657215522435,MATH 10A,A02,083736,Patchell; Gregory David,20,0,30,10
1657215522435,MATH 10A,A03,083737,Patchell; Gregory David,16,0,30,14
1657215528458,MATH 10B,A01,083207,Lim; Seonhee,7,0,34,27
1657215528458,MATH 10B,A02,083208,Lim; Seonhee,9,0,35,26
1657215528458,MATH 10B,A03,093472,Lim; Seonhee,5,0,34,29
1657215528458,MATH 10B,B01,083739,Sinha; Shubham,10,0,30,20
1657215534490,MATH 18,A01,083743,Cinel; Cameron Alexander,6,0,30,24
1657215534490,MATH 18,A02,083744,Cinel; Cameron Alexander,16,0,30,14
1657215534490,MATH 18,A03,083745,Cinel; Cameron Alexander,8,0,30,22
1657215534490,MATH 18,B01,083748,Rideout; David Porter,4,0,37,33
1657215534490,MATH 18,B02,083749,Rideout; David Porter,4,0,36,32
1657215534490,MATH 18,B03,083750,Rideout; David Porter,2,0,37,35
1657215534490,MATH 18,B04,083751,Rideout; David Porter,5,0,36,31
1657215534490,MATH 18,B05,093473,Rideout; David Porter,5,0,36,31
1657215534490,MATH 18,B06,093474,Rideout; David Porter,5,0,36,31
1657215540530,MATH 20A,A01,083754,Zheng; Zequn,13,0,40,27
1657215546555,MATH 20B,A01,083756,Briones; Jor-el Thomas Caparas,2,0,36,34
1657215546555,MATH 20B,A02,083757,Briones; Jor-el Thomas Caparas,1,0,36,35
1657215546555,MATH 20B,A03,093475,Briones; Jor-el Thomas Caparas,1,0,36,35
1657215552592,MATH 20C,A01,083760,Briones; Jor-el Thomas Caparas,1,0,35,34
1657215552592,MATH 20C,A02,083761,Briones; Jor-el Thomas Caparas,8,0,35,27
1657215552592,MATH 20C,A03,093476,Briones; Jor-el Thomas Caparas,0,1,36,36
1657215552592,MATH 20C,B01,083762,Bach; Quang Tran,1,0,30,29
1657215558651,MATH 20D,A01,083765,Tran; Brian Kha,4,0,30,26
1657215558651,MATH 20D,A02,083766,Tran; Brian Kha,5,0,30,25
1657215558651,MATH 20D,A03,083767,Tran; Brian Kha,4,0,30,26
1657215564681,MATH 20E,A01,083771,Ganguly; Soumya,7,0,32,25
1657215564681,MATH 20E,A02,083772,Ganguly; Soumya,7,0,32,25
1657215564681,MATH 20E,B01,083773,Ciotti; Benjamin,19,0,35,16
1657215564681,MATH 20E,B02,083774,Ciotti; Benjamin,17,0,35,18
1657215570728,MATH 103A,A01,083777,Greenfeld; Be'Eri,2,0,36,34
1657215570728,MATH 103A,A02,083778,Greenfeld; Be'Eri,5,0,36,31
1657215570728,MATH 103A,A03,093561,Greenfeld; Be'Eri,4,0,36,32
1657215570728,MATH 103A,B01,083779,Greenfeld; Be'Eri,6,0,36,30
1657215570728,MATH 103A,B02,083780,Greenfeld; Be'Eri,3,0,36,33
1657215570728,MATH 103A,B03,093562,Greenfeld; Be'Eri,3,0,36,33
1657215576752,MATH 105,A01,085443,Carter; Anne Toulson,15,0,35,20
1657215576752,MATH 105,A02,093477,Carter; Anne Toulson,20,0,35,15
1657215582777,MATH 109,A01,083213,Ganzberger; Geoffrey Michael,2,0,34,32
1657215582777,MATH 109,A02,083214,Ganzberger; Geoffrey Michael,4,0,34,30
1657215582777,MATH 109,A03,093478,Ganzberger; Geoffrey Michael,2,0,34,32
1657215582777,MATH 109,B01,083215,Ganzberger; Geoffrey Michael,1,0,32,31
1657215582777,MATH 109,B02,083216,Ganzberger; Geoffrey Michael,1,0,32,31
1657215582777,MATH 109,B03,093479,Ganzberger; Geoffrey Michael,7,0,32,25
1657215588801,MATH 142A,A01,083219,Chow; Bennett,6,0,32,26
1657215588801,MATH 142A,A02,083220,Chow; Bennett,10,0,32,22
1657215588801,MATH 142A,A03,093480,Chow; Bennett,7,0,32,25
1657215588801,MATH 142A,B03,093481,Chow; Bennett,8,0,32,24
1657215588801,MATH 142A,B04,093558,Chow; Bennett,11,0,32,21
1657215588801,MATH 142A,B05,093559,Chow; Bennett,6,0,32,26
1657215594833,MATH 193A,A01,083224,Rotar; Vladimir,7,0,34,27
1657215594833,MATH 193A,A02,083225,Rotar; Vladimir,5,0,34,29
1657215594833,MATH 193A,A03,083781,Rotar; Vladimir,1,0,34,33
1657215594833,MATH 193A,A04,083782,Rotar; Vladimir,8,0,34,26
1657215594833,MATH 193A,A05,093482,Rotar; Vladimir,6,0,34,28
1657215600859,MATH 197,001,091859,McAuley; Julian John,9999,0,9999,0
1657215600859,MATH 197,002,095566,Kedlaya; Kiran S.,9997,0,9999,2
1657215600859,MATH 197,003,095567,Xiao; Ming,9999,0,9999,0
1657215600859,MATH 197,004,095571,Perols; Johan Lars,9998,0,9999,1
1657215607909,COGS 9,A01,083615,Shannon; Kyle Michael,8,0,75,67
1657215613933,COGS 11,A01,083617,Boyle; Mary E. T.,22,0,48,26
1657215620004,COGS 13,A01,083071,Bastos; Amalia Pinkusfeld,9,0,71,62
1657215626029,COGS 14A,A01,092681,Semenuks; Arturs,1,1,100,99
1657215632065,COGS 14B,A01,083073,Cheng; Tzu-Han,6,0,63,57
1657215638105,COGS 17,A01,092677,Semenuks; Arturs,4,0,81,77
1657215644135,COGS 100,A01,083619,Allen; Michael Gordon,15,0,70,55
1657215650168,COGS 101A,A01,083621,Davis; Joshua Daniel,9,0,68,59
1657215656211,COGS 101B,A01,091572,Allen; Michael Gordon,9,0,65,56
1657215662325,COGS 101C,A01,083625,Delgado; Tania,17,0,35,18
1657215668368,COGS 107A,A01,083627,Boyle; Mary E. T.,13,0,60,47
1657215674400,COGS 118A,A01,083075,Gupta; Anjum,16,0,76,60
1657215680444,CSE 3,A50,083646,Miranda; Gregory Joseph,24,0,50,26
1657215686485,CSE 8A,A50,083650,Miranda; Gregory Joseph,17,1,56,39
1657215692509,CSE 11,A01,083080,Cao; Yingjun,5,15,40,35
1657215698536,CSE 12,A01,083652,Krause-Levy; Sophia Louisa,24,1,120,96
1657215704560,CSE 15L,A01,083654,Morris; Justin Loren,9,0,50,41
1657215704560,CSE 15L,A02,083655,Morris; Justin Loren,9,0,50,41
1657215710617,CSE 20,A01,083657,Tran; Khoa Dang,38,0,80,42
1657215716640,CSE 21,A01,095574,Bach; Quang Tran,22,0,48,26
1657215722666,CSE 30,A01,083084,Eldon; John,4,0,80,76
1657215722666,CSE 30,B01,095061,Bhaskar; Nishant,8,0,50,42
1657215728700,CSE 100,A01,083659,Cao; Yingjun,4,4,70,66
1657215734731,CSE 134B,A01,083661,Powell; Thomas Allan,20,0,100,80
1657215740766,CSE 140,A01,083663,Gungor; Onat,13,0,85,72
1657215746802,CSE 140L,A01,083088,Eldon; John,17,0,100,83
1657215752841,CSE 175,A01,083665,Kumar; Rakesh,3,0,25,22
1657215758874,CSE 190,A00,092507,Dubnov; Shlomo,7,0,20,13
1657215764915,ECE 45,A01,083139,Congero; Spencer William,5,0,75,70
1657215770945,ECE 65,A50,083695,Saad; Andrew S,12,0,30,18
1657215770945,ECE 65,A51,095125,Saad; Andrew S,25,0,26,1
1657215776981,ECE 109,A01,091882,Touri; Behrouz,19,0,70,51
1657215783023,ECE 180,A00,083140,Abi Samra; Nicholas Camill,1,0,30,29
1657215783023,ECE 180,B00,083141,Abi Samra; Nicholas Camill,0,0,30,30
1657215789052,MATH 10A,A01,083735,Patchell; Gregory David,2,0,30,28
1657215789052,MATH 10A,A02,083736,Patchell; Gregory David,20,0,30,10
1657215789052,MATH 10A,A03,083737,Patchell; Gregory David,16,0,30,14
1657215795102,MATH 10B,A01,083207,Lim; Seonhee,7,0,34,27
1657215795102,MATH 10B,A02,083208,Lim; Seonhee,9,0,35,26
1657215795102,MATH 10B,A03,093472,Lim; Seonhee,5,0,34,29
1657215795102,MATH 10B,B01,083739,Sinha; Shubham,10,0,30,20
1657215801126,MATH 18,A01,083743,Cinel; Cameron Alexander,6,0,30,24
1657215801126,MATH 18,A02,083744,Cinel; Cameron Alexander,16,0,30,14
1657215801126,MATH 18,A03,083745,Cinel; Cameron Alexander,8,0,30,22
1657215801126,MATH 18,B01,083748,Rideout; David Porter,4,0,37,33
1657215801126,MATH 18,B02,083749,Rideout; David Porter,4,0,36,32
1657215801126,MATH 18,B03,083750,Rideout; David Porter,2,0,37,35
1657215801126,MATH 18,B04,083751,Rideout; David Porter,5,0,36,31
1657215801126,MATH 18,B05,093473,Rideout; David Porter,5,0,36,31
1657215801126,MATH 18,B06,093474,Rideout; David Porter,5,0,36,31
1657215807155,MATH 20A,A01,083754,Zheng; Zequn,13,0,40,27
1657215813197,MATH 20B,A01,083756,Briones; Jor-el Thomas Caparas,2,0,36,34
1657215813197,MATH 20B,A02,083757,Briones; Jor-el Thomas Caparas,1,0,36,35
1657215813197,MATH 20B,A03,093475,Briones; Jor-el Thomas Caparas,1,0,36,35
1657215819221,MATH 20C,A01,083760,Briones; Jor-el Thomas Caparas,1,0,35,34
1657215819221,MATH 20C,A02,083761,Briones; Jor-el Thomas Caparas,8,0,35,27
1657215819221,MATH 20C,A03,093476,Briones; Jor-el Thomas Caparas,0,1,36,36
1657215819221,MATH 20C,B01,083762,Bach; Quang Tran,1,0,30,29
1657215825253,MATH 20D,A01,083765,Tran; Brian Kha,4,0,30,26
1657215825253,MATH 20D,A02,083766,Tran; Brian Kha,5,0,30,25
1657215825253,MATH 20D,A03,083767,Tran; Brian Kha,4,0,30,26
1657215831296,MATH 20E,A01,083771,Ganguly; Soumya,7,0,32,25
1657215831296,MATH 20E,A02,083772,Ganguly; Soumya,7,0,32,25
1657215831296,MATH 20E,B01,083773,Ciotti; Benjamin,19,0,35,16
1657215831296,MATH 20E,B02,083774,Ciotti; Benjamin,17,0,35,18
1657215837320,MATH 103A,A01,083777,Greenfeld; Be'Eri,2,0,36,34
1657215837320,MATH 103A,A02,083778,Greenfeld; Be'Eri,5,0,36,31
1657215837320,MATH 103A,A03,093561,Greenfeld; Be'Eri,4,0,36,32
1657215837320,MATH 103A,B01,083779,Greenfeld; Be'Eri,6,0,36,30
1657215837320,MATH 103A,B02,083780,Greenfeld; Be'Eri,3,0,36,33
1657215837320,MATH 103A,B03,093562,Greenfeld; Be'Eri,3,0,36,33
1657215843354,MATH 105,A01,085443,Carter; Anne Toulson,15,0,35,20
1657215843354,MATH 105,A02,093477,Carter; Anne Toulson,20,0,35,15
1657215849385,MATH 109,A01,083213,Ganzberger; Geoffrey Michael,2,0,34,32
1657215849385,MATH 109,A02,083214,Ganzberger; Geoffrey Michael,4,0,34,30
1657215849385,MATH 109,A03,093478,Ganzberger; Geoffrey Michael,2,0,34,32
1657215849385,MATH 109,B01,083215,Ganzberger; Geoffrey Michael,1,0,32,31
1657215849385,MATH 109,B02,083216,Ganzberger; Geoffrey Michael,1,0,32,31
1657215849385,MATH 109,B03,093479,Ganzberger; Geoffrey Michael,7,0,32,25
1657215855415,MATH 142A,A01,083219,Chow; Bennett,6,0,32,26
1657215855415,MATH 142A,A02,083220,Chow; Bennett,10,0,32,22
1657215855415,MATH 142A,A03,093480,Chow; Bennett,7,0,32,25
1657215855415,MATH 142A,B03,093481,Chow; Bennett,8,0,32,24
1657215855415,MATH 142A,B04,093558,Chow; Bennett,11,0,32,21
1657215855415,MATH 142A,B05,093559,Chow; Bennett,6,0,32,26
1657215861445,MATH 193A,A01,083224,Rotar; Vladimir,7,0,34,27
1657215861445,MATH 193A,A02,083225,Rotar; Vladimir,5,0,34,29
1657215861445,MATH 193A,A03,083781,Rotar; Vladimir,1,0,34,33
1657215861445,MATH 193A,A04,083782,Rotar; Vladimir,8,0,34,26
1657215861445,MATH 193A,A05,093482,Rotar; Vladimir,6,0,34,28
1657215867481,MATH 197,001,091859,McAuley; Julian John,9999,0,9999,0
1657215867481,MATH 197,002,095566,Kedlaya; Kiran S.,9997,0,9999,2
1657215867481,MATH 197,003,095567,Xiao; Ming,9999,0,9999,0
1657215867481,MATH 197,004,095571,Perols; Johan Lars,9998,0,9999,1
1657215874566,COGS 9,A01,083615,Shannon; Kyle Michael,8,0,75,67
1657215880611,COGS 11,A01,083617,Boyle; Mary E. T.,22,0,48,26
1657215886633,COGS 13,A01,083071,Bastos; Amalia Pinkusfeld,9,0,71,62
1657215892672,COGS 14A,A01,092681,Semenuks; Arturs,1,1,100,99
1657215898721,COGS 14B,A01,083073,Cheng; Tzu-Han,6,0,63,57
1657215904743,COGS 17,A01,092677,Semenuks; Arturs,4,0,81,77
1657215910788,COGS 100,A01,083619,Allen; Michael Gordon,15,0,70,55
1657215916810,COGS 101A,A01,083621,Davis; Joshua Daniel,9,0,68,59
1657215922857,COGS 101B,A01,091572,Allen; Michael Gordon,9,0,65,56
1657215928881,COGS 101C,A01,083625,Delgado; Tania,17,0,35,18
1657215934907,COGS 107A,A01,083627,Boyle; Mary E. T.,13,0,60,47
1657215940949,COGS 118A,A01,083075,Gupta; Anjum,16,0,76,60
1657215946995,CSE 3,A50,083646,Miranda; Gregory Joseph,24,0,50,26
1657215953021,CSE 8A,A50,083650,Miranda; Gregory Joseph,17,1,56,39
1657215959044,CSE 11,A01,083080,Cao; Yingjun,5,15,40,35
1657215965082,CSE 12,A01,083652,Krause-Levy; Sophia Louisa,24,1,120,96
1657215971105,CSE 15L,A01,083654,Morris; Justin Loren,9,0,50,41
1657215971105,CSE 15L,A02,083655,Morris; Justin Loren,9,0,50,41
1657215977149,CSE 20,A01,083657,Tran; Khoa Dang,38,0,80,42
1657215983181,CSE 21,A01,095574,Bach; Quang Tran,22,0,48,26
1657215989216,CSE 30,A01,083084,Eldon; John,4,0,80,76
1657215989216,CSE 30,B01,095061,Bhaskar; Nishant,8,0,50,42
1657215995265,CSE 100,A01,083659,Cao; Yingjun,4,4,70,66
1657216001288,CSE 134B,A01,083661,Powell; Thomas Allan,20,0,100,80
1657216007317,CSE 140,A01,083663,Gungor; Onat,13,0,85,72
1657216013366,CSE 140L,A01,083088,Eldon; John,17,0,100,83
1657216019388,CSE 175,A01,083665,Kumar; Rakesh,3,0,25,22
1657216025424,CSE 190,A00,092507,Dubnov; Shlomo,7,0,20,13
1657216031459,ECE 45,A01,083139,Congero; Spencer William,5,0,75,70
1657216037487,ECE 65,A50,083695,Saad; Andrew S,12,0,30,18
1657216037487,ECE 65,A51,095125,Saad; Andrew S,25,0,26,1
1657216043511,ECE 109,A01,091882,Touri; Behrouz,19,0,70,51
1657216049555,ECE 180,A00,083140,Abi Samra; Nicholas Camill,1,0,30,29
1657216049555,ECE 180,B00,083141,Abi Samra; Nicholas Camill,0,0,30,30
1657216055585,MATH 10A,A01,083735,Patchell; Gregory David,2,0,30,28
1657216055585,MATH 10A,A02,083736,Patchell; Gregory David,20,0,30,10
1657216055585,MATH 10A,A03,083737,Patchell; Gregory David,16,0,30,14
1657216061610,MATH 10B,A01,083207,Lim; Seonhee,7,0,34,27
1657216061610,MATH 10B,A02,083208,Lim; Seonhee,9,0,35,26
1657216061610,MATH 10B,A03,093472,Lim; Seonhee,5,0,34,29
1657216061610,MATH 10B,B01,083739,Sinha; Shubham,10,0,30,20
1657216067641,MATH 18,A01,083743,Cinel; Cameron Alexander,6,0,30,24
1657216067641,MATH 18,A02,083744,Cinel; Cameron Alexander,16,0,30,14
1657216067641,MATH 18,A03,083745,Cinel; Cameron Alexander,8,0,30,22
1657216067641,MATH 18,B01,083748,Rideout; David Porter,4,0,37,33
1657216067641,MATH 18,B02,083749,Rideout; David Porter,4,0,36,32
1657216067641,MATH 18,B03,083750,Rideout; David Porter,2,0,37,35
1657216067641,MATH 18,B04,083751,Rideout; David Porter,5,0,36,31
1657216067641,MATH 18,B05,093473,Rideout; David Porter,5,0,36,31
1657216067641,MATH 18,B06,093474,Rideout; David Porter,5,0,36,31
1657216073677,MATH 20A,A01,083754,Zheng; Zequn,13,0,40,27
1657216079703,MATH 20B,A01,083756,Briones; Jor-el Thomas Caparas,2,0,36,34
1657216079703,MATH 20B,A02,083757,Briones; Jor-el Thomas Caparas,1,0,36,35
1657216079703,MATH 20B,A03,093475,Briones; Jor-el Thomas Caparas,1,0,36,35
1657216085751,MATH 20C,A01,083760,Briones; Jor-el Thomas Caparas,1,0,35,34
1657216085751,MATH 20C,A02,083761,Briones; Jor-el Thomas Caparas,8,0,35,27
1657216085751,MATH 20C,A03,093476,Briones; Jor-el Thomas Caparas,0,1,36,36
1657216085751,MATH 20C,B01,083762,Bach; Quang Tran,1,0,30,29
1657216091773,MATH 20D,A01,083765,Tran; Brian Kha,4,0,30,26
1657216091773,MATH 20D,A02,083766,Tran; Brian Kha,5,0,30,25
1657216091773,MATH 20D,A03,083767,Tran; Brian Kha,4,0,30,26
1657216097797,MATH 20E,A01,083771,Ganguly; Soumya,7,0,32,25
1657216097797,MATH 20E,A02,083772,Ganguly; Soumya,7,0,32,25
1657216097797,MATH 20E,B01,083773,Ciotti; Benjamin,19,0,35,16
1657216097797,MATH 20E,B02,083774,Ciotti; Benjamin,17,0,35,18
1657216103835,MATH 103A,A01,083777,Greenfeld; Be'Eri,2,0,36,34
1657216103835,MATH 103A,A02,083778,Greenfeld; Be'Eri,5,0,36,31
1657216103835,MATH 103A,A03,093561,Greenfeld; Be'Eri,4,0,36,32
1657216103835,MATH 103A,B01,083779,Greenfeld; Be'Eri,6,0,36,30
1657216103835,MATH 103A,B02,083780,Greenfeld; Be'Eri,3,0,36,33
1657216103835,MATH 103A,B03,093562,Greenfeld; Be'Eri,3,0,36,33
1657216109858,MATH 105,A01,085443,Carter; Anne Toulson,15,0,35,20
1657216109858,MATH 105,A02,093477,Carter; Anne Toulson,20,0,35,15
1657216115890,MATH 109,A01,083213,Ganzberger; Geoffrey Michael,2,0,34,32
1657216115890,MATH 109,A02,083214,Ganzberger; Geoffrey Michael,4,0,34,30
1657216115890,MATH 109,A03,093478,Ganzberger; Geoffrey Michael,2,0,34,32
1657216115890,MATH 109,B01,083215,Ganzberger; Geoffrey Michael,1,0,32,31
1657216115890,MATH 109,B02,083216,Ganzberger; Geoffrey Michael,1,0,32,31
1657216115890,MATH 109,B03,093479,Ganzberger; Geoffrey Michael,7,0,32,25
1657216121926,MATH 142A,A01,083219,Chow; Bennett,6,0,32,26
1657216121926,MATH 142A,A02,083220,Chow; Bennett,10,0,32,22
1657216121926,MATH 142A,A03,093480,Chow; Bennett,7,0,32,25
1657216121926,MATH 142A,B03,093481,Chow; Bennett,8,0,32,24
1657216121926,MATH 142A,B04,093558,Chow; Bennett,11,0,32,21
1657216121926,MATH 142A,B05,093559,Chow; Bennett,6,0,32,26
1657216127953,MATH 193A,A01,083224,Rotar; Vladimir,7,0,34,27
1657216127953,MATH 193A,A02,083225,Rotar; Vladimir,5,0,34,29
1657216127953,MATH 193A,A03,083781,Rotar; Vladimir,1,0,34,33
1657216127953,MATH 193A,A04,083782,Rotar; Vladimir,8,0,34,26
1657216127953,MATH 193A,A05,093482,Rotar; Vladimir,6,0,34,28
1657216133974,MATH 197,001,091859,McAuley; Julian John,9999,0,9999,0
1657216133974,MATH 197,002,095566,Kedlaya; Kiran S.,9997,0,9999,2
1657216133974,MATH 197,003,095567,Xiao; Ming,9999,0,9999,0
1657216133974,MATH 197,004,095571,Perols; Johan Lars,9998,0,9999,1
1657216141082,COGS 9,A01,083615,Shannon; Kyle Michael,8,0,75,67
1657216147113,COGS 11,A01,083617,Boyle; Mary E. T.,22,0,48,26
1657216153137,COGS 13,A01,083071,Bastos; Amalia Pinkusfeld,9,0,71,62
1657216159173,COGS 14A,A01,092681,Semenuks; Arturs,1,1,100,99
1657216165197,COGS 14B,A01,083073,Cheng; Tzu-Han,6,0,63,57
1657216171233,COGS 17,A01,092677,Semenuks; Arturs,4,0,81,77
1657216177268,COGS 100,A01,083619,Allen; Michael Gordon,15,0,70,55
1657216183303,COGS 101A,A01,083621,Davis; Joshua Daniel,9,0,68,59
1657216189333,COGS 101B,A01,091572,Allen; Michael Gordon,9,0,65,56
1657216195365,COGS 101C,A01,083625,Delgado; Tania,17,0,35,18
1657216201392,COGS 107A,A01,083627,Boyle; Mary E. T.,13,0,60,47
1657216207432,COGS 118A,A01,083075,Gupta; Anjum,16,0,76,60
1657216213465,CSE 3,A50,083646,Miranda; Gregory Joseph,24,0,50,26
1657216219492,CSE 8A,A50,083650,Miranda; Gregory Joseph,17,1,56,39
1657216225515,CSE 11,A01,083080,Cao; Yingjun,5,15,40,35
1657216231543,CSE 12,A01,083652,Krause-Levy; Sophia Louisa,24,1,120,96
1657216237588,CSE 15L,A01,083654,Morris; Justin Loren,9,0,50,41
1657216237588,CSE 15L,A02,083655,Morris; Justin Loren,9,0,50,41
1657216243611,CSE 20,A01,083657,Tran; Khoa Dang,38,0,80,42
1657216249640,CSE 21,A01,095574,Bach; Quang Tran,22,0,48,26
1657216255680,CSE 30,A01,083084,Eldon; John,4,0,80,76
1657216255680,CSE 30,B01,095061,Bhaskar; Nishant,8,0,50,42
1657216261784,CSE 100,A01,083659,Cao; Yingjun,4,4,70,66
1657216267808,CSE 134B,A01,083661,Powell; Thomas Allan,20,0,100,80
1657216273840,CSE 140,A01,083663,Gungor; Onat,13,0,85,72
1657216279889,CSE 140L,A01,083088,Eldon; John,17,0,100,83
1657216285923,CSE 175,A01,083665,Kumar; Rakesh,3,0,25,22
1657216291961,CSE 190,A00,092507,Dubnov; Shlomo,7,0,20,13
1657216297993,ECE 45,A01,083139,Congero; Spencer William,5,0,75,70
1657216304027,ECE 65,A50,083695,Saad; Andrew S,12,0,30,18
1657216304027,ECE 65,A51,095125,Saad; Andrew S,25,0,26,1
1657216310059,ECE 109,A01,091882,Touri; Behrouz,19,0,70,51
1657216316099,ECE 180,A00,083140,Abi Samra; Nicholas Camill,1,0,30,29
1657216316099,ECE 180,B00,083141,Abi Samra; Nicholas Camill,0,0,30,30
1657216322131,MATH 10A,A01,083735,Patchell; Gregory David,2,0,30,28
1657216322131,MATH 10A,A02,083736,Patchell; Gregory David,20,0,30,10
1657216322131,MATH 10A,A03,083737,Patchell; Gregory David,16,0,30,14
1657216328180,MATH 10B,A01,083207,Lim; Seonhee,7,0,34,27
1657216328180,MATH 10B,A02,083208,Lim; Seonhee,9,0,35,26
1657216328180,MATH 10B,A03,093472,Lim; Seonhee,5,0,34,29
1657216328180,MATH 10B,B01,083739,Sinha; Shubham,10,0,30,20
1657216334203,MATH 18,A01,083743,Cinel; Cameron Alexander,6,0,30,24
1657216334203,MATH 18,A02,083744,Cinel; Cameron Alexander,16,0,30,14
1657216334203,MATH 18,A03,083745,Cinel; Cameron Alexander,8,0,30,22
1657216334203,MATH 18,B01,083748,Rideout; David Porter,4,0,37,33
1657216334203,MATH 18,B02,083749,Rideout; David Porter,4,0,36,32
1657216334203,MATH 18,B03,083750,Rideout; David Porter,2,0,37,35
1657216334203,MATH 18,B04,083751,Rideout; David Porter,5,0,36,31
1657216334203,MATH 18,B05,093473,Rideout; David Porter,5,0,36,31
1657216334203,MATH 18,B06,093474,Rideout; David Porter,5,0,36,31
1657216340253,MATH 20A,A01,083754,Zheng; Zequn,13,0,40,27
1657216346287,MATH 20B,A01,083756,Briones; Jor-el Thomas Caparas,2,0,36,34
1657216346287,MATH 20B,A02,083757,Briones; Jor-el Thomas Caparas,1,0,36,35
1657216346287,MATH 20B,A03,093475,Briones; Jor-el Thomas Caparas,1,0,36,35
1657216352310,MATH 20C,A01,083760,Briones; Jor-el Thomas Caparas,1,0,35,34
1657216352310,MATH 20C,A02,083761,Briones; Jor-el Thomas Caparas,8,0,35,27
1657216352310,MATH 20C,A03,093476,Briones; Jor-el Thomas Caparas,0,1,36,36
1657216352310,MATH 20C,B01,083762,Bach; Quang Tran,1,0,30,29
1657216358350,MATH 20D,A01,083765,Tran; Brian Kha,4,0,30,26
1657216358350,MATH 20D,A02,083766,Tran; Brian Kha,5,0,30,25
1657216358350,MATH 20D,A03,083767,Tran; Brian Kha,4,0,30,26
1657216364372,MATH 20E,A01,083771,Ganguly; Soumya,7,0,32,25
1657216364372,MATH 20E,A02,083772,Ganguly; Soumya,7,0,32,25
1657216364372,MATH 20E,B01,083773,Ciotti; Benjamin,19,0,35,16
1657216364372,MATH 20E,B02,083774,Ciotti; Benjamin,17,0,35,18
1657216370402,MATH 103A,A01,083777,Greenfeld; Be'Eri,2,0,36,34
1657216370402,MATH 103A,A02,083778,Greenfeld; Be'Eri,5,0,36,31
1657216370402,MATH 103A,A03,093561,Greenfeld; Be'Eri,4,0,36,32
1657216370402,MATH 103A,B01,083779,Greenfeld; Be'Eri,6,0,36,30
1657216370402,MATH 103A,B02,083780,Greenfeld; Be'Eri,3,0,36,33
1657216370402,MATH 103A,B03,093562,Greenfeld; Be'Eri,3,0,36,33
1657216376460,MATH 105,A01,085443,Carter; Anne Toulson,15,0,35,20
1657216376460,MATH 105,A02,093477,Carter; Anne Toulson,20,0,35,15
1657216382507,MATH 109,A01,083213,Ganzberger; Geoffrey Michael,2,0,34,32
1657216382507,MATH 109,A02,083214,Ganzberger; Geoffrey Michael,4,0,34,30
1657216382507,MATH 109,A03,093478,Ganzberger; Geoffrey Michael,2,0,34,32
1657216382507,MATH 109,B01,083215,Ganzberger; Geoffrey Michael,1,0,32,31
1657216382507,MATH 109,B02,083216,Ganzberger; Geoffrey Michael,1,0,32,31
1657216382507,MATH 109,B03,093479,Ganzberger; Geoffrey Michael,7,0,32,25
1657216388555,MATH 142A,A01,083219,Chow; Bennett,6,0,32,26
1657216388555,MATH 142A,A02,083220,Chow; Bennett,10,0,32,22
1657216388555,MATH 142A,A03,093480,Chow; Bennett,7,0,32,25
1657216388555,MATH 142A,B03,093481,Chow; Bennett,8,0,32,24
1657216388555,MATH 142A,B04,093558,Chow; Bennett,11,0,32,21
1657216388555,MATH 142A,B05,093559,Chow; Bennett,6,0,32,26
1657216394600,MATH 193A,A01,083224,Rotar; Vladimir,7,0,34,27
1657216394600,MATH 193A,A02,083225,Rotar; Vladimir,5,0,34,29
1657216394600,MATH 193A,A03,083781,Rotar; Vladimir,1,0,34,33
1657216394600,MATH 193A,A04,083782,Rotar; Vladimir,8,0,34,26
1657216394600,MATH 193A,A05,093482,Rotar; Vladimir,6,0,34,28
1657216400640,MATH 197,001,091859,McAuley; Julian John,9999,0,9999,0
1657216400640,MATH 197,002,095566,Kedlaya; Kiran S.,9997,0,9999,2
1657216400640,MATH 197,003,095567,Xiao; Ming,9999,0,9999,0
1657216400640,MATH 197,004,095571,Perols; Johan Lars,9998,0,9999,1
1657216407707,COGS 9,A01,083615,Shannon; Kyle Michael,8,0,75,67
1657216413759,COGS 11,A01,083617,Boyle; Mary E. T.,22,0,48,26
1657216419815,COGS 13,A01,083071,Bastos; Amalia Pinkusfeld,9,0,71,62
1657216425842,COGS 14A,A01,092681,Semenuks; Arturs,1,1,100,99
1657216431891,COGS 14B,A01,083073,Cheng; Tzu-Han,6,0,63,57
1657216437916,COGS 17,A01,092677,Semenuks; Arturs,4,0,81,77
1657216443976,COGS 100,A01,083619,Allen; Michael Gordon,15,0,70,55
1657216450003,COGS 101A,A01,083621,Davis; Joshua Daniel,9,0,68,59
1657216456040,COGS 101B,A01,091572,Allen; Michael Gordon,9,0,65,56
1657216462063,COGS 101C,A01,083625,Delgado; Tania,17,0,35,18
1657216468100,COGS 107A,A01,083627,Boyle; Mary E. T.,13,0,60,47
1657216474125,COGS 118A,A01,083075,Gupta; Anjum,16,0,76,60
1657216480150,CSE 3,A50,083646,Miranda; Gregory Joseph,24,0,50,26
1657216486200,CSE 8A,A50,083650,Miranda; Gregory Joseph,17,1,56,39
1657216492239,CSE 11,A01,083080,Cao; Yingjun,5,15,40,35
1657216498279,CSE 12,A01,083652,Krause-Levy; Sophia Louisa,24,1,120,96
1657216504303,CSE 15L,A01,083654,Morris; Justin Loren,9,0,50,41
1657216504303,CSE 15L,A02,083655,Morris; Justin Loren,9,0,50,41
1657216510327,CSE 20,A01,083657,Tran; Khoa Dang,38,0,80,42
1657216516357,CSE 21,A01,095574,Bach; Quang Tran,22,0,48,26
1657216522397,CSE 30,A01,083084,Eldon; John,4,0,80,76
1657216522397,CSE 30,B01,095061,Bhaskar; Nishant,8,0,50,42
1657216528424,CSE 100,A01,083659,Cao; Yingjun,4,4,70,66
1657216534454,CSE 134B,A01,083661,Powell; Thomas Allan,20,0,100,80
1657216540477,CSE 140,A01,083663,Gungor; Onat,13,0,85,72
1657216546503,CSE 140L,A01,083088,Eldon; John,17,0,100,83
1657216552530,CSE 175,A01,083665,Kumar; Rakesh,3,0,25,22
1657216558563,CSE 190,A00,092507,Dubnov; Shlomo,7,0,20,13
1657216564607,ECE 45,A01,083139,Congero; Spencer William,5,0,75,70
1657216570632,ECE 65,A50,083695,Saad; Andrew S,12,0,30,18
1657216570632,ECE 65,A51,095125,Saad; Andrew S,25,0,26,1
1657216576667,ECE 109,A01,091882,Touri; Behrouz,19,0,70,51
1657216582720,ECE 180,A00,083140,Abi Samra; Nicholas Camill,1,0,30,29
1657216582720,ECE 180,B00,083141,Abi Samra; Nicholas Camill,0,0,30,30
1657216588755,MATH 10A,A01,083735,Patchell; Gregory David,2,0,30,28
1657216588755,MATH 10A,A02,083736,Patchell; Gregory David,20,0,30,10
1657216588755,MATH 10A,A03,083737,Patchell; Gregory David,16,0,30,14
1657216594808,MATH 10B,A01,083207,Lim; Seonhee,7,0,34,27
1657216594808,MATH 10B,A02,083208,Lim; Seonhee,9,0,35,26
1657216594808,MATH 10B,A03,093472,Lim; Seonhee,5,0,34,29
1657216594808,MATH 10B,B01,083739,Sinha; Shubham,10,0,30,20
1657216600901,MATH 18,A01,083743,Cinel; Cameron Alexander,6,0,30,24
1657216600901,MATH 18,A02,083744,Cinel; Cameron Alexander,16,0,30,14
1657216600901,MATH 18,A03,083745,Cinel; Cameron Alexander,8,0,30,22
1657216600901,MATH 18,B01,083748,Rideout; David Porter,4,0,37,33
1657216600901,MATH 18,B02,083749,Rideout; David Porter,4,0,36,32
1657216600901,MATH 18,B03,083750,Rideout; David Porter,2,0,37,35
1657216600901,MATH 18,B04,083751,Rideout; David Porter,5,0,36,31
1657216600901,MATH 18,B05,093473,Rideout; David Porter,5,0,36,31
1657216600901,MATH 18,B06,093474,Rideout; David Porter,5,0,36,31
1657216606926,MATH 20A,A01,083754,Zheng; Zequn,13,0,40,27
1657216612954,MATH 20B,A01,083756,Briones; Jor-el Thomas Caparas,2,0,36,34
1657216612954,MATH 20B,A02,083757,Briones; Jor-el Thomas Caparas,1,0,36,35
1657216612954,MATH 20B,A03,093475,Briones; Jor-el Thomas Caparas,1,0,36,35
1657216618988,MATH 20C,A01,083760,Briones; Jor-el Thomas Caparas,1,0,35,34
1657216618988,MATH 20C,A02,083761,Briones; Jor-el Thomas Caparas,8,0,35,27
1657216618988,MATH 20C,A03,093476,Briones; Jor-el Thomas Caparas,0,1,36,36
1657216618988,MATH 20C,B01,083762,Bach; Quang Tran,1,0,30,29
1657216625018,MATH 20D,A01,083765,Tran; Brian Kha,4,0,30,26
1657216625018,MATH 20D,A02,083766,Tran; Brian Kha,5,0,30,25
1657216625018,MATH 20D,A03,083767,Tran; Brian Kha,4,0,30,26
1657216631042,MATH 20E,A01,083771,Ganguly; Soumya,7,0,32,25
1657216631042,MATH 20E,A02,083772,Ganguly; Soumya,7,0,32,25
1657216631042,MATH 20E,B01,083773,Ciotti; Benjamin,19,0,35,16
1657216631042,MATH 20E,B02,083774,Ciotti; Benjamin,17,0,35,18
1657216637095,MATH 103A,A01,083777,Greenfeld; Be'Eri,2,0,36,34
1657216637095,MATH 103A,A02,083778,Greenfeld; Be'Eri,5,0,36,31
1657216637095,MATH 103A,A03,093561,Greenfeld; Be'Eri,4,0,36,32
1657216637095,MATH 103A,B01,083779,Greenfeld; Be'Eri,6,0,36,30
1657216637095,MATH 103A,B02,083780,Greenfeld; Be'Eri,3,0,36,33
1657216637095,MATH 103A,B03,093562,Greenfeld; Be'Eri,3,0,36,33
1657216643124,MATH 105,A01,085443,Carter; Anne Toulson,15,0,35,20
1657216643124,MATH 105,A02,093477,Carter; Anne Toulson,20,0,35,15
1657216649170,MATH 109,A01,083213,Ganzberger; Geoffrey Michael,2,0,34,32
1657216649170,MATH 109,A02,083214,Ganzberger; Geoffrey Michael,4,0,34,30
1657216649170,MATH 109,A03,093478,Ganzberger; Geoffrey Michael,2,0,34,32
1657216649170,MATH 109,B01,083215,Ganzberger; Geoffrey Michael,1,0,32,31
1657216649170,MATH 109,B02,083216,Ganzberger; Geoffrey Michael,1,0,32,31
1657216649170,MATH 109,B03,093479,Ganzberger; Geoffrey Michael,7,0,32,25
1657216655202,MATH 142A,A01,083219,Chow; Bennett,6,0,32,26
1657216655202,MATH 142A,A02,083220,Chow; Bennett,10,0,32,22
1657216655202,MATH 142A,A03,093480,Chow; Bennett,7,0,32,25
1657216655202,MATH 142A,B03,093481,Chow; Bennett,8,0,32,24
1657216655202,MATH 142A,B04,093558,Chow; Bennett,11,0,32,21
1657216655202,MATH 142A,B05,093559,Chow; Bennett,6,0,32,26
1657216661252,MATH 193A,A01,083224,Rotar; Vladimir,7,0,34,27
1657216661252,MATH 193A,A02,083225,Rotar; Vladimir,5,0,34,29
1657216661252,MATH 193A,A03,083781,Rotar; Vladimir,1,0,34,33
1657216661252,MATH 193A,A04,083782,Rotar; Vladimir,8,0,34,26
1657216661252,MATH 193A,A05,093482,Rotar; Vladimir,6,0,34,28
1657216667275,MATH 197,001,091859,McAuley; Julian John,9999,0,9999,0
1657216667275,MATH 197,002,095566,Kedlaya; Kiran S.,9997,0,9999,2
1657216667275,MATH 197,003,095567,Xiao; Ming,9999,0,9999,0
1657216667275,MATH 197,004,095571,Perols; Johan Lars,9998,0,9999,1
1657216674345,COGS 9,A01,083615,Shannon; Kyle Michael,8,0,75,67
1657216680379,COGS 11,A01,083617,Boyle; Mary E. T.,22,0,48,26
1657216686419,COGS 13,A01,083071,Bastos; Amalia Pinkusfeld,9,0,71,62
1657216692441,COGS 14A,A01,092681,Semenuks; Arturs,1,1,100,99
1657216698482,COGS 14B,A01,083073,Cheng; Tzu-Han,6,0,63,57
1657216704510,COGS 17,A01,092677,Semenuks; Arturs,4,0,81,77
1657216710539,COGS 100,A01,083619,Allen; Michael Gordon,15,0,70,55
1657216716577,COGS 101A,A01,083621,Davis; Joshua Daniel,9,0,68,59
1657216722603,COGS 101B,A01,091572,Allen; Michael Gordon,9,0,65,56
1657216728651,COGS 101C,A01,083625,Delgado; Tania,17,0,35,18
1657216734689,COGS 107A,A01,083627,Boyle; Mary E. T.,13,0,60,47
1657216740738,COGS 118A,A01,083075,Gupta; Anjum,16,0,76,60
1657216746788,CSE 3,A50,083646,Miranda; Gregory Joseph,24,0,50,26
1657216752816,CSE 8A,A50,083650,Miranda; Gregory Joseph,17,1,56,39
1657216758848,CSE 11,A01,083080,Cao; Yingjun,5,15,40,35
1657216764875,CSE 12,A01,083652,Krause-Levy; Sophia Louisa,24,1,120,96
1657216770912,CSE 15L,A01,083654,Morris; Justin Loren,9,0,50,41
1657216770912,CSE 15L,A02,083655,Morris; Justin Loren,9,0,50,41
1657216776940,CSE 20,A01,083657,Tran; Khoa Dang,38,0,80,42
1657216782974,CSE 21,A01,095574,Bach; Quang Tran,22,0,48,26
1657216789032,CSE 30,A01,083084,Eldon; John,4,0,80,76
1657216789032,CSE 30,B01,095061,Bhaskar; Nishant,8,0,50,42
1657216795086,CSE 100,A01,083659,Cao; Yingjun,4,4,70,66
1657216801116,CSE 134B,A01,083661,Powell; Thomas Allan,20,0,100,80
1657216807143,CSE 140,A01,083663,Gungor; Onat,13,0,85,72
1657216813178,CSE 140L,A01,083088,Eldon; John,17,0,100,83
1657216819212,CSE 175,A01,083665,Kumar; Rakesh,3,0,25,22
1657216825259,CSE 190,A00,092507,Dubnov; Shlomo,7,0,20,13
1657216831296,ECE 45,A01,083139,Congero; Spencer William,5,0,75,70
1657216837327,ECE 65,A50,083695,Saad; Andrew S,12,0,30,18
1657216837327,ECE 65,A51,095125,Saad; Andrew S,25,0,26,1
1657216843353,ECE 109,A01,091882,Touri; Behrouz,19,0,70,51
1657216849380,ECE 180,A00,083140,Abi Samra; Nicholas Camill,1,0,30,29
1657216849380,ECE 180,B00,083141,Abi Samra; Nicholas Camill,0,0,30,30
1657216855419,MATH 10A,A01,083735,Patchell; Gregory David,2,0,30,28
1657216855419,MATH 10A,A02,083736,Patchell; Gregory David,20,0,30,10
1657216855419,MATH 10A,A03,083737,Patchell; Gregory David,16,0,30,14
1657216861535,MATH 10B,A01,083207,Lim; Seonhee,7,0,34,27
1657216861535,MATH 10B,A02,083208,Lim; Seonhee,9,0,35,26
1657216861535,MATH 10B,A03,093472,Lim; Seonhee,5,0,34,29
1657216861535,MATH 10B,B01,083739,Sinha; Shubham,10,0,30,20
1657216867582,MATH 18,A01,083743,Cinel; Cameron Alexander,6,0,30,24
1657216867582,MATH 18,A02,083744,Cinel; Cameron Alexander,16,0,30,14
1657216867582,MATH 18,A03,083745,Cinel; Cameron Alexander,8,0,30,22
1657216867582,MATH 18,B01,083748,Rideout; David Porter,4,0,37,33
1657216867582,MATH 18,B02,083749,Rideout; David Porter,4,0,36,32
1657216867582,MATH 18,B03,083750,Rideout; David Porter,2,0,37,35
1657216867582,MATH 18,B04,083751,Rideout; David Porter,5,0,36,31
1657216867582,MATH 18,B05,093473,Rideout; David Porter,5,0,36,31
1657216867582,MATH 18,B06,093474,Rideout; David Porter,5,0,36,31
1657216873604,MATH 20A,A01,083754,Zheng; Zequn,13,0,40,27
1657216879628,MATH 20B,A01,083756,Briones; Jor-el Thomas Caparas,2,0,36,34
1657216879628,MATH 20B,A02,083757,Briones; Jor-el Thomas Caparas,1,0,36,35
1657216879628,MATH 20B,A03,093475,Briones; Jor-el Thomas Caparas,1,0,36,35
1657216885664,MATH 20C,A01,083760,Briones; Jor-el Thomas Caparas,1,0,35,34
1657216885664,MATH 20C,A02,083761,Briones; Jor-el Thomas Caparas,8,0,35,27
1657216885664,MATH 20C,A03,093476,Briones; Jor-el Thomas Caparas,0,1,36,36
1657216885664,MATH 20C,B01,083762,Bach; Quang Tran,1,0,30,29
1657216891712,MATH 20D,A01,083765,Tran; Brian Kha,4,0,30,26
1657216891712,MATH 20D,A02,083766,Tran; Brian Kha,5,0,30,25
1657216891712,MATH 20D,A03,083767,Tran; Brian Kha,4,0,30,26
1657216897748,MATH 20E,A01,083771,Ganguly; Soumya,7,0,32,25
1657216897748,MATH 20E,A02,083772,Ganguly; Soumya,7,0,32,25
1657216897748,MATH 20E,B01,083773,Ciotti; Benjamin,19,0,35,16
1657216897748,MATH 20E,B02,083774,Ciotti; Benjamin,17,0,35,18
1657216903794,MATH 103A,A01,083777,Greenfeld; Be'Eri,2,0,36,34
1657216903794,MATH 103A,A02,083778,Greenfeld; Be'Eri,5,0,36,31
1657216903794,MATH 103A,A03,093561,Greenfeld; Be'Eri,4,0,36,32
1657216903794,MATH 103A,B01,083779,Greenfeld; Be'Eri,6,0,36,30
1657216903794,MATH 103A,B02,083780,Greenfeld; Be'Eri,3,0,36,33
1657216903794,MATH 103A,B03,093562,Greenfeld; Be'Eri,3,0,36,33
1657216909827,MATH 105,A01,085443,Carter; Anne Toulson,15,0,35,20
1657216909827,MATH 105,A02,093477,Carter; Anne Toulson,20,0,35,15
1657216915867,MATH 109,A01,083213,Ganzberger; Geoffrey Michael,2,0,34,32
1657216915867,MATH 109,A02,083214,Ganzberger; Geoffrey Michael,4,0,34,30
1657216915867,MATH 109,A03,093478,Ganzberger; Geoffrey Michael,2,0,34,32
1657216915867,MATH 109,B01,083215,Ganzberger; Geoffrey Michael,1,0,32,31
1657216915867,MATH 109,B02,083216,Ganzberger; Geoffrey Michael,1,0,32,31
1657216915867,MATH 109,B03,093479,Ganzberger; Geoffrey Michael,7,0,32,25
1657216921898,MATH 142A,A01,083219,Chow; Bennett,6,0,32,26
1657216921898,MATH 142A,A02,083220,Chow; Bennett,10,0,32,22
1657216921898,MATH 142A,A03,093480,Chow; Bennett,7,0,32,25
1657216921898,MATH 142A,B03,093481,Chow; Bennett,8,0,32,24
1657216921898,MATH 142A,B04,093558,Chow; Bennett,11,0,32,21
1657216921898,MATH 142A,B05,093559,Chow; Bennett,6,0,32,26
1657216927946,MATH 193A,A01,083224,Rotar; Vladimir,7,0,34,27
1657216927946,MATH 193A,A02,083225,Rotar; Vladimir,5,0,34,29
1657216927946,MATH 193A,A03,083781,Rotar; Vladimir,1,0,34,33
1657216927946,MATH 193A,A04,083782,Rotar; Vladimir,8,0,34,26
1657216927946,MATH 193A,A05,093482,Rotar; Vladimir,6,0,34,28
1657216933992,MATH 197,001,091859,McAuley; Julian John,9999,0,9999,0
1657216933992,MATH 197,002,095566,Kedlaya; Kiran S.,9997,0,9999,2
1657216933992,MATH 197,003,095567,Xiao; Ming,9999,0,9999,0
1657216933992,MATH 197,004,095571,Perols; Johan Lars,9998,0,9999,1
1657216941087,COGS 9,A01,083615,Shannon; Kyle Michael,8,0,75,67
1657216947128,COGS 11,A01,083617,Boyle; Mary E. T.,22,0,48,26
1657216953156,COGS 13,A01,083071,Bastos; Amalia Pinkusfeld,9,0,71,62
1657216959184,COGS 14A,A01,092681,Semenuks; Arturs,1,1,100,99
1657216965218,COGS 14B,A01,083073,Cheng; Tzu-Han,6,0,63,57
1657216971258,COGS 17,A01,092677,Semenuks; Arturs,4,0,81,77
1657216977282,COGS 100,A01,083619,Allen; Michael Gordon,15,0,70,55
1657216983308,COGS 101A,A01,083621,Davis; Joshua Daniel,9,0,68,59
1657216989362,COGS 101B,A01,091572,Allen; Michael Gordon,9,0,65,56
1657216995408,COGS 101C,A01,083625,Delgado; Tania,17,0,35,18
1657217001435,COGS 107A,A01,083627,Boyle; Mary E. T.,13,0,60,47
1657217007469,COGS 118A,A01,083075,Gupta; Anjum,16,0,76,60
1657217013499,CSE 3,A50,083646,Miranda; Gregory Joseph,24,0,50,26
1657217019521,CSE 8A,A50,083650,Miranda; Gregory Joseph,17,1,56,39
1657217025548,CSE 11,A01,083080,Cao; Yingjun,5,15,40,35
1657217031605,CSE 12,A01,083652,Krause-Levy; Sophia Louisa,24,1,120,96
1657217037639,CSE 15L,A01,083654,Morris; Justin Loren,9,0,50,41
1657217037639,CSE 15L,A02,083655,Morris; Justin Loren,9,0,50,41
1657217043677,CSE 20,A01,083657,Tran; Khoa Dang,38,0,80,42
1657217049709,CSE 21,A01,095574,Bach; Quang Tran,22,0,48,26
1657217055733,CSE 30,A01,083084,Eldon; John,4,0,80,76
1657217055733,CSE 30,B01,095061,Bhaskar; Nishant,8,0,50,42
1657217061783,CSE 100,A01,083659,Cao; Yingjun,4,4,70,66
1657217067829,CSE 134B,A01,083661,Powell; Thomas Allan,20,0,100,80
1657217073864,CSE 140,A01,083663,Gungor; Onat,13,0,85,72
1657217080102,CSE 140L,A01,083088,Eldon; John,17,0,100,83
1657217086123,CSE 175,A01,083665,Kumar; Rakesh,3,0,25,22
1657217092156,CSE 190,A00,092507,Dubnov; Shlomo,7,0,20,13
1657217098195,ECE 45,A01,083139,Congero; Spencer William,5,0,75,70
1657217104233,ECE 65,A50,083695,Saad; Andrew S,12,0,30,18
1657217104233,ECE 65,A51,095125,Saad; Andrew S,25,0,26,1
1657217110267,ECE 109,A01,091882,Touri; Behrouz,19,0,70,51
1657217116314,ECE 180,A00,083140,Abi Samra; Nicholas Camill,1,0,30,29
1657217116314,ECE 180,B00,083141,Abi Samra; Nicholas Camill,0,0,30,30
1657217122342,MATH 10A,A01,083735,Patchell; Gregory David,2,0,30,28
1657217122342,MATH 10A,A02,083736,Patchell; Gregory David,20,0,30,10
1657217122342,MATH 10A,A03,083737,Patchell; Gregory David,16,0,30,14
1657217128369,MATH 10B,A01,083207,Lim; Seonhee,7,0,34,27
1657217128369,MATH 10B,A02,083208,Lim; Seonhee,9,0,35,26
1657217128369,MATH 10B,A03,093472,Lim; Seonhee,5,0,34,29
1657217128369,MATH 10B,B01,083739,Sinha; Shubham,10,0,30,20
1657217134406,MATH 18,A01,083743,Cinel; Cameron Alexander,6,0,30,24
1657217134406,MATH 18,A02,083744,Cinel; Cameron Alexander,16,0,30,14
1657217134406,MATH 18,A03,083745,Cinel; Cameron Alexander,8,0,30,22
1657217134406,MATH 18,B01,083748,Rideout; David Porter,4,0,37,33
1657217134406,MATH 18,B02,083749,Rideout; David Porter,4,0,36,32
1657217134406,MATH 18,B03,083750,Rideout; David Porter,2,0,37,35
1657217134406,MATH 18,B04,083751,Rideout; David Porter,5,0,36,31
1657217134406,MATH 18,B05,093473,Rideout; David Porter,5,0,36,31
1657217134406,MATH 18,B06,093474,Rideout; David Porter,5,0,36,31
1657217140439,MATH 20A,A01,083754,Zheng; Zequn,13,0,40,27
1657217146461,MATH 20B,A01,083756,Briones; Jor-el Thomas Caparas,2,0,36,34
1657217146461,MATH 20B,A02,083757,Briones; Jor-el Thomas Caparas,1,0,36,35
1657217146461,MATH 20B,A03,093475,Briones; Jor-el Thomas Caparas,1,0,36,35
1657217152500,MATH 20C,A01,083760,Briones; Jor-el Thomas Caparas,1,0,35,34
1657217152500,MATH 20C,A02,083761,Briones; Jor-el Thomas Caparas,8,0,35,27
1657217152500,MATH 20C,A03,093476,Briones; Jor-el Thomas Caparas,0,1,36,36
1657217152500,MATH 20C,B01,083762,Bach; Quang Tran,1,0,30,29
1657217158540,MATH 20D,A01,083765,Tran; Brian Kha,4,0,30,26
1657217158540,MATH 20D,A02,083766,Tran; Brian Kha,5,0,30,25
1657217158540,MATH 20D,A03,083767,Tran; Brian Kha,4,0,30,26
1657217164582,MATH 20E,A01,083771,Ganguly; Soumya,7,0,32,25
1657217164582,MATH 20E,A02,083772,Ganguly; Soumya,7,0,32,25
1657217164582,MATH 20E,B01,083773,Ciotti; Benjamin,19,0,35,16
1657217164582,MATH 20E,B02,083774,Ciotti; Benjamin,17,0,35,18
1657217170639,MATH 103A,A01,083777,Greenfeld; Be'Eri,2,0,36,34
1657217170639,MATH 103A,A02,083778,Greenfeld; Be'Eri,5,0,36,31
1657217170639,MATH 103A,A03,093561,Greenfeld; Be'Eri,4,0,36,32
1657217170639,MATH 103A,B01,083779,Greenfeld; Be'Eri,6,0,36,30
1657217170639,MATH 103A,B02,083780,Greenfeld; Be'Eri,3,0,36,33
1657217170639,MATH 103A,B03,093562,Greenfeld; Be'Eri,3,0,36,33
1657217176683,MATH 105,A01,085443,Carter; Anne Toulson,15,0,35,20
1657217176683,MATH 105,A02,093477,Carter; Anne Toulson,20,0,35,15
1657217182707,MATH 109,A01,083213,Ganzberger; Geoffrey Michael,2,0,34,32
1657217182707,MATH 109,A02,083214,Ganzberger; Geoffrey Michael,4,0,34,30
1657217182707,MATH 109,A03,093478,Ganzberger; Geoffrey Michael,2,0,34,32
1657217182707,MATH 109,B01,083215,Ganzberger; Geoffrey Michael,1,0,32,31
1657217182707,MATH 109,B02,083216,Ganzberger; Geoffrey Michael,1,0,32,31
1657217182707,MATH 109,B03,093479,Ganzberger; Geoffrey Michael,7,0,32,25
1657217188735,MATH 142A,A01,083219,Chow; Bennett,6,0,32,26
1657217188735,MATH 142A,A02,083220,Chow; Bennett,10,0,32,22
1657217188735,MATH 142A,A03,093480,Chow; Bennett,7,0,32,25
1657217188735,MATH 142A,B03,093481,Chow; Bennett,8,0,32,24
1657217188735,MATH 142A,B04,093558,Chow; Bennett,11,0,32,21
1657217188735,MATH 142A,B05,093559,Chow; Bennett,6,0,32,26
1657217194778,MATH 193A,A01,083224,Rotar; Vladimir,7,0,34,27
1657217194778,MATH 193A,A02,083225,Rotar; Vladimir,5,0,34,29
1657217194778,MATH 193A,A03,083781,Rotar; Vladimir,1,0,34,33
1657217194778,MATH 193A,A04,083782,Rotar; Vladimir,8,0,34,26
1657217194778,MATH 193A,A05,093482,Rotar; Vladimir,6,0,34,28
1657217200799,MATH 197,001,091859,McAuley; Julian John,9999,0,9999,0
1657217200799,MATH 197,002,095566,Kedlaya; Kiran S.,9997,0,9999,2
1657217200799,MATH 197,003,095567,Xiao; Ming,9999,0,9999,0
1657217200799,MATH 197,004,095571,Perols; Johan Lars,9998,0,9999,1
1657217207851,COGS 9,A01,083615,Shannon; Kyle Michael,8,0,75,67
1657217213877,COGS 11,A01,083617,Boyle; Mary E. T.,22,0,48,26
1657217219923,COGS 13,A01,083071,Bastos; Amalia Pinkusfeld,9,0,71,62
1657217225961,COGS 14A,A01,092681,Semenuks; Arturs,1,1,100,99
1657217231986,COGS 14B,A01,083073,Cheng; Tzu-Han,6,0,63,57
1657217238016,COGS 17,A01,092677,Semenuks; Arturs,4,0,81,77
1657217244040,COGS 100,A01,083619,Allen; Michael Gordon,15,0,70,55
1657217250079,COGS 101A,A01,083621,Davis; Joshua Daniel,9,0,68,59
1657217256123,COGS 101B,A01,091572,Allen; Michael Gordon,9,0,65,56
1657217262151,COGS 101C,A01,083625,Delgado; Tania,17,0,35,18
1657217268196,COGS 107A,A01,083627,Boyle; Mary E. T.,13,0,60,47
1657217274219,COGS 118A,A01,083075,Gupta; Anjum,16,0,76,60
1657217280264,CSE 3,A50,083646,Miranda; Gregory Joseph,24,0,50,26
1657217286300,CSE 8A,A50,083650,Miranda; Gregory Joseph,17,1,56,39
1657217292333,CSE 11,A01,083080,Cao; Yingjun,5,15,40,35
1657217298366,CSE 12,A01,083652,Krause-Levy; Sophia Louisa,24,1,120,96
1657217304388,CSE 15L,A01,083654,Morris; Justin Loren,9,0,50,41
1657217304388,CSE 15L,A02,083655,Morris; Justin Loren,9,0,50,41
1657217310417,CSE 20,A01,083657,Tran; Khoa Dang,38,0,80,42
1657217316451,CSE 21,A01,095574,Bach; Quang Tran,22,0,48,26
1657217322493,CSE 30,A01,083084,Eldon; John,4,0,80,76
1657217322493,CSE 30,B01,095061,Bhaskar; Nishant,8,0,50,42
1657217328522,CSE 100,A01,083659,Cao; Yingjun,4,4,70,66
1657217334569,CSE 134B,A01,083661,Powell; Thomas Allan,20,0,100,80
1657217340608,CSE 140,A01,083663,Gungor; Onat,13,0,85,72
1657217346655,CSE 140L,A01,083088,Eldon; John,17,0,100,83
1657217352710,CSE 175,A01,083665,Kumar; Rakesh,3,0,25,22
1657217358753,CSE 190,A00,092507,Dubnov; Shlomo,7,0,20,13
1657217364798,ECE 45,A01,083139,Congero; Spencer William,5,0,75,70
1657217370833,ECE 65,A50,083695,Saad; Andrew S,12,0,30,18
1657217370833,ECE 65,A51,095125,Saad; Andrew S,25,0,26,1
1657217376859,ECE 109,A01,091882,Touri; Behrouz,19,0,70,51
1657217382884,ECE 180,A00,083140,Abi Samra; Nicholas Camill,1,0,30,29
1657217382884,ECE 180,B00,083141,Abi Samra; Nicholas Camill,0,0,30,30
1657217388914,MATH 10A,A01,083735,Patchell; Gregory David,2,0,30,28
1657217388914,MATH 10A,A02,083736,Patchell; Gregory David,20,0,30,10
1657217388914,MATH 10A,A03,083737,Patchell; Gregory David,16,0,30,14
1657217394958,MATH 10B,A01,083207,Lim; Seonhee,7,0,34,27
1657217394958,MATH 10B,A02,083208,Lim; Seonhee,9,0,35,26
1657217394958,MATH 10B,A03,093472,Lim; Seonhee,5,0,34,29
1657217394958,MATH 10B,B01,083739,Sinha; Shubham,10,0,30,20
1657217400989,MATH 18,A01,083743,Cinel; Cameron Alexander,6,0,30,24
1657217400989,MATH 18,A02,083744,Cinel; Cameron Alexander,16,0,30,14
1657217400989,MATH 18,A03,083745,Cinel; Cameron Alexander,8,0,30,22
1657217400989,MATH 18,B01,083748,Rideout; David Porter,4,0,37,33
1657217400989,MATH 18,B02,083749,Rideout; David Porter,4,0,36,32
1657217400989,MATH 18,B03,083750,Rideout; David Porter,2,0,37,35
1657217400989,MATH 18,B04,083751,Rideout; David Porter,5,0,36,31
1657217400989,MATH 18,B05,093473,Rideout; David Porter,5,0,36,31
1657217400989,MATH 18,B06,093474,Rideout; David Porter,5,0,36,31
1657217407025,MATH 20A,A01,083754,Zheng; Zequn,13,0,40,27
1657217413059,MATH 20B,A01,083756,Briones; Jor-el Thomas Caparas,2,0,36,34
1657217413059,MATH 20B,A02,083757,Briones; Jor-el Thomas Caparas,1,0,36,35
1657217413059,MATH 20B,A03,093475,Briones; Jor-el Thomas Caparas,1,0,36,35
1657217419105,MATH 20C,A01,083760,Briones; Jor-el Thomas Caparas,1,0,35,34
1657217419105,MATH 20C,A02,083761,Briones; Jor-el Thomas Caparas,8,0,35,27
1657217419105,MATH 20C,A03,093476,Briones; Jor-el Thomas Caparas,0,1,36,36
1657217419105,MATH 20C,B01,083762,Bach; Quang Tran,1,0,30,29
1657217425141,MATH 20D,A01,083765,Tran; Brian Kha,4,0,30,26
1657217425141,MATH 20D,A02,083766,Tran; Brian Kha,5,0,30,25
1657217425141,MATH 20D,A03,083767,Tran; Brian Kha,4,0,30,26
1657217431166,MATH 20E,A01,083771,Ganguly; Soumya,7,0,32,25
1657217431166,MATH 20E,A02,083772,Ganguly; Soumya,7,0,32,25
1657217431166,MATH 20E,B01,083773,Ciotti; Benjamin,19,0,35,16
1657217431166,MATH 20E,B02,083774,Ciotti; Benjamin,17,0,35,18
1657217437213,MATH 103A,A01,083777,Greenfeld; Be'Eri,2,0,36,34
1657217437213,MATH 103A,A02,083778,Greenfeld; Be'Eri,5,0,36,31
1657217437213,MATH 103A,A03,093561,Greenfeld; Be'Eri,4,0,36,32
1657217437213,MATH 103A,B01,083779,Greenfeld; Be'Eri,6,0,36,30
1657217437213,MATH 103A,B02,083780,Greenfeld; Be'Eri,3,0,36,33
1657217437213,MATH 103A,B03,093562,Greenfeld; Be'Eri,3,0,36,33
1657217443243,MATH 105,A01,085443,Carter; Anne Toulson,15,0,35,20
1657217443243,MATH 105,A02,093477,Carter; Anne Toulson,20,0,35,15
1657217449270,MATH 109,A01,083213,Ganzberger; Geoffrey Michael,2,0,34,32
1657217449270,MATH 109,A02,083214,Ganzberger; Geoffrey Michael,4,0,34,30
1657217449270,MATH 109,A03,093478,Ganzberger; Geoffrey Michael,2,0,34,32
1657217449270,MATH 109,B01,083215,Ganzberger; Geoffrey Michael,1,0,32,31
1657217449270,MATH 109,B02,083216,Ganzberger; Geoffrey Michael,1,0,32,31
1657217449270,MATH 109,B03,093479,Ganzberger; Geoffrey Michael,7,0,32,25
1657217455314,MATH 142A,A01,083219,Chow; Bennett,6,0,32,26
1657217455314,MATH 142A,A02,083220,Chow; Bennett,10,0,32,22
1657217455314,MATH 142A,A03,093480,Chow; Bennett,7,0,32,25
1657217455314,MATH 142A,B03,093481,Chow; Bennett,8,0,32,24
1657217455314,MATH 142A,B04,093558,Chow; Bennett,11,0,32,21
1657217455314,MATH 142A,B05,093559,Chow; Bennett,6,0,32,26
1657217461415,MATH 193A,A01,083224,Rotar; Vladimir,7,0,34,27
1657217461415,MATH 193A,A02,083225,Rotar; Vladimir,5,0,34,29
1657217461415,MATH 193A,A03,083781,Rotar; Vladimir,1,0,34,33
1657217461415,MATH 193A,A04,083782,Rotar; Vladimir,8,0,34,26
1657217461415,MATH 193A,A05,093482,Rotar; Vladimir,6,0,34,28
1657217467460,MATH 197,001,091859,McAuley; Julian John,9999,0,9999,0
1657217467460,MATH 197,002,095566,Kedlaya; Kiran S.,9997,0,9999,2
1657217467460,MATH 197,003,095567,Xiao; Ming,9999,0,9999,0
1657217467460,MATH 197,004,095571,Perols; Johan Lars,9998,0,9999,1
1657217474541,COGS 9,A01,083615,Shannon; Kyle Michael,8,0,75,67
1657217480582,COGS 11,A01,083617,Boyle; Mary E. T.,22,0,48,26
1657217486632,COGS 13,A01,083071,Bastos; Amalia Pinkusfeld,9,0,71,62
1657217492679,COGS 14A,A01,092681,Semenuks; Arturs,1,1,100,99
1657217498718,COGS 14B,A01,083073,Cheng; Tzu-Han,6,0,63,57
1657217504741,COGS 17,A01,092677,Semenuks; Arturs,4,0,81,77
1657217510763,COGS 100,A01,083619,Allen; Michael Gordon,15,0,70,55
1657217516790,COGS 101A,A01,083621,Davis; Joshua Daniel,9,0,68,59
1657217522816,COGS 101B,A01,091572,Allen; Michael Gordon,9,0,65,56
1657217528843,COGS 101C,A01,083625,Delgado; Tania,17,0,35,18
1657217534871,COGS 107A,A01,083627,Boyle; Mary E. T.,13,0,60,47
1657217540895,COGS 118A,A01,083075,Gupta; Anjum,16,0,76,60
1657217546923,CSE 3,A50,083646,Miranda; Gregory Joseph,24,0,50,26
1657217552951,CSE 8A,A50,083650,Miranda; Gregory Joseph,17,1,56,39
1657217558975,CSE 11,A01,083080,Cao; Yingjun,5,15,40,35
1657217565003,CSE 12,A01,083652,Krause-Levy; Sophia Louisa,24,1,120,96
1657217571047,CSE 15L,A01,083654,Morris; Justin Loren,9,0,50,41
1657217571047,CSE 15L,A02,083655,Morris; Justin Loren,9,0,50,41
1657217577085,CSE 20,A01,083657,Tran; Khoa Dang,38,0,80,42
1657217583112,CSE 21,A01,095574,Bach; Quang Tran,22,0,48,26
1657217589139,CSE 30,A01,083084,Eldon; John,4,0,80,76
1657217589139,CSE 30,B01,095061,Bhaskar; Nishant,8,0,50,42
1657217595162,CSE 100,A01,083659,Cao; Yingjun,4,4,70,66
1657217601186,CSE 134B,A01,083661,Powell; Thomas Allan,20,0,100,80
1657217607208,CSE 140,A01,083663,Gungor; Onat,13,0,85,72
1657217613232,CSE 140L,A01,083088,Eldon; John,17,0,100,83
1657217619260,CSE 175,A01,083665,Kumar; Rakesh,3,0,25,22
1657217625283,CSE 190,A00,092507,Dubnov; Shlomo,7,0,20,13
1657217631306,ECE 45,A01,083139,Congero; Spencer William,5,0,75,70
1657217637331,ECE 65,A50,083695,Saad; Andrew S,12,0,30,18
1657217637331,ECE 65,A51,095125,Saad; Andrew S,25,0,26,1
1657217643354,ECE 109,A01,091882,Touri; Behrouz,19,0,70,51
1657217649378,ECE 180,A00,083140,Abi Samra; Nicholas Camill,1,0,30,29
1657217649378,ECE 180,B00,083141,Abi Samra; Nicholas Camill,0,0,30,30
1657217655409,MATH 10A,A01,083735,Patchell; Gregory David,2,0,30,28
1657217655409,MATH 10A,A02,083736,Patchell; Gregory David,20,0,30,10
1657217655409,MATH 10A,A03,083737,Patchell; Gregory David,16,0,30,14
1657217661436,MATH 10B,A01,083207,Lim; Seonhee,7,0,34,27
1657217661436,MATH 10B,A02,083208,Lim; Seonhee,9,0,35,26
1657217661436,MATH 10B,A03,093472,Lim; Seonhee,5,0,34,29
1657217661436,MATH 10B,B01,083739,Sinha; Shubham,10,0,30,20
1657217667465,MATH 18,A01,083743,Cinel; Cameron Alexander,6,0,30,24
1657217667465,MATH 18,A02,083744,Cinel; Cameron Alexander,16,0,30,14
1657217667465,MATH 18,A03,083745,Cinel; Cameron Alexander,8,0,30,22
1657217667465,MATH 18,B01,083748,Rideout; David Porter,4,0,37,33
1657217667465,MATH 18,B02,083749,Rideout; David Porter,4,0,36,32
1657217667465,MATH 18,B03,083750,Rideout; David Porter,2,0,37,35
1657217667465,MATH 18,B04,083751,Rideout; David Porter,5,0,36,31
1657217667465,MATH 18,B05,093473,Rideout; David Porter,5,0,36,31
1657217667465,MATH 18,B06,093474,Rideout; David Porter,5,0,36,31
1657217673496,MATH 20A,A01,083754,Zheng; Zequn,13,0,40,27
1657217679519,MATH 20B,A01,083756,Briones; Jor-el Thomas Caparas,2,0,36,34
1657217679519,MATH 20B,A02,083757,Briones; Jor-el Thomas Caparas,1,0,36,35
1657217679519,MATH 20B,A03,093475,Briones; Jor-el Thomas Caparas,1,0,36,35
1657217685542,MATH 20C,A01,083760,Briones; Jor-el Thomas Caparas,1,0,35,34
1657217685542,MATH 20C,A02,083761,Briones; Jor-el Thomas Caparas,8,0,35,27
1657217685542,MATH 20C,A03,093476,Briones; Jor-el Thomas Caparas,0,1,36,36
1657217685542,MATH 20C,B01,083762,Bach; Quang Tran,1,0,30,29
1657217691566,MATH 20D,A01,083765,Tran; Brian Kha,4,0,30,26
1657217691566,MATH 20D,A02,083766,Tran; Brian Kha,5,0,30,25
1657217691566,MATH 20D,A03,083767,Tran; Brian Kha,4,0,30,26
1657217697590,MATH 20E,A01,083771,Ganguly; Soumya,7,0,32,25
1657217697590,MATH 20E,A02,083772,Ganguly; Soumya,7,0,32,25
1657217697590,MATH 20E,B01,083773,Ciotti; Benjamin,19,0,35,16
1657217697590,MATH 20E,B02,083774,Ciotti; Benjamin,17,0,35,18
1657217703624,MATH 103A,A01,083777,Greenfeld; Be'Eri,2,0,36,34
1657217703624,MATH 103A,A02,083778,Greenfeld; Be'Eri,5,0,36,31
1657217703624,MATH 103A,A03,093561,Greenfeld; Be'Eri,4,0,36,32
1657217703624,MATH 103A,B01,083779,Greenfeld; Be'Eri,6,0,36,30
1657217703624,MATH 103A,B02,083780,Greenfeld; Be'Eri,3,0,36,33
1657217703624,MATH 103A,B03,093562,Greenfeld; Be'Eri,3,0,36,33
1657217709653,MATH 105,A01,085443,Carter; Anne Toulson,15,0,35,20
1657217709653,MATH 105,A02,093477,Carter; Anne Toulson,20,0,35,15
1657217715697,MATH 109,A01,083213,Ganzberger; Geoffrey Michael,2,0,34,32
1657217715697,MATH 109,A02,083214,Ganzberger; Geoffrey Michael,4,0,34,30
1657217715697,MATH 109,A03,093478,Ganzberger; Geoffrey Michael,2,0,34,32
1657217715697,MATH 109,B01,083215,Ganzberger; Geoffrey Michael,1,0,32,31
1657217715697,MATH 109,B02,083216,Ganzberger; Geoffrey Michael,1,0,32,31
1657217715697,MATH 109,B03,093479,Ganzberger; Geoffrey Michael,7,0,32,25
1657217721743,MATH 142A,A01,083219,Chow; Bennett,6,0,32,26
1657217721743,MATH 142A,A02,083220,Chow; Bennett,10,0,32,22
1657217721743,MATH 142A,A03,093480,Chow; Bennett,7,0,32,25
1657217721743,MATH 142A,B03,093481,Chow; Bennett,8,0,32,24
1657217721743,MATH 142A,B04,093558,Chow; Bennett,11,0,32,21
1657217721743,MATH 142A,B05,093559,Chow; Bennett,6,0,32,26
1657217727768,MATH 193A,A01,083224,Rotar; Vladimir,7,0,34,27
1657217727768,MATH 193A,A02,083225,Rotar; Vladimir,5,0,34,29
1657217727768,MATH 193A,A03,083781,Rotar; Vladimir,1,0,34,33
1657217727768,MATH 193A,A04,083782,Rotar; Vladimir,8,0,34,26
1657217727768,MATH 193A,A05,093482,Rotar; Vladimir,6,0,34,28
1657217733802,MATH 197,001,091859,McAuley; Julian John,9999,0,9999,0
1657217733802,MATH 197,002,095566,Kedlaya; Kiran S.,9997,0,9999,2
1657217733802,MATH 197,003,095567,Xiao; Ming,9999,0,9999,0
1657217733802,MATH 197,004,095571,Perols; Johan Lars,9998,0,9999,1
1657217740870,COGS 9,A01,083615,Shannon; Kyle Michael,8,0,75,67
1657217746903,COGS 11,A01,083617,Boyle; Mary E. T.,22,0,48,26
1657217752950,COGS 13,A01,083071,Bastos; Amalia Pinkusfeld,9,0,71,62
1657217758992,COGS 14A,A01,092681,Semenuks; Arturs,1,1,100,99
1657217765022,COGS 14B,A01,083073,Cheng; Tzu-Han,6,0,63,57
1657217771059,COGS 17,A01,092677,Semenuks; Arturs,4,0,81,77
1657217777092,COGS 100,A01,083619,Allen; Michael Gordon,15,0,70,55
1657217783119,COGS 101A,A01,083621,Davis; Joshua Daniel,9,0,68,59
1657217789148,COGS 101B,A01,091572,Allen; Michael Gordon,9,0,65,56
1657217795176,COGS 101C,A01,083625,Delgado; Tania,17,0,35,18
1657217801198,COGS 107A,A01,083627,Boyle; Mary E. T.,13,0,60,47
1657217807229,COGS 118A,A01,083075,Gupta; Anjum,16,0,76,60
1657217813251,CSE 3,A50,083646,Miranda; Gregory Joseph,24,0,50,26
1657217819276,CSE 8A,A50,083650,Miranda; Gregory Joseph,17,1,56,39
1657217825303,CSE 11,A01,083080,Cao; Yingjun,5,15,40,35
1657217831336,CSE 12,A01,083652,Krause-Levy; Sophia Louisa,24,1,120,96
1657217837365,CSE 15L,A01,083654,Morris; Justin Loren,9,0,50,41
1657217837365,CSE 15L,A02,083655,Morris; Justin Loren,9,0,50,41
1657217843408,CSE 20,A01,083657,Tran; Khoa Dang,38,0,80,42
1657217849434,CSE 21,A01,095574,Bach; Quang Tran,22,0,48,26
1657217855462,CSE 30,A01,083084,Eldon; John,4,0,80,76
1657217855462,CSE 30,B01,095061,Bhaskar; Nishant,8,0,50,42
1657217861499,CSE 100,A01,083659,Cao; Yingjun,4,4,70,66
1657217867533,CSE 134B,A01,083661,Powell; Thomas Allan,20,0,100,80
1657217873572,CSE 140,A01,083663,Gungor; Onat,13,0,85,72
1657217879596,CSE 140L,A01,083088,Eldon; John,17,0,100,83
1657217885624,CSE 175,A01,083665,Kumar; Rakesh,3,0,25,22
1657217891661,CSE 190,A00,092507,Dubnov; Shlomo,7,0,20,13
1657217897690,ECE 45,A01,083139,Congero; Spencer William,5,0,75,70
1657217903715,ECE 65,A50,083695,Saad; Andrew S,12,0,30,18
1657217903715,ECE 65,A51,095125,Saad; Andrew S,25,0,26,1
1657217909762,ECE 109,A01,091882,Touri; Behrouz,19,0,70,51
1657217915787,ECE 180,A00,083140,Abi Samra; Nicholas Camill,1,0,30,29
1657217915787,ECE 180,B00,083141,Abi Samra; Nicholas Camill,0,0,30,30
1657217921822,MATH 10A,A01,083735,Patchell; Gregory David,2,0,30,28
1657217921822,MATH 10A,A02,083736,Patchell; Gregory David,20,0,30,10
1657217921822,MATH 10A,A03,083737,Patchell; Gregory David,16,0,30,14
1657217927872,MATH 10B,A01,083207,Lim; Seonhee,7,0,34,27
1657217927872,MATH 10B,A02,083208,Lim; Seonhee,9,0,35,26
1657217927872,MATH 10B,A03,093472,Lim; Seonhee,5,0,34,29
1657217927872,MATH 10B,B01,083739,Sinha; Shubham,10,0,30,20
1657217933906,MATH 18,A01,083743,Cinel; Cameron Alexander,6,0,30,24
1657217933906,MATH 18,A02,083744,Cinel; Cameron Alexander,16,0,30,14
1657217933906,MATH 18,A03,083745,Cinel; Cameron Alexander,8,0,30,22
1657217933906,MATH 18,B01,083748,Rideout; David Porter,4,0,37,33
1657217933906,MATH 18,B02,083749,Rideout; David Porter,4,0,36,32
1657217933906,MATH 18,B03,083750,Rideout; David Porter,2,0,37,35
1657217933906,MATH 18,B04,083751,Rideout; David Porter,5,0,36,31
1657217933906,MATH 18,B05,093473,Rideout; David Porter,5,0,36,31
1657217933906,MATH 18,B06,093474,Rideout; David Porter,5,0,36,31
1657217939942,MATH 20A,A01,083754,Zheng; Zequn,13,0,40,27
1657217945975,MATH 20B,A01,083756,Briones; Jor-el Thomas Caparas,2,0,36,34
1657217945975,MATH 20B,A02,083757,Briones; Jor-el Thomas Caparas,1,0,36,35
1657217945975,MATH 20B,A03,093475,Briones; Jor-el Thomas Caparas,1,0,36,35
1657217952002,MATH 20C,A01,083760,Briones; Jor-el Thomas Caparas,1,0,35,34
1657217952002,MATH 20C,A02,083761,Briones; Jor-el Thomas Caparas,8,0,35,27
1657217952002,MATH 20C,A03,093476,Briones; Jor-el Thomas Caparas,0,1,36,36
1657217952002,MATH 20C,B01,083762,Bach; Quang Tran,1,0,30,29
1657217958033,MATH 20D,A01,083765,Tran; Brian Kha,4,0,30,26
1657217958033,MATH 20D,A02,083766,Tran; Brian Kha,5,0,30,25
1657217958033,MATH 20D,A03,083767,Tran; Brian Kha,4,0,30,26
1657217964057,MATH 20E,A01,083771,Ganguly; Soumya,7,0,32,25
1657217964057,MATH 20E,A02,083772,Ganguly; Soumya,7,0,32,25
1657217964057,MATH 20E,B01,083773,Ciotti; Benjamin,19,0,35,16
1657217964057,MATH 20E,B02,083774,Ciotti; Benjamin,17,0,35,18
1657217970096,MATH 103A,A01,083777,Greenfeld; Be'Eri,2,0,36,34
1657217970096,MATH 103A,A02,083778,Greenfeld; Be'Eri,5,0,36,31
1657217970096,MATH 103A,A03,093561,Greenfeld; Be'Eri,4,0,36,32
1657217970096,MATH 103A,B01,083779,Greenfeld; Be'Eri,6,0,36,30
1657217970096,MATH 103A,B02,083780,Greenfeld; Be'Eri,3,0,36,33
1657217970096,MATH 103A,B03,093562,Greenfeld; Be'Eri,3,0,36,33
1657217976131,MATH 105,A01,085443,Carter; Anne Toulson,15,0,35,20
1657217976131,MATH 105,A02,093477,Carter; Anne Toulson,20,0,35,15
1657217982156,MATH 109,A01,083213,Ganzberger; Geoffrey Michael,2,0,34,32
1657217982156,MATH 109,A02,083214,Ganzberger; Geoffrey Michael,4,0,34,30
1657217982156,MATH 109,A03,093478,Ganzberger; Geoffrey Michael,2,0,34,32
1657217982156,MATH 109,B01,083215,Ganzberger; Geoffrey Michael,1,0,32,31
1657217982156,MATH 109,B02,083216,Ganzberger; Geoffrey Michael,1,0,32,31
1657217982156,MATH 109,B03,093479,Ganzberger; Geoffrey Michael,7,0,32,25
1657217988203,MATH 142A,A01,083219,Chow; Bennett,6,0,32,26
1657217988203,MATH 142A,A02,083220,Chow; Bennett,10,0,32,22
1657217988203,MATH 142A,A03,093480,Chow; Bennett,7,0,32,25
1657217988203,MATH 142A,B03,093481,Chow; Bennett,8,0,32,24
1657217988203,MATH 142A,B04,093558,Chow; Bennett,11,0,32,21
1657217988203,MATH 142A,B05,093559,Chow; Bennett,6,0,32,26
1657217994226,MATH 193A,A01,083224,Rotar; Vladimir,7,0,34,27
1657217994226,MATH 193A,A02,083225,Rotar; Vladimir,5,0,34,29
1657217994226,MATH 193A,A03,083781,Rotar; Vladimir,1,0,34,33
1657217994226,MATH 193A,A04,083782,Rotar; Vladimir,8,0,34,26
1657217994226,MATH 193A,A05,093482,Rotar; Vladimir,6,0,34,28
1657218000266,MATH 197,001,091859,McAuley; Julian John,9999,0,9999,0
1657218000266,MATH 197,002,095566,Kedlaya; Kiran S.,9997,0,9999,2
1657218000266,MATH 197,003,095567,Xiao; Ming,9999,0,9999,0
1657218000266,MATH 197,004,095571,Perols; Johan Lars,9998,0,9999,1
1657218007336,COGS 9,A01,083615,Shannon; Kyle Michael,8,0,75,67
1657218013363,COGS 11,A01,083617,Boyle; Mary E. T.,22,0,48,26
1657218019398,COGS 13,A01,083071,Bastos; Amalia Pinkusfeld,9,0,71,62
1657218025421,COGS 14A,A01,092681,Semenuks; Arturs,1,1,100,99
1657218031451,COGS 14B,A01,083073,Cheng; Tzu-Han,6,0,63,57
1657218037475,COGS 17,A01,092677,Semenuks; Arturs,4,0,81,77
1657218043500,COGS 100,A01,083619,Allen; Michael Gordon,15,0,70,55
1657218049525,COGS 101A,A01,083621,Davis; Joshua Daniel,9,0,68,59
1657218055628,COGS 101B,A01,091572,Allen; Michael Gordon,9,0,65,56
1657218061656,COGS 101C,A01,083625,Delgado; Tania,17,0,35,18
1657218067681,COGS 107A,A01,083627,Boyle; Mary E. T.,13,0,60,47
1657218073729,COGS 118A,A01,083075,Gupta; Anjum,16,0,76,60
1657218079768,CSE 3,A50,083646,Miranda; Gregory Joseph,24,0,50,26
1657218085790,CSE 8A,A50,083650,Miranda; Gregory Joseph,17,1,56,39
1657218091813,CSE 11,A01,083080,Cao; Yingjun,5,15,40,35
1657218097837,CSE 12,A01,083652,Krause-Levy; Sophia Louisa,24,1,120,96
1657218103871,CSE 15L,A01,083654,Morris; Justin Loren,9,0,50,41
1657218103871,CSE 15L,A02,083655,Morris; Justin Loren,9,0,50,41
1657218109904,CSE 20,A01,083657,Tran; Khoa Dang,38,0,80,42
1657218115926,CSE 21,A01,095574,Bach; Quang Tran,22,0,48,26
1657218121953,CSE 30,A01,083084,Eldon; John,4,0,80,76
1657218121953,CSE 30,B01,095061,Bhaskar; Nishant,8,0,50,42
1657218127984,CSE 100,A01,083659,Cao; Yingjun,4,4,70,66
1657218134020,CSE 134B,A01,083661,Powell; Thomas Allan,20,0,100,80
1657218140050,CSE 140,A01,083663,Gungor; Onat,13,0,85,72
1657218146074,CSE 140L,A01,083088,Eldon; John,17,0,100,83
1657218152096,CSE 175,A01,083665,Kumar; Rakesh,3,0,25,22
1657218158117,CSE 190,A00,092507,Dubnov; Shlomo,7,0,20,13
1657218164143,ECE 45,A01,083139,Congero; Spencer William,5,0,75,70
1657218170179,ECE 65,A50,083695,Saad; Andrew S,12,0,30,18
1657218170179,ECE 65,A51,095125,Saad; Andrew S,25,0,26,1
1657218176202,ECE 109,A01,091882,Touri; Behrouz,19,0,70,51
1657218182228,ECE 180,A00,083140,Abi Samra; Nicholas Camill,1,0,30,29
1657218182228,ECE 180,B00,083141,Abi Samra; Nicholas Camill,0,0,30,30
1657218188260,MATH 10A,A01,083735,Patchell; Gregory David,2,0,30,28
1657218188260,MATH 10A,A02,083736,Patchell; Gregory David,20,0,30,10
1657218188260,MATH 10A,A03,083737,Patchell; Gregory David,16,0,30,14
1657218194300,MATH 10B,A01,083207,Lim; Seonhee,7,0,34,27
1657218194300,MATH 10B,A02,083208,Lim; Seonhee,9,0,35,26
1657218194300,MATH 10B,A03,093472,Lim; Seonhee,5,0,34,29
1657218194300,MATH 10B,B01,083739,Sinha; Shubham,10,0,30,20
1657218200339,MATH 18,A01,083743,Cinel; Cameron Alexander,6,0,30,24
1657218200339,MATH 18,A02,083744,Cinel; Cameron Alexander,16,0,30,14
1657218200339,MATH 18,A03,083745,Cinel; Cameron Alexander,8,0,30,22
1657218200339,MATH 18,B01,083748,Rideout; David Porter,4,0,37,33
1657218200339,MATH 18,B02,083749,Rideout; David Porter,4,0,36,32
1657218200339,MATH 18,B03,083750,Rideout; David Porter,2,0,37,35
1657218200339,MATH 18,B04,083751,Rideout; David Porter,5,0,36,31
1657218200339,MATH 18,B05,093473,Rideout; David Porter,5,0,36,31
1657218200339,MATH 18,B06,093474,Rideout; David Porter,5,0,36,31
1657218206374,MATH 20A,A01,083754,Zheng; Zequn,14,0,40,26
1657218212406,MATH 20B,A01,083756,Briones; Jor-el Thomas Caparas,2,0,36,34
1657218212406,MATH 20B,A02,083757,Briones; Jor-el Thomas Caparas,1,0,36,35
1657218212406,MATH 20B,A03,093475,Briones; Jor-el Thomas Caparas,1,0,36,35
1657218218470,MATH 20C,A01,083760,Briones; Jor-el Thomas Caparas,1,0,35,34
1657218218470,MATH 20C,A02,083761,Briones; Jor-el Thomas Caparas,8,0,35,27
1657218218470,MATH 20C,A03,093476,Briones; Jor-el Thomas Caparas,0,1,36,36
1657218218470,MATH 20C,B01,083762,Bach; Quang Tran,1,0,30,29
1657218224494,MATH 20D,A01,083765,Tran; Brian Kha,4,0,30,26
1657218224494,MATH 20D,A02,083766,Tran; Brian Kha,5,0,30,25
1657218224494,MATH 20D,A03,083767,Tran; Brian Kha,4,0,30,26
1657218230517,MATH 20E,A01,083771,Ganguly; Soumya,7,0,32,25
1657218230517,MATH 20E,A02,083772,Ganguly; Soumya,7,0,32,25
1657218230517,MATH 20E,B01,083773,Ciotti; Benjamin,19,0,35,16
1657218230517,MATH 20E,B02,083774,Ciotti; Benjamin,17,0,35,18
1657218236548,MATH 103A,A01,083777,Greenfeld; Be'Eri,2,0,36,34
1657218236548,MATH 103A,A02,083778,Greenfeld; Be'Eri,5,0,36,31
1657218236548,MATH 103A,A03,093561,Greenfeld; Be'Eri,4,0,36,32
1657218236548,MATH 103A,B01,083779,Greenfeld; Be'Eri,6,0,36,30
1657218236548,MATH 103A,B02,083780,Greenfeld; Be'Eri,3,0,36,33
1657218236548,MATH 103A,B03,093562,Greenfeld; Be'Eri,3,0,36,33
1657218242591,MATH 105,A01,085443,Carter; Anne Toulson,15,0,35,20
1657218242591,MATH 105,A02,093477,Carter; Anne Toulson,20,0,35,15
1657218248614,MATH 109,A01,083213,Ganzberger; Geoffrey Michael,2,0,34,32
1657218248614,MATH 109,A02,083214,Ganzberger; Geoffrey Michael,4,0,34,30
1657218248614,MATH 109,A03,093478,Ganzberger; Geoffrey Michael,2,0,34,32
1657218248614,MATH 109,B01,083215,Ganzberger; Geoffrey Michael,1,0,32,31
1657218248614,MATH 109,B02,083216,Ganzberger; Geoffrey Michael,1,0,32,31
1657218248614,MATH 109,B03,093479,Ganzberger; Geoffrey Michael,7,0,32,25
1657218254647,MATH 142A,A01,083219,Chow; Bennett,6,0,32,26
1657218254647,MATH 142A,A02,083220,Chow; Bennett,10,0,32,22
1657218254647,MATH 142A,A03,093480,Chow; Bennett,7,0,32,25
1657218254647,MATH 142A,B03,093481,Chow; Bennett,8,0,32,24
1657218254647,MATH 142A,B04,093558,Chow; Bennett,11,0,32,21
1657218254647,MATH 142A,B05,093559,Chow; Bennett,6,0,32,26
1657218260670,MATH 193A,A01,083224,Rotar; Vladimir,7,0,34,27
1657218260670,MATH 193A,A02,083225,Rotar; Vladimir,5,0,34,29
1657218260670,MATH 193A,A03,083781,Rotar; Vladimir,1,0,34,33
1657218260670,MATH 193A,A04,083782,Rotar; Vladimir,8,0,34,26
1657218260670,MATH 193A,A05,093482,Rotar; Vladimir,6,0,34,28
1657218266694,MATH 197,001,091859,McAuley; Julian John,9999,0,9999,0
1657218266694,MATH 197,002,095566,Kedlaya; Kiran S.,9997,0,9999,2
1657218266694,MATH 197,003,095567,Xiao; Ming,9999,0,9999,0
1657218266694,MATH 197,004,095571,Perols; Johan Lars,9998,0,9999,1
1657218273783,COGS 9,A01,083615,Shannon; Kyle Michael,8,0,75,67
1657218279813,COGS 11,A01,083617,Boyle; Mary E. T.,22,0,48,26
1657218285838,COGS 13,A01,083071,Bastos; Amalia Pinkusfeld,9,0,71,62
1657218291863,COGS 14A,A01,092681,Semenuks; Arturs,1,1,100,99
1657218297889,COGS 14B,A01,083073,Cheng; Tzu-Han,6,0,63,57
1657218303912,COGS 17,A01,092677,Semenuks; Arturs,4,0,81,77
1657218309939,COGS 100,A01,083619,Allen; Michael Gordon,15,0,70,55
1657218315961,COGS 101A,A01,083621,Davis; Joshua Daniel,9,0,68,59
1657218321982,COGS 101B,A01,091572,Allen; Michael Gordon,9,0,65,56
1657218328009,COGS 101C,A01,083625,Delgado; Tania,17,0,35,18
1657218334059,COGS 107A,A01,083627,Boyle; Mary E. T.,13,0,60,47
1657218340086,COGS 118A,A01,083075,Gupta; Anjum,16,0,76,60
1657218346115,CSE 3,A50,083646,Miranda; Gregory Joseph,24,0,50,26
1657218352139,CSE 8A,A50,083650,Miranda; Gregory Joseph,17,1,56,39
1657218358172,CSE 11,A01,083080,Cao; Yingjun,5,15,40,35
1657218364215,CSE 12,A01,083652,Krause-Levy; Sophia Louisa,24,1,120,96
1657218370238,CSE 15L,A01,083654,Morris; Justin Loren,9,0,50,41
1657218370238,CSE 15L,A02,083655,Morris; Justin Loren,9,0,50,41
1657218376274,CSE 20,A01,083657,Tran; Khoa Dang,38,0,80,42
1657218382295,CSE 21,A01,095574,Bach; Quang Tran,22,0,48,26
1657218388320,CSE 30,A01,083084,Eldon; John,4,0,80,76
1657218388320,CSE 30,B01,095061,Bhaskar; Nishant,8,0,50,42
1657218394341,CSE 100,A01,083659,Cao; Yingjun,4,4,70,66
1657218400364,CSE 134B,A01,083661,Powell; Thomas Allan,20,0,100,80
1657218406387,CSE 140,A01,083663,Gungor; Onat,13,0,85,72
1657218412421,CSE 140L,A01,083088,Eldon; John,17,0,100,83
1657218418486,CSE 175,A01,083665,Kumar; Rakesh,3,0,25,22
1657218424518,CSE 190,A00,092507,Dubnov; Shlomo,7,0,20,13
1657218430541,ECE 45,A01,083139,Congero; Spencer William,5,0,75,70
1657218436572,ECE 65,A50,083695,Saad; Andrew S,12,0,30,18
1657218436572,ECE 65,A51,095125,Saad; Andrew S,25,0,26,1
1657218442599,ECE 109,A01,091882,Touri; Behrouz,19,0,70,51
1657218448636,ECE 180,A00,083140,Abi Samra; Nicholas Camill,1,0,30,29
1657218448636,ECE 180,B00,083141,Abi Samra; Nicholas Camill,0,0,30,30
1657218454663,MATH 10A,A01,083735,Patchell; Gregory David,2,0,30,28
1657218454663,MATH 10A,A02,083736,Patchell; Gregory David,20,0,30,10
1657218454663,MATH 10A,A03,083737,Patchell; Gregory David,16,0,30,14
1657218460688,MATH 10B,A01,083207,Lim; Seonhee,7,0,34,27
1657218460688,MATH 10B,A02,083208,Lim; Seonhee,9,0,35,26
1657218460688,MATH 10B,A03,093472,Lim; Seonhee,5,0,34,29
1657218460688,MATH 10B,B01,083739,Sinha; Shubham,10,0,30,20
1657218466721,MATH 18,A01,083743,Cinel; Cameron Alexander,6,0,30,24
1657218466721,MATH 18,A02,083744,Cinel; Cameron Alexander,16,0,30,14
1657218466721,MATH 18,A03,083745,Cinel; Cameron Alexander,8,0,30,22
1657218466721,MATH 18,B01,083748,Rideout; David Porter,4,0,37,33
1657218466721,MATH 18,B02,083749,Rideout; David Porter,4,0,36,32
1657218466721,MATH 18,B03,083750,Rideout; David Porter,2,0,37,35
1657218466721,MATH 18,B04,083751,Rideout; David Porter,5,0,36,31
1657218466721,MATH 18,B05,093473,Rideout; David Porter,5,0,36,31
1657218466721,MATH 18,B06,093474,Rideout; David Porter,5,0,36,31
1657218472761,MATH 20A,A01,083754,Zheng; Zequn,14,0,40,26
1657218478788,MATH 20B,A01,083756,Briones; Jor-el Thomas Caparas,2,0,36,34
1657218478788,MATH 20B,A02,083757,Briones; Jor-el Thomas Caparas,1,0,36,35
1657218478788,MATH 20B,A03,093475,Briones; Jor-el Thomas Caparas,1,0,36,35
1657218484816,MATH 20C,A01,083760,Briones; Jor-el Thomas Caparas,1,0,35,34
1657218484816,MATH 20C,A02,083761,Briones; Jor-el Thomas Caparas,8,0,35,27
1657218484816,MATH 20C,A03,093476,Briones; Jor-el Thomas Caparas,0,1,36,36
1657218484816,MATH 20C,B01,083762,Bach; Quang Tran,1,0,30,29
1657218490841,MATH 20D,A01,083765,Tran; Brian Kha,4,0,30,26
1657218490841,MATH 20D,A02,083766,Tran; Brian Kha,5,0,30,25
1657218490841,MATH 20D,A03,083767,Tran; Brian Kha,4,0,30,26
1657218496869,MATH 20E,A01,083771,Ganguly; Soumya,7,0,32,25
1657218496869,MATH 20E,A02,083772,Ganguly; Soumya,7,0,32,25
1657218496869,MATH 20E,B01,083773,Ciotti; Benjamin,19,0,35,16
1657218496869,MATH 20E,B02,083774,Ciotti; Benjamin,17,0,35,18
1657218502901,MATH 103A,A01,083777,Greenfeld; Be'Eri,2,0,36,34
1657218502901,MATH 103A,A02,083778,Greenfeld; Be'Eri,5,0,36,31
1657218502901,MATH 103A,A03,093561,Greenfeld; Be'Eri,4,0,36,32
1657218502901,MATH 103A,B01,083779,Greenfeld; Be'Eri,6,0,36,30
1657218502901,MATH 103A,B02,083780,Greenfeld; Be'Eri,3,0,36,33
1657218502901,MATH 103A,B03,093562,Greenfeld; Be'Eri,3,0,36,33
1657218508928,MATH 105,A01,085443,Carter; Anne Toulson,15,0,35,20
1657218508928,MATH 105,A02,093477,Carter; Anne Toulson,20,0,35,15
1657218514964,MATH 109,A01,083213,Ganzberger; Geoffrey Michael,2,0,34,32
1657218514964,MATH 109,A02,083214,Ganzberger; Geoffrey Michael,4,0,34,30
1657218514964,MATH 109,A03,093478,Ganzberger; Geoffrey Michael,2,0,34,32
1657218514964,MATH 109,B01,083215,Ganzberger; Geoffrey Michael,1,0,32,31
1657218514964,MATH 109,B02,083216,Ganzberger; Geoffrey Michael,1,0,32,31
1657218514964,MATH 109,B03,093479,Ganzberger; Geoffrey Michael,7,0,32,25
1657218520989,MATH 142A,A01,083219,Chow; Bennett,6,0,32,26
1657218520989,MATH 142A,A02,083220,Chow; Bennett,10,0,32,22
1657218520989,MATH 142A,A03,093480,Chow; Bennett,7,0,32,25
1657218520989,MATH 142A,B03,093481,Chow; Bennett,8,0,32,24
1657218520989,MATH 142A,B04,093558,Chow; Bennett,11,0,32,21
1657218520989,MATH 142A,B05,093559,Chow; Bennett,6,0,32,26
1657218527016,MATH 193A,A01,083224,Rotar; Vladimir,7,0,34,27
1657218527016,MATH 193A,A02,083225,Rotar; Vladimir,6,0,34,28
1657218527016,MATH 193A,A03,083781,Rotar; Vladimir,1,0,34,33
1657218527016,MATH 193A,A04,083782,Rotar; Vladimir,8,0,34,26
1657218527016,MATH 193A,A05,093482,Rotar; Vladimir,6,0,34,28
1657218533046,MATH 197,001,091859,McAuley; Julian John,9999,0,9999,0
1657218533046,MATH 197,002,095566,Kedlaya; Kiran S.,9997,0,9999,2
1657218533046,MATH 197,003,095567,Xiao; Ming,9999,0,9999,0
1657218533046,MATH 197,004,095571,Perols; Johan Lars,9998,0,9999,1
1657218540128,COGS 9,A01,083615,Shannon; Kyle Michael,8,0,75,67
1657218546155,COGS 11,A01,083617,Boyle; Mary E. T.,22,0,48,26
1657218552181,COGS 13,A01,083071,Bastos; Amalia Pinkusfeld,9,0,71,62
1657218558219,COGS 14A,A01,092681,Semenuks; Arturs,1,1,100,99
1657218564268,COGS 14B,A01,083073,Cheng; Tzu-Han,6,0,63,57
1657218570291,COGS 17,A01,092677,Semenuks; Arturs,4,0,81,77
1657218576324,COGS 100,A01,083619,Allen; Michael Gordon,15,0,70,55
1657218582356,COGS 101A,A01,083621,Davis; Joshua Daniel,9,0,68,59
1657218588394,COGS 101B,A01,091572,Allen; Michael Gordon,9,0,65,56
1657218594419,COGS 101C,A01,083625,Delgado; Tania,17,0,35,18
1657218600451,COGS 107A,A01,083627,Boyle; Mary E. T.,13,0,60,47
1657218606474,COGS 118A,A01,083075,Gupta; Anjum,16,0,76,60
1657218612503,CSE 3,A50,083646,Miranda; Gregory Joseph,24,0,50,26
1657218618527,CSE 8A,A50,083650,Miranda; Gregory Joseph,17,1,56,39
1657218624562,CSE 11,A01,083080,Cao; Yingjun,5,15,40,35
1657218630584,CSE 12,A01,083652,Krause-Levy; Sophia Louisa,24,1,120,96
1657218636621,CSE 15L,A01,083654,Morris; Justin Loren,9,0,50,41
1657218636621,CSE 15L,A02,083655,Morris; Justin Loren,9,0,50,41
1657218642663,CSE 20,A01,083657,Tran; Khoa Dang,38,0,80,42
1657218648695,CSE 21,A01,095574,Bach; Quang Tran,22,0,48,26
1657218654824,CSE 30,A01,083084,Eldon; John,4,0,80,76
1657218654824,CSE 30,B01,095061,Bhaskar; Nishant,8,0,50,42
1657218660849,CSE 100,A01,083659,Cao; Yingjun,4,4,70,66
1657218666882,CSE 134B,A01,083661,Powell; Thomas Allan,20,0,100,80
1657218672909,CSE 140,A01,083663,Gungor; Onat,13,0,85,72
1657218678939,CSE 140L,A01,083088,Eldon; John,17,0,100,83
1657218684968,CSE 175,A01,083665,Kumar; Rakesh,3,0,25,22
1657218690996,CSE 190,A00,092507,Dubnov; Shlomo,7,0,20,13
1657218697020,ECE 45,A01,083139,Congero; Spencer William,5,0,75,70
1657218703048,ECE 65,A50,083695,Saad; Andrew S,12,0,30,18
1657218703048,ECE 65,A51,095125,Saad; Andrew S,25,0,26,1
1657218709089,ECE 109,A01,091882,Touri; Behrouz,19,0,70,51
1657218715113,ECE 180,A00,083140,Abi Samra; Nicholas Camill,1,0,30,29
1657218715113,ECE 180,B00,083141,Abi Samra; Nicholas Camill,0,0,30,30
1657218721136,MATH 10A,A01,083735,Patchell; Gregory David,2,0,30,28
1657218721136,MATH 10A,A02,083736,Patchell; Gregory David,20,0,30,10
1657218721136,MATH 10A,A03,083737,Patchell; Gregory David,16,0,30,14
1657218727160,MATH 10B,A01,083207,Lim; Seonhee,7,0,34,27
1657218727160,MATH 10B,A02,083208,Lim; Seonhee,9,0,35,26
1657218727160,MATH 10B,A03,093472,Lim; Seonhee,5,0,34,29
1657218727160,MATH 10B,B01,083739,Sinha; Shubham,10,0,30,20
1657218733188,MATH 18,A01,083743,Cinel; Cameron Alexander,6,0,30,24
1657218733188,MATH 18,A02,083744,Cinel; Cameron Alexander,16,0,30,14
1657218733188,MATH 18,A03,083745,Cinel; Cameron Alexander,8,0,30,22
1657218733188,MATH 18,B01,083748,Rideout; David Porter,4,0,37,33
1657218733188,MATH 18,B02,083749,Rideout; David Porter,4,0,36,32
1657218733188,MATH 18,B03,083750,Rideout; David Porter,2,0,37,35
1657218733188,MATH 18,B04,083751,Rideout; David Porter,5,0,36,31
1657218733188,MATH 18,B05,093473,Rideout; David Porter,5,0,36,31
1657218733188,MATH 18,B06,093474,Rideout; David Porter,5,0,36,31
1657218739214,MATH 20A,A01,083754,Zheng; Zequn,14,0,40,26
1657218745242,MATH 20B,A01,083756,Briones; Jor-el Thomas Caparas,2,0,36,34
1657218745242,MATH 20B,A02,083757,Briones; Jor-el Thomas Caparas,1,0,36,35
1657218745242,MATH 20B,A03,093475,Briones; Jor-el Thomas Caparas,1,0,36,35
1657218751286,MATH 20C,A01,083760,Briones; Jor-el Thomas Caparas,1,0,35,34
1657218751286,MATH 20C,A02,083761,Briones; Jor-el Thomas Caparas,8,0,35,27
1657218751286,MATH 20C,A03,093476,Briones; Jor-el Thomas Caparas,0,1,36,36
1657218751286,MATH 20C,B01,083762,Bach; Quang Tran,1,0,30,29
1657218757319,MATH 20D,A01,083765,Tran; Brian Kha,4,0,30,26
1657218757319,MATH 20D,A02,083766,Tran; Brian Kha,5,0,30,25
1657218757319,MATH 20D,A03,083767,Tran; Brian Kha,4,0,30,26
1657218763341,MATH 20E,A01,083771,Ganguly; Soumya,7,0,32,25
1657218763341,MATH 20E,A02,083772,Ganguly; Soumya,7,0,32,25
1657218763341,MATH 20E,B01,083773,Ciotti; Benjamin,19,0,35,16
1657218763341,MATH 20E,B02,083774,Ciotti; Benjamin,17,0,35,18
1657218769371,MATH 103A,A01,083777,Greenfeld; Be'Eri,2,0,36,34
1657218769371,MATH 103A,A02,083778,Greenfeld; Be'Eri,5,0,36,31
1657218769371,MATH 103A,A03,093561,Greenfeld; Be'Eri,4,0,36,32
1657218769371,MATH 103A,B01,083779,Greenfeld; Be'Eri,6,0,36,30
1657218769371,MATH 103A,B02,083780,Greenfeld; Be'Eri,3,0,36,33
1657218769371,MATH 103A,B03,093562,Greenfeld; Be'Eri,3,0,36,33
1657218775393,MATH 105,A01,085443,Carter; Anne Toulson,15,0,35,20
1657218775393,MATH 105,A02,093477,Carter; Anne Toulson,20,0,35,15
1657218781417,MATH 109,A01,083213,Ganzberger; Geoffrey Michael,2,0,34,32
1657218781417,MATH 109,A02,083214,Ganzberger; Geoffrey Michael,4,0,34,30
1657218781417,MATH 109,A03,093478,Ganzberger; Geoffrey Michael,2,0,34,32
1657218781417,MATH 109,B01,083215,Ganzberger; Geoffrey Michael,1,0,32,31
1657218781417,MATH 109,B02,083216,Ganzberger; Geoffrey Michael,1,0,32,31
1657218781417,MATH 109,B03,093479,Ganzberger; Geoffrey Michael,7,0,32,25
1657218787442,MATH 142A,A01,083219,Chow; Bennett,6,0,32,26
1657218787442,MATH 142A,A02,083220,Chow; Bennett,10,0,32,22
1657218787442,MATH 142A,A03,093480,Chow; Bennett,7,0,32,25
1657218787442,MATH 142A,B03,093481,Chow; Bennett,8,0,32,24
1657218787442,MATH 142A,B04,093558,Chow; Bennett,11,0,32,21
1657218787442,MATH 142A,B05,093559,Chow; Bennett,6,0,32,26
1657218793477,MATH 193A,A01,083224,Rotar; Vladimir,7,0,34,27
1657218793477,MATH 193A,A02,083225,Rotar; Vladimir,6,0,34,28
1657218793477,MATH 193A,A03,083781,Rotar; Vladimir,1,0,34,33
1657218793477,MATH 193A,A04,083782,Rotar; Vladimir,8,0,34,26
1657218793477,MATH 193A,A05,093482,Rotar; Vladimir,6,0,34,28
1657218799502,MATH 197,001,091859,McAuley; Julian John,9999,0,9999,0
1657218799502,MATH 197,002,095566,Kedlaya; Kiran S.,9997,0,9999,2
1657218799502,MATH 197,003,095567,Xiao; Ming,9999,0,9999,0
1657218799502,MATH 197,004,095571,Perols; Johan Lars,9998,0,9999,1
1657218806571,COGS 9,A01,083615,Shannon; Kyle Michael,8,0,75,67
1657218812609,COGS 11,A01,083617,Boyle; Mary E. T.,22,0,48,26
1657218818651,COGS 13,A01,083071,Bastos; Amalia Pinkusfeld,9,0,71,62
1657218824678,COGS 14A,A01,092681,Semenuks; Arturs,1,1,100,99
1657218830716,COGS 14B,A01,083073,Cheng; Tzu-Han,6,0,63,57
1657218836766,COGS 17,A01,092677,Semenuks; Arturs,4,0,81,77
1657218842794,COGS 100,A01,083619,Allen; Michael Gordon,15,0,70,55
1657218848820,COGS 101A,A01,083621,Davis; Joshua Daniel,9,0,68,59
1657218854845,COGS 101B,A01,091572,Allen; Michael Gordon,9,0,65,56
1657218860871,COGS 101C,A01,083625,Delgado; Tania,17,0,35,18
1657218866893,COGS 107A,A01,083627,Boyle; Mary E. T.,13,0,60,47
1657218872917,COGS 118A,A01,083075,Gupta; Anjum,16,0,76,60
1657218878941,CSE 3,A50,083646,Miranda; Gregory Joseph,24,0,50,26
1657218884964,CSE 8A,A50,083650,Miranda; Gregory Joseph,17,1,56,39
1657218890997,CSE 11,A01,083080,Cao; Yingjun,5,15,40,35
1657218897023,CSE 12,A01,083652,Krause-Levy; Sophia Louisa,24,1,120,96
1657218903049,CSE 15L,A01,083654,Morris; Justin Loren,9,0,50,41
1657218903049,CSE 15L,A02,083655,Morris; Justin Loren,9,0,50,41
1657218909073,CSE 20,A01,083657,Tran; Khoa Dang,38,0,80,42
1657218915097,CSE 21,A01,095574,Bach; Quang Tran,22,0,48,26
1657218921120,CSE 30,A01,083084,Eldon; John,4,0,80,76
1657218921120,CSE 30,B01,095061,Bhaskar; Nishant,8,0,50,42
1657218927147,CSE 100,A01,083659,Cao; Yingjun,4,4,70,66
1657218933181,CSE 134B,A01,083661,Powell; Thomas Allan,20,0,100,80
1657218939206,CSE 140,A01,083663,Gungor; Onat,13,0,85,72
1657218945242,CSE 140L,A01,083088,Eldon; John,17,0,100,83
1657218951269,CSE 175,A01,083665,Kumar; Rakesh,3,0,25,22
1657218957311,CSE 190,A00,092507,Dubnov; Shlomo,7,0,20,13
1657218963342,ECE 45,A01,083139,Congero; Spencer William,5,0,75,70
1657218969369,ECE 65,A50,083695,Saad; Andrew S,12,0,30,18
1657218969369,ECE 65,A51,095125,Saad; Andrew S,25,0,26,1
1657218975400,ECE 109,A01,091882,Touri; Behrouz,19,0,70,51
1657218981426,ECE 180,A00,083140,Abi Samra; Nicholas Camill,1,0,30,29
1657218981426,ECE 180,B00,083141,Abi Samra; Nicholas Camill,0,0,30,30
1657218987455,MATH 10A,A01,083735,Patchell; Gregory David,2,0,30,28
1657218987455,MATH 10A,A02,083736,Patchell; Gregory David,20,0,30,10
1657218987455,MATH 10A,A03,083737,Patchell; Gregory David,16,0,30,14
1657218993491,MATH 10B,A01,083207,Lim; Seonhee,7,0,34,27
1657218993491,MATH 10B,A02,083208,Lim; Seonhee,9,0,35,26
1657218993491,MATH 10B,A03,093472,Lim; Seonhee,5,0,34,29
1657218993491,MATH 10B,B01,083739,Sinha; Shubham,10,0,30,20
1657218999525,MATH 18,A01,083743,Cinel; Cameron Alexander,6,0,30,24
1657218999525,MATH 18,A02,083744,Cinel; Cameron Alexander,16,0,30,14
1657218999525,MATH 18,A03,083745,Cinel; Cameron Alexander,8,0,30,22
1657218999525,MATH 18,B01,083748,Rideout; David Porter,4,0,37,33
1657218999525,MATH 18,B02,083749,Rideout; David Porter,4,0,36,32
1657218999525,MATH 18,B03,083750,Rideout; David Porter,2,0,37,35
1657218999525,MATH 18,B04,083751,Rideout; David Porter,5,0,36,31
1657218999525,MATH 18,B05,093473,Rideout; David Porter,5,0,36,31
1657218999525,MATH 18,B06,093474,Rideout; David Porter,5,0,36,31
1657219005553,MATH 20A,A01,083754,Zheng; Zequn,14,0,40,26
1657219011582,MATH 20B,A01,083756,Briones; Jor-el Thomas Caparas,2,0,36,34
1657219011582,MATH 20B,A02,083757,Briones; Jor-el Thomas Caparas,1,0,36,35
1657219011582,MATH 20B,A03,093475,Briones; Jor-el Thomas Caparas,1,0,36,35
1657219017617,MATH 20C,A01,083760,Briones; Jor-el Thomas Caparas,1,0,35,34
1657219017617,MATH 20C,A02,083761,Briones; Jor-el Thomas Caparas,8,0,35,27
1657219017617,MATH 20C,A03,093476,Briones; Jor-el Thomas Caparas,0,1,36,36
1657219017617,MATH 20C,B01,083762,Bach; Quang Tran,1,0,30,29
1657219023645,MATH 20D,A01,083765,Tran; Brian Kha,4,0,30,26
1657219023645,MATH 20D,A02,083766,Tran; Brian Kha,5,0,30,25
1657219023645,MATH 20D,A03,083767,Tran; Brian Kha,4,0,30,26
1657219029673,MATH 20E,A01,083771,Ganguly; Soumya,7,0,32,25
1657219029673,MATH 20E,A02,083772,Ganguly; Soumya,7,0,32,25
1657219029673,MATH 20E,B01,083773,Ciotti; Benjamin,19,0,35,16
1657219029673,MATH 20E,B02,083774,Ciotti; Benjamin,17,0,35,18
1657219035701,MATH 103A,A01,083777,Greenfeld; Be'Eri,2,0,36,34
1657219035701,MATH 103A,A02,083778,Greenfeld; Be'Eri,5,0,36,31
1657219035701,MATH 103A,A03,093561,Greenfeld; Be'Eri,4,0,36,32
1657219035701,MATH 103A,B01,083779,Greenfeld; Be'Eri,6,0,36,30
1657219035701,MATH 103A,B02,083780,Greenfeld; Be'Eri,3,0,36,33
1657219035701,MATH 103A,B03,093562,Greenfeld; Be'Eri,3,0,36,33
1657219041735,MATH 105,A01,085443,Carter; Anne Toulson,15,0,35,20
1657219041735,MATH 105,A02,093477,Carter; Anne Toulson,20,0,35,15
1657219047770,MATH 109,A01,083213,Ganzberger; Geoffrey Michael,2,0,34,32
1657219047770,MATH 109,A02,083214,Ganzberger; Geoffrey Michael,4,0,34,30
1657219047770,MATH 109,A03,093478,Ganzberger; Geoffrey Michael,2,0,34,32
1657219047770,MATH 109,B01,083215,Ganzberger; Geoffrey Michael,1,0,32,31
1657219047770,MATH 109,B02,083216,Ganzberger; Geoffrey Michael,1,0,32,31
1657219047770,MATH 109,B03,093479,Ganzberger; Geoffrey Michael,7,0,32,25
1657219053797,MATH 142A,A01,083219,Chow; Bennett,6,0,32,26
1657219053797,MATH 142A,A02,083220,Chow; Bennett,10,0,32,22
1657219053797,MATH 142A,A03,093480,Chow; Bennett,7,0,32,25
1657219053797,MATH 142A,B03,093481,Chow; Bennett,8,0,32,24
1657219053797,MATH 142A,B04,093558,Chow; Bennett,11,0,32,21
1657219053797,MATH 142A,B05,093559,Chow; Bennett,6,0,32,26
1657219059820,MATH 193A,A01,083224,Rotar; Vladimir,7,0,34,27
1657219059820,MATH 193A,A02,083225,Rotar; Vladimir,6,0,34,28
1657219059820,MATH 193A,A03,083781,Rotar; Vladimir,1,0,34,33
1657219059820,MATH 193A,A04,083782,Rotar; Vladimir,8,0,34,26
1657219059820,MATH 193A,A05,093482,Rotar; Vladimir,6,0,34,28
1657219065845,MATH 197,001,091859,McAuley; Julian John,9999,0,9999,0
1657219065845,MATH 197,002,095566,Kedlaya; Kiran S.,9997,0,9999,2
1657219065845,MATH 197,003,095567,Xiao; Ming,9999,0,9999,0
1657219065845,MATH 197,004,095571,Perols; Johan Lars,9998,0,9999,1
1657219072923,COGS 9,A01,083615,Shannon; Kyle Michael,8,0,75,67
1657219078947,COGS 11,A01,083617,Boyle; Mary E. T.,22,0,48,26
1657219084969,COGS 13,A01,083071,Bastos; Amalia Pinkusfeld,9,0,71,62
1657219090992,COGS 14A,A01,092681,Semenuks; Arturs,1,1,100,99
1657219097014,COGS 14B,A01,083073,Cheng; Tzu-Han,6,0,63,57
1657219103038,COGS 17,A01,092677,Semenuks; Arturs,4,0,81,77
1657219109068,COGS 100,A01,083619,Allen; Michael Gordon,15,0,70,55
1657219115104,COGS 101A,A01,083621,Davis; Joshua Daniel,9,0,68,59
1657219121128,COGS 101B,A01,091572,Allen; Michael Gordon,9,0,65,56
1657219127152,COGS 101C,A01,083625,Delgado; Tania,17,0,35,18
1657219133190,COGS 107A,A01,083627,Boyle; Mary E. T.,13,0,60,47
1657219139214,COGS 118A,A01,083075,Gupta; Anjum,16,0,76,60
1657219145244,CSE 3,A50,083646,Miranda; Gregory Joseph,24,0,50,26
1657219151268,CSE 8A,A50,083650,Miranda; Gregory Joseph,17,1,56,39
1657219157308,CSE 11,A01,083080,Cao; Yingjun,5,15,40,35
1657219163330,CSE 12,A01,083652,Krause-Levy; Sophia Louisa,24,1,120,96
1657219169364,CSE 15L,A01,083654,Morris; Justin Loren,9,0,50,41
1657219169364,CSE 15L,A02,083655,Morris; Justin Loren,9,0,50,41
1657219175390,CSE 20,A01,083657,Tran; Khoa Dang,38,0,80,42
1657219181426,CSE 21,A01,095574,Bach; Quang Tran,22,0,48,26
1657219187454,CSE 30,A01,083084,Eldon; John,4,0,80,76
1657219187454,CSE 30,B01,095061,Bhaskar; Nishant,8,0,50,42
1657219193484,CSE 100,A01,083659,Cao; Yingjun,4,4,70,66
1657219199529,CSE 134B,A01,083661,Powell; Thomas Allan,20,0,100,80
1657219205566,CSE 140,A01,083663,Gungor; Onat,13,0,85,72
1657219211595,CSE 140L,A01,083088,Eldon; John,17,0,100,83
1657219217620,CSE 175,A01,083665,Kumar; Rakesh,3,0,25,22
1657219223644,CSE 190,A00,092507,Dubnov; Shlomo,7,0,20,13
1657219229673,ECE 45,A01,083139,Congero; Spencer William,5,0,75,70
1657219235700,ECE 65,A50,083695,Saad; Andrew S,12,0,30,18
1657219235700,ECE 65,A51,095125,Saad; Andrew S,25,0,26,1
1657219241727,ECE 109,A01,091882,Touri; Behrouz,19,0,70,51
1657219247760,ECE 180,A00,083140,Abi Samra; Nicholas Camill,1,0,30,29
1657219247760,ECE 180,B00,083141,Abi Samra; Nicholas Camill,0,0,30,30
1657219253867,MATH 10A,A01,083735,Patchell; Gregory David,2,0,30,28
1657219253867,MATH 10A,A02,083736,Patchell; Gregory David,20,0,30,10
1657219253867,MATH 10A,A03,083737,Patchell; Gregory David,16,0,30,14
1657219259897,MATH 10B,A01,083207,Lim; Seonhee,7,0,34,27
1657219259897,MATH 10B,A02,083208,Lim; Seonhee,9,0,35,26
1657219259897,MATH 10B,A03,093472,Lim; Seonhee,5,0,34,29
1657219259897,MATH 10B,B01,083739,Sinha; Shubham,10,0,30,20
1657219265920,MATH 18,A01,083743,Cinel; Cameron Alexander,6,0,30,24
1657219265920,MATH 18,A02,083744,Cinel; Cameron Alexander,16,0,30,14
1657219265920,MATH 18,A03,083745,Cinel; Cameron Alexander,8,0,30,22
1657219265920,MATH 18,B01,083748,Rideout; David Porter,4,0,37,33
1657219265920,MATH 18,B02,083749,Rideout; David Porter,4,0,36,32
1657219265920,MATH 18,B03,083750,Rideout; David Porter,2,0,37,35
1657219265920,MATH 18,B04,083751,Rideout; David Porter,5,0,36,31
1657219265920,MATH 18,B05,093473,Rideout; David Porter,5,0,36,31
1657219265920,MATH 18,B06,093474,Rideout; David Porter,5,0,36,31
1657219271945,MATH 20A,A01,083754,Zheng; Zequn,14,0,40,26
1657219277968,MATH 20B,A01,083756,Briones; Jor-el Thomas Caparas,2,0,36,34
1657219277968,MATH 20B,A02,083757,Briones; Jor-el Thomas Caparas,1,0,36,35
1657219277968,MATH 20B,A03,093475,Briones; Jor-el Thomas Caparas,1,0,36,35
1657219283996,MATH 20C,A01,083760,Briones; Jor-el Thomas Caparas,1,0,35,34
1657219283996,MATH 20C,A02,083761,Briones; Jor-el Thomas Caparas,8,0,35,27
1657219283996,MATH 20C,A03,093476,Briones; Jor-el Thomas Caparas,0,1,36,36
1657219283996,MATH 20C,B01,083762,Bach; Quang Tran,1,0,30,29
1657219290024,MATH 20D,A01,083765,Tran; Brian Kha,4,0,30,26
1657219290024,MATH 20D,A02,083766,Tran; Brian Kha,5,0,30,25
1657219290024,MATH 20D,A03,083767,Tran; Brian Kha,4,0,30,26
1657219296060,MATH 20E,A01,083771,Ganguly; Soumya,7,0,32,25
1657219296060,MATH 20E,A02,083772,Ganguly; Soumya,7,0,32,25
1657219296060,MATH 20E,B01,083773,Ciotti; Benjamin,19,0,35,16
1657219296060,MATH 20E,B02,083774,Ciotti; Benjamin,17,0,35,18
1657219302112,MATH 103A,A01,083777,Greenfeld; Be'Eri,2,0,36,34
1657219302112,MATH 103A,A02,083778,Greenfeld; Be'Eri,5,0,36,31
1657219302112,MATH 103A,A03,093561,Greenfeld; Be'Eri,4,0,36,32
1657219302112,MATH 103A,B01,083779,Greenfeld; Be'Eri,6,0,36,30
1657219302112,MATH 103A,B02,083780,Greenfeld; Be'Eri,3,0,36,33
1657219302112,MATH 103A,B03,093562,Greenfeld; Be'Eri,3,0,36,33
1657219308144,MATH 105,A01,085443,Carter; Anne Toulson,15,0,35,20
1657219308144,MATH 105,A02,093477,Carter; Anne Toulson,20,0,35,15
1657219314167,MATH 109,A01,083213,Ganzberger; Geoffrey Michael,2,0,34,32
1657219314167,MATH 109,A02,083214,Ganzberger; Geoffrey Michael,4,0,34,30
1657219314167,MATH 109,A03,093478,Ganzberger; Geoffrey Michael,2,0,34,32
1657219314167,MATH 109,B01,083215,Ganzberger; Geoffrey Michael,1,0,32,31
1657219314167,MATH 109,B02,083216,Ganzberger; Geoffrey Michael,1,0,32,31
1657219314167,MATH 109,B03,093479,Ganzberger; Geoffrey Michael,7,0,32,25
1657219320190,MATH 142A,A01,083219,Chow; Bennett,6,0,32,26
1657219320190,MATH 142A,A02,083220,Chow; Bennett,10,0,32,22
1657219320190,MATH 142A,A03,093480,Chow; Bennett,7,0,32,25
1657219320190,MATH 142A,B03,093481,Chow; Bennett,8,0,32,24
1657219320190,MATH 142A,B04,093558,Chow; Bennett,11,0,32,21
1657219320190,MATH 142A,B05,093559,Chow; Bennett,6,0,32,26
1657219326223,MATH 193A,A01,083224,Rotar; Vladimir,7,0,34,27
1657219326223,MATH 193A,A02,083225,Rotar; Vladimir,6,0,34,28
1657219326223,MATH 193A,A03,083781,Rotar; Vladimir,1,0,34,33
1657219326223,MATH 193A,A04,083782,Rotar; Vladimir,8,0,34,26
1657219326223,MATH 193A,A05,093482,Rotar; Vladimir,6,0,34,28
1657219332257,MATH 197,001,091859,McAuley; Julian John,9999,0,9999,0
1657219332257,MATH 197,002,095566,Kedlaya; Kiran S.,9997,0,9999,2
1657219332257,MATH 197,003,095567,Xiao; Ming,9999,0,9999,0
1657219332257,MATH 197,004,095571,Perols; Johan Lars,9998,0,9999,1
1657219339321,COGS 9,A01,083615,Shannon; Kyle Michael,8,0,75,67
1657219345345,COGS 11,A01,083617,Boyle; Mary E. T.,22,0,48,26
1657219351371,COGS 13,A01,083071,Bastos; Amalia Pinkusfeld,9,0,71,62
1657219357398,COGS 14A,A01,092681,Semenuks; Arturs,1,1,100,99
1657219363427,COGS 14B,A01,083073,Cheng; Tzu-Han,6,0,63,57
1657219369454,COGS 17,A01,092677,Semenuks; Arturs,4,0,81,77
1657219375476,COGS 100,A01,083619,Allen; Michael Gordon,15,0,70,55
1657219381504,COGS 101A,A01,083621,Davis; Joshua Daniel,9,0,68,59
1657219387527,COGS 101B,A01,091572,Allen; Michael Gordon,9,0,65,56
1657219393550,COGS 101C,A01,083625,Delgado; Tania,17,0,35,18
1657219399575,COGS 107A,A01,083627,Boyle; Mary E. T.,13,0,60,47
1657219405607,COGS 118A,A01,083075,Gupta; Anjum,16,0,76,60
1657219411643,CSE 3,A50,083646,Miranda; Gregory Joseph,24,0,50,26
1657219417667,CSE 8A,A50,083650,Miranda; Gregory Joseph,17,1,56,39
1657219423690,CSE 11,A01,083080,Cao; Yingjun,5,15,40,35
1657219429714,CSE 12,A01,083652,Krause-Levy; Sophia Louisa,24,1,120,96
1657219435749,CSE 15L,A01,083654,Morris; Justin Loren,9,0,50,41
1657219435749,CSE 15L,A02,083655,Morris; Justin Loren,9,0,50,41
1657219441772,CSE 20,A01,083657,Tran; Khoa Dang,38,0,80,42
1657219447794,CSE 21,A01,095574,Bach; Quang Tran,22,0,48,26
1657219453827,CSE 30,A01,083084,Eldon; John,4,0,80,76
1657219453827,CSE 30,B01,095061,Bhaskar; Nishant,8,0,50,42
1657219459857,CSE 100,A01,083659,Cao; Yingjun,4,4,70,66
1657219465885,CSE 134B,A01,083661,Powell; Thomas Allan,20,0,100,80
1657219471908,CSE 140,A01,083663,Gungor; Onat,13,0,85,72
1657219477932,CSE 140L,A01,083088,Eldon; John,17,0,100,83
1657219483955,CSE 175,A01,083665,Kumar; Rakesh,3,0,25,22
1657219489980,CSE 190,A00,092507,Dubnov; Shlomo,7,0,20,13
1657219496004,ECE 45,A01,083139,Congero; Spencer William,5,0,75,70
1657219502038,ECE 65,A50,083695,Saad; Andrew S,12,0,30,18
1657219502038,ECE 65,A51,095125,Saad; Andrew S,25,0,26,1
1657219508069,ECE 109,A01,091882,Touri; Behrouz,19,0,70,51
1657219514092,ECE 180,A00,083140,Abi Samra; Nicholas Camill,1,0,30,29
1657219514092,ECE 180,B00,083141,Abi Samra; Nicholas Camill,0,0,30,30
1657219520126,MATH 10A,A01,083735,Patchell; Gregory David,2,0,30,28
1657219520126,MATH 10A,A02,083736,Patchell; Gregory David,20,0,30,10
1657219520126,MATH 10A,A03,083737,Patchell; Gregory David,16,0,30,14
1657219526149,MATH 10B,A01,083207,Lim; Seonhee,7,0,34,27
1657219526149,MATH 10B,A02,083208,Lim; Seonhee,9,0,35,26
1657219526149,MATH 10B,A03,093472,Lim; Seonhee,5,0,34,29
1657219526149,MATH 10B,B01,083739,Sinha; Shubham,10,0,30,20
1657219532174,MATH 18,A01,083743,Cinel; Cameron Alexander,6,0,30,24
1657219532174,MATH 18,A02,083744,Cinel; Cameron Alexander,16,0,30,14
1657219532174,MATH 18,A03,083745,Cinel; Cameron Alexander,8,0,30,22
1657219532174,MATH 18,B01,083748,Rideout; David Porter,4,0,37,33
1657219532174,MATH 18,B02,083749,Rideout; David Porter,4,0,36,32
1657219532174,MATH 18,B03,083750,Rideout; David Porter,2,0,37,35
1657219532174,MATH 18,B04,083751,Rideout; David Porter,5,0,36,31
1657219532174,MATH 18,B05,093473,Rideout; David Porter,5,0,36,31
1657219532174,MATH 18,B06,093474,Rideout; David Porter,5,0,36,31
1657219538206,MATH 20A,A01,083754,Zheng; Zequn,14,0,40,26
1657219544243,MATH 20B,A01,083756,Briones; Jor-el Thomas Caparas,2,0,36,34
1657219544243,MATH 20B,A02,083757,Briones; Jor-el Thomas Caparas,1,0,36,35
1657219544243,MATH 20B,A03,093475,Briones; Jor-el Thomas Caparas,1,0,36,35
1657219550267,MATH 20C,A01,083760,Briones; Jor-el Thomas Caparas,1,0,35,34
1657219550267,MATH 20C,A02,083761,Briones; Jor-el Thomas Caparas,8,0,35,27
1657219550267,MATH 20C,A03,093476,Briones; Jor-el Thomas Caparas,0,1,36,36
1657219550267,MATH 20C,B01,083762,Bach; Quang Tran,1,0,30,29
1657219556295,MATH 20D,A01,083765,Tran; Brian Kha,4,0,30,26
1657219556295,MATH 20D,A02,083766,Tran; Brian Kha,5,0,30,25
1657219556295,MATH 20D,A03,083767,Tran; Brian Kha,4,0,30,26
1657219562319,MATH 20E,A01,083771,Ganguly; Soumya,7,0,32,25
1657219562319,MATH 20E,A02,083772,Ganguly; Soumya,7,0,32,25
1657219562319,MATH 20E,B01,083773,Ciotti; Benjamin,19,0,35,16
1657219562319,MATH 20E,B02,083774,Ciotti; Benjamin,17,0,35,18
1657219568361,MATH 103A,A01,083777,Greenfeld; Be'Eri,2,0,36,34
1657219568361,MATH 103A,A02,083778,Greenfeld; Be'Eri,5,0,36,31
1657219568361,MATH 103A,A03,093561,Greenfeld; Be'Eri,4,0,36,32
1657219568361,MATH 103A,B01,083779,Greenfeld; Be'Eri,6,0,36,30
1657219568361,MATH 103A,B02,083780,Greenfeld; Be'Eri,3,0,36,33
1657219568361,MATH 103A,B03,093562,Greenfeld; Be'Eri,3,0,36,33
1657219574395,MATH 105,A01,085443,Carter; Anne Toulson,15,0,35,20
1657219574395,MATH 105,A02,093477,Carter; Anne Toulson,20,0,35,15
1657219580419,MATH 109,A01,083213,Ganzberger; Geoffrey Michael,2,0,34,32
1657219580419,MATH 109,A02,083214,Ganzberger; Geoffrey Michael,4,0,34,30
1657219580419,MATH 109,A03,093478,Ganzberger; Geoffrey Michael,2,0,34,32
1657219580419,MATH 109,B01,083215,Ganzberger; Geoffrey Michael,1,0,32,31
1657219580419,MATH 109,B02,083216,Ganzberger; Geoffrey Michael,1,0,32,31
1657219580419,MATH 109,B03,093479,Ganzberger; Geoffrey Michael,7,0,32,25
1657219586444,MATH 142A,A01,083219,Chow; Bennett,6,0,32,26
1657219586444,MATH 142A,A02,083220,Chow; Bennett,10,0,32,22
1657219586444,MATH 142A,A03,093480,Chow; Bennett,7,0,32,25
1657219586444,MATH 142A,B03,093481,Chow; Bennett,8,0,32,24
1657219586444,MATH 142A,B04,093558,Chow; Bennett,11,0,32,21
1657219586444,MATH 142A,B05,093559,Chow; Bennett,6,0,32,26
1657219592481,MATH 193A,A01,083224,Rotar; Vladimir,7,0,34,27
1657219592481,MATH 193A,A02,083225,Rotar; Vladimir,6,0,34,28
1657219592481,MATH 193A,A03,083781,Rotar; Vladimir,1,0,34,33
1657219592481,MATH 193A,A04,083782,Rotar; Vladimir,8,0,34,26
1657219592481,MATH 193A,A05,093482,Rotar; Vladimir,6,0,34,28
1657219598504,MATH 197,001,091859,McAuley; Julian John,9999,0,9999,0
1657219598504,MATH 197,002,095566,Kedlaya; Kiran S.,9997,0,9999,2
1657219598504,MATH 197,003,095567,Xiao; Ming,9999,0,9999,0
1657219598504,MATH 197,004,095571,Perols; Johan Lars,9998,0,9999,1
1657219605564,COGS 9,A01,083615,Shannon; Kyle Michael,8,0,75,67
1657219611593,COGS 11,A01,083617,Boyle; Mary E. T.,22,0,48,26
1657219617619,COGS 13,A01,083071,Bastos; Amalia Pinkusfeld,9,0,71,62
1657219623642,COGS 14A,A01,092681,Semenuks; Arturs,1,1,100,99
1657219629677,COGS 14B,A01,083073,Cheng; Tzu-Han,6,0,63,57
1657219635706,COGS 17,A01,092677,Semenuks; Arturs,4,0,81,77
1657219641729,COGS 100,A01,083619,Allen; Michael Gordon,15,0,70,55
1657219647754,COGS 101A,A01,083621,Davis; Joshua Daniel,9,0,68,59
1657219653778,COGS 101B,A01,091572,Allen; Michael Gordon,9,0,65,56
1657219659801,COGS 101C,A01,083625,Delgado; Tania,17,0,35,18
1657219665830,COGS 107A,A01,083627,Boyle; Mary E. T.,13,0,60,47
1657219671859,COGS 118A,A01,083075,Gupta; Anjum,16,0,76,60
1657219677887,CSE 3,A50,083646,Miranda; Gregory Joseph,24,0,50,26
1657219683923,CSE 8A,A50,083650,Miranda; Gregory Joseph,17,1,56,39
1657219689948,CSE 11,A01,083080,Cao; Yingjun,5,15,40,35
1657219695969,CSE 12,A01,083652,Krause-Levy; Sophia Louisa,24,1,120,96
1657219701996,CSE 15L,A01,083654,Morris; Justin Loren,9,0,50,41
1657219701996,CSE 15L,A02,083655,Morris; Justin Loren,9,0,50,41
1657219708020,CSE 20,A01,083657,Tran; Khoa Dang,38,0,80,42
1657219714049,CSE 21,A01,095574,Bach; Quang Tran,22,0,48,26
1657219720076,CSE 30,A01,083084,Eldon; John,4,0,80,76
1657219720076,CSE 30,B01,095061,Bhaskar; Nishant,8,0,50,42
1657219726099,CSE 100,A01,083659,Cao; Yingjun,4,4,70,66
1657219732129,CSE 134B,A01,083661,Powell; Thomas Allan,20,0,100,80
1657219738158,CSE 140,A01,083663,Gungor; Onat,13,0,85,72
1657219744195,CSE 140L,A01,083088,Eldon; John,17,0,100,83
1657219750222,CSE 175,A01,083665,Kumar; Rakesh,3,0,25,22
1657219756244,CSE 190,A00,092507,Dubnov; Shlomo,7,0,20,13
1657219762268,ECE 45,A01,083139,Congero; Spencer William,5,0,75,70
1657219768301,ECE 65,A50,083695,Saad; Andrew S,12,0,30,18
1657219768301,ECE 65,A51,095125,Saad; Andrew S,25,0,26,1
1657219774329,ECE 109,A01,091882,Touri; Behrouz,19,0,70,51
1657219780358,ECE 180,A00,083140,Abi Samra; Nicholas Camill,1,0,30,29
1657219780358,ECE 180,B00,083141,Abi Samra; Nicholas Camill,0,0,30,30
1657219786383,MATH 10A,A01,083735,Patchell; Gregory David,2,0,30,28
1657219786383,MATH 10A,A02,083736,Patchell; Gregory David,20,0,30,10
1657219786383,MATH 10A,A03,083737,Patchell; Gregory David,16,0,30,14
1657219792407,MATH 10B,A01,083207,Lim; Seonhee,7,0,34,27
1657219792407,MATH 10B,A02,083208,Lim; Seonhee,9,0,35,26
1657219792407,MATH 10B,A03,093472,Lim; Seonhee,5,0,34,29
1657219792407,MATH 10B,B01,083739,Sinha; Shubham,10,0,30,20
1657219798432,MATH 18,A01,083743,Cinel; Cameron Alexander,6,0,30,24
1657219798432,MATH 18,A02,083744,Cinel; Cameron Alexander,16,0,30,14
1657219798432,MATH 18,A03,083745,Cinel; Cameron Alexander,8,0,30,22
1657219798432,MATH 18,B01,083748,Rideout; David Porter,4,0,37,33
1657219798432,MATH 18,B02,083749,Rideout; David Porter,4,0,36,32
1657219798432,MATH 18,B03,083750,Rideout; David Porter,2,0,37,35
1657219798432,MATH 18,B04,083751,Rideout; David Porter,5,0,36,31
1657219798432,MATH 18,B05,093473,Rideout; David Porter,5,0,36,31
1657219798432,MATH 18,B06,093474,Rideout; David Porter,5,0,36,31
1657219804465,MATH 20A,A01,083754,Zheng; Zequn,14,0,40,26
1657219810497,MATH 20B,A01,083756,Briones; Jor-el Thomas Caparas,2,0,36,34
1657219810497,MATH 20B,A02,083757,Briones; Jor-el Thomas Caparas,1,0,36,35
1657219810497,MATH 20B,A03,093475,Briones; Jor-el Thomas Caparas,1,0,36,35
1657219816531,MATH 20C,A01,083760,Briones; Jor-el Thomas Caparas,1,0,35,34
1657219816531,MATH 20C,A02,083761,Briones; Jor-el Thomas Caparas,8,0,35,27
1657219816531,MATH 20C,A03,093476,Briones; Jor-el Thomas Caparas,0,1,36,36
1657219816531,MATH 20C,B01,083762,Bach; Quang Tran,1,0,30,29
1657219822555,MATH 20D,A01,083765,Tran; Brian Kha,4,0,30,26
1657219822555,MATH 20D,A02,083766,Tran; Brian Kha,5,0,30,25
1657219822555,MATH 20D,A03,083767,Tran; Brian Kha,4,0,30,26
1657219828584,MATH 20E,A01,083771,Ganguly; Soumya,7,0,32,25
1657219828584,MATH 20E,A02,083772,Ganguly; Soumya,7,0,32,25
1657219828584,MATH 20E,B01,083773,Ciotti; Benjamin,19,0,35,16
1657219828584,MATH 20E,B02,083774,Ciotti; Benjamin,17,0,35,18
1657219834614,MATH 103A,A01,083777,Greenfeld; Be'Eri,2,0,36,34
1657219834614,MATH 103A,A02,083778,Greenfeld; Be'Eri,5,0,36,31
1657219834614,MATH 103A,A03,093561,Greenfeld; Be'Eri,4,0,36,32
1657219834614,MATH 103A,B01,083779,Greenfeld; Be'Eri,6,0,36,30
1657219834614,MATH 103A,B02,083780,Greenfeld; Be'Eri,3,0,36,33
1657219834614,MATH 103A,B03,093562,Greenfeld; Be'Eri,3,0,36,33
1657219840643,MATH 105,A01,085443,Carter; Anne Toulson,15,0,35,20
1657219840643,MATH 105,A02,093477,Carter; Anne Toulson,20,0,35,15
1657219846667,MATH 109,A01,083213,Ganzberger; Geoffrey Michael,2,0,34,32
1657219846667,MATH 109,A02,083214,Ganzberger; Geoffrey Michael,4,0,34,30
1657219846667,MATH 109,A03,093478,Ganzberger; Geoffrey Michael,2,0,34,32
1657219846667,MATH 109,B01,083215,Ganzberger; Geoffrey Michael,1,0,32,31
1657219846667,MATH 109,B02,083216,Ganzberger; Geoffrey Michael,1,0,32,31
1657219846667,MATH 109,B03,093479,Ganzberger; Geoffrey Michael,7,0,32,25
1657219852784,MATH 142A,A01,083219,Chow; Bennett,6,0,32,26
1657219852784,MATH 142A,A02,083220,Chow; Bennett,10,0,32,22
1657219852784,MATH 142A,A03,093480,Chow; Bennett,7,0,32,25
1657219852784,MATH 142A,B03,093481,Chow; Bennett,8,0,32,24
1657219852784,MATH 142A,B04,093558,Chow; Bennett,11,0,32,21
1657219852784,MATH 142A,B05,093559,Chow; Bennett,6,0,32,26
1657219858807,MATH 193A,A01,083224,Rotar; Vladimir,7,0,34,27
1657219858807,MATH 193A,A02,083225,Rotar; Vladimir,6,0,34,28
1657219858807,MATH 193A,A03,083781,Rotar; Vladimir,1,0,34,33
1657219858807,MATH 193A,A04,083782,Rotar; Vladimir,8,0,34,26
1657219858807,MATH 193A,A05,093482,Rotar; Vladimir,6,0,34,28
1657219864831,MATH 197,001,091859,McAuley; Julian John,9999,0,9999,0
1657219864831,MATH 197,002,095566,Kedlaya; Kiran S.,9997,0,9999,2
1657219864831,MATH 197,003,095567,Xiao; Ming,9999,0,9999,0
1657219864831,MATH 197,004,095571,Perols; Johan Lars,9998,0,9999,1
1657219871887,COGS 9,A01,083615,Shannon; Kyle Michael,8,0,75,67
1657219877928,COGS 11,A01,083617,Boyle; Mary E. T.,22,0,48,26
1657219883993,COGS 13,A01,083071,Bastos; Amalia Pinkusfeld,9,0,71,62
1657219890032,COGS 14A,A01,092681,Semenuks; Arturs,1,1,100,99
1657219896067,COGS 14B,A01,083073,Cheng; Tzu-Han,6,0,63,57
1657219902100,COGS 17,A01,092677,Semenuks; Arturs,5,0,81,76
1657219908131,COGS 100,A01,083619,Allen; Michael Gordon,15,0,70,55
1657219914161,COGS 101A,A01,083621,Davis; Joshua Daniel,9,0,68,59
1657219920188,COGS 101B,A01,091572,Allen; Michael Gordon,9,0,65,56
1657219926214,COGS 101C,A01,083625,Delgado; Tania,17,0,35,18
1657219932254,COGS 107A,A01,083627,Boyle; Mary E. T.,13,0,60,47
1657219938279,COGS 118A,A01,083075,Gupta; Anjum,16,0,76,60
1657219944308,CSE 3,A50,083646,Miranda; Gregory Joseph,24,0,50,26
1657219950330,CSE 8A,A50,083650,Miranda; Gregory Joseph,17,1,56,39
1657219956353,CSE 11,A01,083080,Cao; Yingjun,5,15,40,35
1657219962390,CSE 12,A01,083652,Krause-Levy; Sophia Louisa,24,1,120,96
1657219968420,CSE 15L,A01,083654,Morris; Justin Loren,9,0,50,41
1657219968420,CSE 15L,A02,083655,Morris; Justin Loren,9,0,50,41
1657219974464,CSE 20,A01,083657,Tran; Khoa Dang,38,0,80,42
1657219980487,CSE 21,A01,095574,Bach; Quang Tran,22,0,48,26
1657219986516,CSE 30,A01,083084,Eldon; John,4,0,80,76
1657219986516,CSE 30,B01,095061,Bhaskar; Nishant,8,0,50,42
1657219992552,CSE 100,A01,083659,Cao; Yingjun,4,4,70,66
1657219998573,CSE 134B,A01,083661,Powell; Thomas Allan,20,0,100,80
1657220004597,CSE 140,A01,083663,Gungor; Onat,13,0,85,72
1657220010626,CSE 140L,A01,083088,Eldon; John,17,0,100,83
1657220016650,CSE 175,A01,083665,Kumar; Rakesh,3,0,25,22
1657220022673,CSE 190,A00,092507,Dubnov; Shlomo,7,0,20,13
1657220028704,ECE 45,A01,083139,Congero; Spencer William,5,0,75,70
1657220034726,ECE 65,A50,083695,Saad; Andrew S,12,0,30,18
1657220034726,ECE 65,A51,095125,Saad; Andrew S,25,0,26,1
1657220040757,ECE 109,A01,091882,Touri; Behrouz,19,0,70,51
1657220046786,ECE 180,A00,083140,Abi Samra; Nicholas Camill,1,0,30,29
1657220046786,ECE 180,B00,083141,Abi Samra; Nicholas Camill,0,0,30,30
1657220052810,MATH 10A,A01,083735,Patchell; Gregory David,2,0,30,28
1657220052810,MATH 10A,A02,083736,Patchell; Gregory David,20,0,30,10
1657220052810,MATH 10A,A03,083737,Patchell; Gregory David,16,0,30,14
1657220058843,MATH 10B,A01,083207,Lim; Seonhee,7,0,34,27
1657220058843,MATH 10B,A02,083208,Lim; Seonhee,9,0,35,26
1657220058843,MATH 10B,A03,093472,Lim; Seonhee,5,0,34,29
1657220058843,MATH 10B,B01,083739,Sinha; Shubham,10,0,30,20
1657220064881,MATH 18,A01,083743,Cinel; Cameron Alexander,6,0,30,24
1657220064881,MATH 18,A02,083744,Cinel; Cameron Alexander,16,0,30,14
1657220064881,MATH 18,A03,083745,Cinel; Cameron Alexander,8,0,30,22
1657220064881,MATH 18,B01,083748,Rideout; David Porter,4,0,37,33
1657220064881,MATH 18,B02,083749,Rideout; David Porter,4,0,36,32
1657220064881,MATH 18,B03,083750,Rideout; David Porter,2,0,37,35
1657220064881,MATH 18,B04,083751,Rideout; David Porter,5,0,36,31
1657220064881,MATH 18,B05,093473,Rideout; David Porter,5,0,36,31
1657220064881,MATH 18,B06,093474,Rideout; David Porter,5,0,36,31
1657220070906,MATH 20A,A01,083754,Zheng; Zequn,14,0,40,26
1657220076942,MATH 20B,A01,083756,Briones; Jor-el Thomas Caparas,2,0,36,34
1657220076942,MATH 20B,A02,083757,Briones; Jor-el Thomas Caparas,1,0,36,35
1657220076942,MATH 20B,A03,093475,Briones; Jor-el Thomas Caparas,1,0,36,35
1657220082979,MATH 20C,A01,083760,Briones; Jor-el Thomas Caparas,1,0,35,34
1657220082979,MATH 20C,A02,083761,Briones; Jor-el Thomas Caparas,8,0,35,27
1657220082979,MATH 20C,A03,093476,Briones; Jor-el Thomas Caparas,0,1,36,36
1657220082979,MATH 20C,B01,083762,Bach; Quang Tran,1,0,30,29
1657220089005,MATH 20D,A01,083765,Tran; Brian Kha,4,0,30,26
1657220089005,MATH 20D,A02,083766,Tran; Brian Kha,5,0,30,25
1657220089005,MATH 20D,A03,083767,Tran; Brian Kha,4,0,30,26
1657220095033,MATH 20E,A01,083771,Ganguly; Soumya,7,0,32,25
1657220095033,MATH 20E,A02,083772,Ganguly; Soumya,7,0,32,25
1657220095033,MATH 20E,B01,083773,Ciotti; Benjamin,19,0,35,16
1657220095033,MATH 20E,B02,083774,Ciotti; Benjamin,17,0,35,18
1657220101055,MATH 103A,A01,083777,Greenfeld; Be'Eri,2,0,36,34
1657220101055,MATH 103A,A02,083778,Greenfeld; Be'Eri,5,0,36,31
1657220101055,MATH 103A,A03,093561,Greenfeld; Be'Eri,4,0,36,32
1657220101055,MATH 103A,B01,083779,Greenfeld; Be'Eri,6,0,36,30
1657220101055,MATH 103A,B02,083780,Greenfeld; Be'Eri,3,0,36,33
1657220101055,MATH 103A,B03,093562,Greenfeld; Be'Eri,3,0,36,33
1657220107079,MATH 105,A01,085443,Carter; Anne Toulson,15,0,35,20
1657220107079,MATH 105,A02,093477,Carter; Anne Toulson,20,0,35,15
1657220113108,MATH 109,A01,083213,Ganzberger; Geoffrey Michael,2,0,34,32
1657220113108,MATH 109,A02,083214,Ganzberger; Geoffrey Michael,4,0,34,30
1657220113108,MATH 109,A03,093478,Ganzberger; Geoffrey Michael,2,0,34,32
1657220113108,MATH 109,B01,083215,Ganzberger; Geoffrey Michael,1,0,32,31
1657220113108,MATH 109,B02,083216,Ganzberger; Geoffrey Michael,1,0,32,31
1657220113108,MATH 109,B03,093479,Ganzberger; Geoffrey Michael,7,0,32,25
1657220119131,MATH 142A,A01,083219,Chow; Bennett,6,0,32,26
1657220119131,MATH 142A,A02,083220,Chow; Bennett,10,0,32,22
1657220119131,MATH 142A,A03,093480,Chow; Bennett,7,0,32,25
1657220119131,MATH 142A,B03,093481,Chow; Bennett,8,0,32,24
1657220119131,MATH 142A,B04,093558,Chow; Bennett,11,0,32,21
1657220119131,MATH 142A,B05,093559,Chow; Bennett,6,0,32,26
1657220125153,MATH 193A,A01,083224,Rotar; Vladimir,7,0,34,27
1657220125153,MATH 193A,A02,083225,Rotar; Vladimir,6,0,34,28
1657220125153,MATH 193A,A03,083781,Rotar; Vladimir,1,0,34,33
1657220125153,MATH 193A,A04,083782,Rotar; Vladimir,8,0,34,26
1657220125153,MATH 193A,A05,093482,Rotar; Vladimir,6,0,34,28
1657220131176,MATH 197,001,091859,McAuley; Julian John,9999,0,9999,0
1657220131176,MATH 197,002,095566,Kedlaya; Kiran S.,9997,0,9999,2
1657220131176,MATH 197,003,095567,Xiao; Ming,9999,0,9999,0
1657220131176,MATH 197,004,095571,Perols; Johan Lars,9998,0,9999,1
1657220138230,COGS 9,A01,083615,Shannon; Kyle Michael,8,0,75,67
1657220144260,COGS 11,A01,083617,Boyle; Mary E. T.,22,0,48,26
1657220150286,COGS 13,A01,083071,Bastos; Amalia Pinkusfeld,9,0,71,62
1657220156312,COGS 14A,A01,092681,Semenuks; Arturs,1,1,100,99
1657220162334,COGS 14B,A01,083073,Cheng; Tzu-Han,6,0,63,57
1657220168367,COGS 17,A01,092677,Semenuks; Arturs,5,0,81,76
1657220174391,COGS 100,A01,083619,Allen; Michael Gordon,15,0,70,55
1657220180415,COGS 101A,A01,083621,Davis; Joshua Daniel,9,0,68,59
1657220186442,COGS 101B,A01,091572,Allen; Michael Gordon,9,0,65,56
1657220192479,COGS 101C,A01,083625,Delgado; Tania,17,0,35,18
1657220198512,COGS 107A,A01,083627,Boyle; Mary E. T.,13,0,60,47
1657220204567,COGS 118A,A01,083075,Gupta; Anjum,16,0,76,60
1657220210596,CSE 3,A50,083646,Miranda; Gregory Joseph,24,0,50,26
1657220216628,CSE 8A,A50,083650,Miranda; Gregory Joseph,17,1,56,39
1657220222657,CSE 11,A01,083080,Cao; Yingjun,5,15,40,35
1657220228678,CSE 12,A01,083652,Krause-Levy; Sophia Louisa,24,1,120,96
1657220234708,CSE 15L,A01,083654,Morris; Justin Loren,9,0,50,41
1657220234708,CSE 15L,A02,083655,Morris; Justin Loren,9,0,50,41
1657220240734,CSE 20,A01,083657,Tran; Khoa Dang,38,0,80,42
1657220246768,CSE 21,A01,095574,Bach; Quang Tran,22,0,48,26
1657220252795,CSE 30,A01,083084,Eldon; John,4,0,80,76
1657220252795,CSE 30,B01,095061,Bhaskar; Nishant,8,0,50,42
1657220258818,CSE 100,A01,083659,Cao; Yingjun,4,4,70,66
1657220264843,CSE 134B,A01,083661,Powell; Thomas Allan,20,0,100,80
1657220270866,CSE 140,A01,083663,Gungor; Onat,13,0,85,72
1657220276888,CSE 140L,A01,083088,Eldon; John,17,0,100,83
1657220282913,CSE 175,A01,083665,Kumar; Rakesh,3,0,25,22
1657220288935,CSE 190,A00,092507,Dubnov; Shlomo,7,0,20,13
1657220294961,ECE 45,A01,083139,Congero; Spencer William,5,0,75,70
1657220300986,ECE 65,A50,083695,Saad; Andrew S,12,0,30,18
1657220300986,ECE 65,A51,095125,Saad; Andrew S,25,0,26,1
1657220307016,ECE 109,A01,091882,Touri; Behrouz,19,0,70,51
1657220313049,ECE 180,A00,083140,Abi Samra; Nicholas Camill,1,0,30,29
1657220313049,ECE 180,B00,083141,Abi Samra; Nicholas Camill,0,0,30,30
1657220319071,MATH 10A,A01,083735,Patchell; Gregory David,2,0,30,28
1657220319071,MATH 10A,A02,083736,Patchell; Gregory David,20,0,30,10
1657220319071,MATH 10A,A03,083737,Patchell; Gregory David,16,0,30,14
1657220325112,MATH 10B,A01,083207,Lim; Seonhee,7,0,34,27
1657220325112,MATH 10B,A02,083208,Lim; Seonhee,9,0,35,26
1657220325112,MATH 10B,A03,093472,Lim; Seonhee,5,0,34,29
1657220325112,MATH 10B,B01,083739,Sinha; Shubham,10,0,30,20
1657220331145,MATH 18,A01,083743,Cinel; Cameron Alexander,6,0,30,24
1657220331145,MATH 18,A02,083744,Cinel; Cameron Alexander,16,0,30,14
1657220331145,MATH 18,A03,083745,Cinel; Cameron Alexander,8,0,30,22
1657220331145,MATH 18,B01,083748,Rideout; David Porter,4,0,37,33
1657220331145,MATH 18,B02,083749,Rideout; David Porter,4,0,36,32
1657220331145,MATH 18,B03,083750,Rideout; David Porter,2,0,37,35
1657220331145,MATH 18,B04,083751,Rideout; David Porter,5,0,36,31
1657220331145,MATH 18,B05,093473,Rideout; David Porter,5,0,36,31
1657220331145,MATH 18,B06,093474,Rideout; David Porter,5,0,36,31
1657220337168,MATH 20A,A01,083754,Zheng; Zequn,14,0,40,26
1657220343192,MATH 20B,A01,083756,Briones; Jor-el Thomas Caparas,2,0,36,34
1657220343192,MATH 20B,A02,083757,Briones; Jor-el Thomas Caparas,1,0,36,35
1657220343192,MATH 20B,A03,093475,Briones; Jor-el Thomas Caparas,1,0,36,35
1657220349228,MATH 20C,A01,083760,Briones; Jor-el Thomas Caparas,1,0,35,34
1657220349228,MATH 20C,A02,083761,Briones; Jor-el Thomas Caparas,8,0,35,27
1657220349228,MATH 20C,A03,093476,Briones; Jor-el Thomas Caparas,0,1,36,36
1657220349228,MATH 20C,B01,083762,Bach; Quang Tran,1,0,30,29
1657220355263,MATH 20D,A01,083765,Tran; Brian Kha,4,0,30,26
1657220355263,MATH 20D,A02,083766,Tran; Brian Kha,5,0,30,25
1657220355263,MATH 20D,A03,083767,Tran; Brian Kha,4,0,30,26
1657220361294,MATH 20E,A01,083771,Ganguly; Soumya,7,0,32,25
1657220361294,MATH 20E,A02,083772,Ganguly; Soumya,7,0,32,25
1657220361294,MATH 20E,B01,083773,Ciotti; Benjamin,19,0,35,16
1657220361294,MATH 20E,B02,083774,Ciotti; Benjamin,17,0,35,18
1657220367321,MATH 103A,A01,083777,Greenfeld; Be'Eri,2,0,36,34
1657220367321,MATH 103A,A02,083778,Greenfeld; Be'Eri,5,0,36,31
1657220367321,MATH 103A,A03,093561,Greenfeld; Be'Eri,4,0,36,32
1657220367321,MATH 103A,B01,083779,Greenfeld; Be'Eri,6,0,36,30
1657220367321,MATH 103A,B02,083780,Greenfeld; Be'Eri,3,0,36,33
1657220367321,MATH 103A,B03,093562,Greenfeld; Be'Eri,3,0,36,33
1657220373348,MATH 105,A01,085443,Carter; Anne Toulson,15,0,35,20
1657220373348,MATH 105,A02,093477,Carter; Anne Toulson,20,0,35,15
1657220379376,MATH 109,A01,083213,Ganzberger; Geoffrey Michael,2,0,34,32
1657220379376,MATH 109,A02,083214,Ganzberger; Geoffrey Michael,4,0,34,30
1657220379376,MATH 109,A03,093478,Ganzberger; Geoffrey Michael,2,0,34,32
1657220379376,MATH 109,B01,083215,Ganzberger; Geoffrey Michael,1,0,32,31
1657220379376,MATH 109,B02,083216,Ganzberger; Geoffrey Michael,1,0,32,31
1657220379376,MATH 109,B03,093479,Ganzberger; Geoffrey Michael,7,0,32,25
1657220385399,MATH 142A,A01,083219,Chow; Bennett,6,0,32,26
1657220385399,MATH 142A,A02,083220,Chow; Bennett,10,0,32,22
1657220385399,MATH 142A,A03,093480,Chow; Bennett,7,0,32,25
1657220385399,MATH 142A,B03,093481,Chow; Bennett,8,0,32,24
1657220385399,MATH 142A,B04,093558,Chow; Bennett,11,0,32,21
1657220385399,MATH 142A,B05,093559,Chow; Bennett,6,0,32,26
1657220391435,MATH 193A,A01,083224,Rotar; Vladimir,7,0,34,27
1657220391435,MATH 193A,A02,083225,Rotar; Vladimir,6,0,34,28
1657220391435,MATH 193A,A03,083781,Rotar; Vladimir,1,0,34,33
1657220391435,MATH 193A,A04,083782,Rotar; Vladimir,8,0,34,26
1657220391435,MATH 193A,A05,093482,Rotar; Vladimir,6,0,34,28
1657220397465,MATH 197,001,091859,McAuley; Julian John,9999,0,9999,0
1657220397465,MATH 197,002,095566,Kedlaya; Kiran S.,9997,0,9999,2
1657220397465,MATH 197,003,095567,Xiao; Ming,9999,0,9999,0
1657220397465,MATH 197,004,095571,Perols; Johan Lars,9998,0,9999,1
1657220404552,COGS 9,A01,083615,Shannon; Kyle Michael,8,0,75,67
1657220410580,COGS 11,A01,083617,Boyle; Mary E. T.,22,0,48,26
1657220416613,COGS 13,A01,083071,Bastos; Amalia Pinkusfeld,9,0,71,62
1657220422640,COGS 14A,A01,092681,Semenuks; Arturs,1,1,100,99
1657220428667,COGS 14B,A01,083073,Cheng; Tzu-Han,6,0,63,57
1657220434715,COGS 17,A01,092677,Semenuks; Arturs,5,0,81,76
1657220440744,COGS 100,A01,083619,Allen; Michael Gordon,15,0,70,55
1657220446851,COGS 101A,A01,083621,Davis; Joshua Daniel,9,0,68,59
1657220452875,COGS 101B,A01,091572,Allen; Michael Gordon,9,0,65,56
1657220458900,COGS 101C,A01,083625,Delgado; Tania,17,0,35,18
1657220464924,COGS 107A,A01,083627,Boyle; Mary E. T.,13,0,60,47
1657220470949,COGS 118A,A01,083075,Gupta; Anjum,16,0,76,60
1657220476970,CSE 3,A50,083646,Miranda; Gregory Joseph,24,0,50,26
1657220482999,CSE 8A,A50,083650,Miranda; Gregory Joseph,17,1,56,39
1657220489033,CSE 11,A01,083080,Cao; Yingjun,5,15,40,35
1657220495057,CSE 12,A01,083652,Krause-Levy; Sophia Louisa,24,1,120,96
1657220501090,CSE 15L,A01,083654,Morris; Justin Loren,9,0,50,41
1657220501090,CSE 15L,A02,083655,Morris; Justin Loren,9,0,50,41
1657220507116,CSE 20,A01,083657,Tran; Khoa Dang,38,0,80,42
1657220513139,CSE 21,A01,095574,Bach; Quang Tran,22,0,48,26
1657220519164,CSE 30,A01,083084,Eldon; John,4,0,80,76
1657220519164,CSE 30,B01,095061,Bhaskar; Nishant,8,0,50,42
1657220525186,CSE 100,A01,083659,Cao; Yingjun,4,4,70,66
1657220531221,CSE 134B,A01,083661,Powell; Thomas Allan,20,0,100,80
1657220537243,CSE 140,A01,083663,Gungor; Onat,13,0,85,72
1657220543278,CSE 140L,A01,083088,Eldon; John,17,0,100,83
1657220549304,CSE 175,A01,083665,Kumar; Rakesh,3,0,25,22
1657220555337,CSE 190,A00,092507,Dubnov; Shlomo,7,0,20,13
1657220561360,ECE 45,A01,083139,Congero; Spencer William,5,0,75,70
1657220567387,ECE 65,A50,083695,Saad; Andrew S,12,0,30,18
1657220567387,ECE 65,A51,095125,Saad; Andrew S,25,0,26,1
1657220573414,ECE 109,A01,091882,Touri; Behrouz,19,0,70,51
1657220579449,ECE 180,A00,083140,Abi Samra; Nicholas Camill,1,0,30,29
1657220579449,ECE 180,B00,083141,Abi Samra; Nicholas Camill,0,0,30,30
1657220585475,MATH 10A,A01,083735,Patchell; Gregory David,2,0,30,28
1657220585475,MATH 10A,A02,083736,Patchell; Gregory David,20,0,30,10
1657220585475,MATH 10A,A03,083737,Patchell; Gregory David,16,0,30,14
1657220591498,MATH 10B,A01,083207,Lim; Seonhee,7,0,34,27
1657220591498,MATH 10B,A02,083208,Lim; Seonhee,9,0,35,26
1657220591498,MATH 10B,A03,093472,Lim; Seonhee,5,0,34,29
1657220591498,MATH 10B,B01,083739,Sinha; Shubham,10,0,30,20
1657220597528,MATH 18,A01,083743,Cinel; Cameron Alexander,6,0,30,24
1657220597528,MATH 18,A02,083744,Cinel; Cameron Alexander,16,0,30,14
1657220597528,MATH 18,A03,083745,Cinel; Cameron Alexander,8,0,30,22
1657220597528,MATH 18,B01,083748,Rideout; David Porter,4,0,37,33
1657220597528,MATH 18,B02,083749,Rideout; David Porter,4,0,36,32
1657220597528,MATH 18,B03,083750,Rideout; David Porter,2,0,37,35
1657220597528,MATH 18,B04,083751,Rideout; David Porter,5,0,36,31
1657220597528,MATH 18,B05,093473,Rideout; David Porter,5,0,36,31
1657220597528,MATH 18,B06,093474,Rideout; David Porter,5,0,36,31
1657220603551,MATH 20A,A01,083754,Zheng; Zequn,14,0,40,26
1657220609578,MATH 20B,A01,083756,Briones; Jor-el Thomas Caparas,2,0,36,34
1657220609578,MATH 20B,A02,083757,Briones; Jor-el Thomas Caparas,1,0,36,35
1657220609578,MATH 20B,A03,093475,Briones; Jor-el Thomas Caparas,1,0,36,35
1657220615618,MATH 20C,A01,083760,Briones; Jor-el Thomas Caparas,1,0,35,34
1657220615618,MATH 20C,A02,083761,Briones; Jor-el Thomas Caparas,8,0,35,27
1657220615618,MATH 20C,A03,093476,Briones; Jor-el Thomas Caparas,0,1,36,36
1657220615618,MATH 20C,B01,083762,Bach; Quang Tran,1,0,30,29
1657220621641,MATH 20D,A01,083765,Tran; Brian Kha,4,0,30,26
1657220621641,MATH 20D,A02,083766,Tran; Brian Kha,5,0,30,25
1657220621641,MATH 20D,A03,083767,Tran; Brian Kha,4,0,30,26
1657220627664,MATH 20E,A01,083771,Ganguly; Soumya,7,0,32,25
1657220627664,MATH 20E,A02,083772,Ganguly; Soumya,7,0,32,25
1657220627664,MATH 20E,B01,083773,Ciotti; Benjamin,19,0,35,16
1657220627664,MATH 20E,B02,083774,Ciotti; Benjamin,17,0,35,18
1657220633700,MATH 103A,A01,083777,Greenfeld; Be'Eri,2,0,36,34
1657220633700,MATH 103A,A02,083778,Greenfeld; Be'Eri,5,0,36,31
1657220633700,MATH 103A,A03,093561,Greenfeld; Be'Eri,4,0,36,32
1657220633700,MATH 103A,B01,083779,Greenfeld; Be'Eri,6,0,36,30
1657220633700,MATH 103A,B02,083780,Greenfeld; Be'Eri,3,0,36,33
1657220633700,MATH 103A,B03,093562,Greenfeld; Be'Eri,3,0,36,33
1657220639727,MATH 105,A01,085443,Carter; Anne Toulson,15,0,35,20
1657220639727,MATH 105,A02,093477,Carter; Anne Toulson,20,0,35,15
1657220645750,MATH 109,A01,083213,Ganzberger; Geoffrey Michael,2,0,34,32
1657220645750,MATH 109,A02,083214,Ganzberger; Geoffrey Michael,4,0,34,30
1657220645750,MATH 109,A03,093478,Ganzberger; Geoffrey Michael,2,0,34,32
1657220645750,MATH 109,B01,083215,Ganzberger; Geoffrey Michael,1,0,32,31
1657220645750,MATH 109,B02,083216,Ganzberger; Geoffrey Michael,1,0,32,31
1657220645750,MATH 109,B03,093479,Ganzberger; Geoffrey Michael,7,0,32,25
1657220651779,MATH 142A,A01,083219,Chow; Bennett,6,0,32,26
1657220651779,MATH 142A,A02,083220,Chow; Bennett,10,0,32,22
1657220651779,MATH 142A,A03,093480,Chow; Bennett,7,0,32,25
1657220651779,MATH 142A,B03,093481,Chow; Bennett,8,0,32,24
1657220651779,MATH 142A,B04,093558,Chow; Bennett,11,0,32,21
1657220651779,MATH 142A,B05,093559,Chow; Bennett,6,0,32,26
1657220657802,MATH 193A,A01,083224,Rotar; Vladimir,7,0,34,27
1657220657802,MATH 193A,A02,083225,Rotar; Vladimir,6,0,34,28
1657220657802,MATH 193A,A03,083781,Rotar; Vladimir,1,0,34,33
1657220657802,MATH 193A,A04,083782,Rotar; Vladimir,8,0,34,26
1657220657802,MATH 193A,A05,093482,Rotar; Vladimir,6,0,34,28
1657220663825,MATH 197,001,091859,McAuley; Julian John,9999,0,9999,0
1657220663825,MATH 197,002,095566,Kedlaya; Kiran S.,9997,0,9999,2
1657220663825,MATH 197,003,095567,Xiao; Ming,9999,0,9999,0
1657220663825,MATH 197,004,095571,Perols; Johan Lars,9998,0,9999,1
1657220670880,COGS 9,A01,083615,Shannon; Kyle Michael,8,0,75,67
1657220676906,COGS 11,A01,083617,Boyle; Mary E. T.,22,0,48,26
1657220682936,COGS 13,A01,083071,Bastos; Amalia Pinkusfeld,9,0,71,62
1657220688968,COGS 14A,A01,092681,Semenuks; Arturs,1,1,100,99
1657220694997,COGS 14B,A01,083073,Cheng; Tzu-Han,6,0,63,57
1657220701029,COGS 17,A01,092677,Semenuks; Arturs,5,0,81,76
1657220707054,COGS 100,A01,083619,Allen; Michael Gordon,15,0,70,55
1657220713077,COGS 101A,A01,083621,Davis; Joshua Daniel,9,0,68,59
1657220719110,COGS 101B,A01,091572,Allen; Michael Gordon,9,0,65,56
1657220725134,COGS 101C,A01,083625,Delgado; Tania,17,0,35,18
1657220731158,COGS 107A,A01,083627,Boyle; Mary E. T.,13,0,60,47
1657220737182,COGS 118A,A01,083075,Gupta; Anjum,16,0,76,60
1657220743205,CSE 3,A50,083646,Miranda; Gregory Joseph,24,0,50,26
1657220749230,CSE 8A,A50,083650,Miranda; Gregory Joseph,17,1,56,39
1657220755256,CSE 11,A01,083080,Cao; Yingjun,5,15,40,35
1657220761283,CSE 12,A01,083652,Krause-Levy; Sophia Louisa,24,1,120,96
1657220767311,CSE 15L,A01,083654,Morris; Justin Loren,9,0,50,41
1657220767311,CSE 15L,A02,083655,Morris; Justin Loren,9,0,50,41
1657220773344,CSE 20,A01,083657,Tran; Khoa Dang,38,0,80,42
1657220779368,CSE 21,A01,095574,Bach; Quang Tran,22,0,48,26
1657220785404,CSE 30,A01,083084,Eldon; John,4,0,80,76
1657220785404,CSE 30,B01,095061,Bhaskar; Nishant,8,0,50,42
1657220791428,CSE 100,A01,083659,Cao; Yingjun,4,4,70,66
1657220797450,CSE 134B,A01,083661,Powell; Thomas Allan,21,0,100,79
1657220803477,CSE 140,A01,083663,Gungor; Onat,13,0,85,72
1657220809499,CSE 140L,A01,083088,Eldon; John,17,0,100,83
1657220815531,CSE 175,A01,083665,Kumar; Rakesh,3,0,25,22
1657220821553,CSE 190,A00,092507,Dubnov; Shlomo,7,0,20,13
1657220827583,ECE 45,A01,083139,Congero; Spencer William,5,0,75,70
1657220833611,ECE 65,A50,083695,Saad; Andrew S,12,0,30,18
1657220833611,ECE 65,A51,095125,Saad; Andrew S,25,0,26,1
1657220839637,ECE 109,A01,091882,Touri; Behrouz,19,0,70,51
1657220845663,ECE 180,A00,083140,Abi Samra; Nicholas Camill,1,0,30,29
1657220845663,ECE 180,B00,083141,Abi Samra; Nicholas Camill,0,0,30,30
1657220851690,MATH 10A,A01,083735,Patchell; Gregory David,2,0,30,28
1657220851690,MATH 10A,A02,083736,Patchell; Gregory David,20,0,30,10
1657220851690,MATH 10A,A03,083737,Patchell; Gregory David,16,0,30,14
1657220857717,MATH 10B,A01,083207,Lim; Seonhee,7,0,34,27
1657220857717,MATH 10B,A02,083208,Lim; Seonhee,9,0,35,26
1657220857717,MATH 10B,A03,093472,Lim; Seonhee,5,0,34,29
1657220857717,MATH 10B,B01,083739,Sinha; Shubham,10,0,30,20
1657220863747,MATH 18,A01,083743,Cinel; Cameron Alexander,6,0,30,24
1657220863747,MATH 18,A02,083744,Cinel; Cameron Alexander,16,0,30,14
1657220863747,MATH 18,A03,083745,Cinel; Cameron Alexander,8,0,30,22
1657220863747,MATH 18,B01,083748,Rideout; David Porter,4,0,37,33
1657220863747,MATH 18,B02,083749,Rideout; David Porter,4,0,36,32
1657220863747,MATH 18,B03,083750,Rideout; David Porter,2,0,37,35
1657220863747,MATH 18,B04,083751,Rideout; David Porter,5,0,36,31
1657220863747,MATH 18,B05,093473,Rideout; David Porter,5,0,36,31
1657220863747,MATH 18,B06,093474,Rideout; David Porter,5,0,36,31
1657220869769,MATH 20A,A01,083754,Zheng; Zequn,14,0,40,26
1657220875801,MATH 20B,A01,083756,Briones; Jor-el Thomas Caparas,2,0,36,34
1657220875801,MATH 20B,A02,083757,Briones; Jor-el Thomas Caparas,1,0,36,35
1657220875801,MATH 20B,A03,093475,Briones; Jor-el Thomas Caparas,1,0,36,35
1657220881822,MATH 20C,A01,083760,Briones; Jor-el Thomas Caparas,1,0,35,34
1657220881822,MATH 20C,A02,083761,Briones; Jor-el Thomas Caparas,8,0,35,27
1657220881822,MATH 20C,A03,093476,Briones; Jor-el Thomas Caparas,0,1,36,36
1657220881822,MATH 20C,B01,083762,Bach; Quang Tran,1,0,30,29
1657220887852,MATH 20D,A01,083765,Tran; Brian Kha,4,0,30,26
1657220887852,MATH 20D,A02,083766,Tran; Brian Kha,5,0,30,25
1657220887852,MATH 20D,A03,083767,Tran; Brian Kha,4,0,30,26
1657220893881,MATH 20E,A01,083771,Ganguly; Soumya,7,0,32,25
1657220893881,MATH 20E,A02,083772,Ganguly; Soumya,7,0,32,25
1657220893881,MATH 20E,B01,083773,Ciotti; Benjamin,19,0,35,16
1657220893881,MATH 20E,B02,083774,Ciotti; Benjamin,17,0,35,18
1657220899922,MATH 103A,A01,083777,Greenfeld; Be'Eri,2,0,36,34
1657220899922,MATH 103A,A02,083778,Greenfeld; Be'Eri,5,0,36,31
1657220899922,MATH 103A,A03,093561,Greenfeld; Be'Eri,4,0,36,32
1657220899922,MATH 103A,B01,083779,Greenfeld; Be'Eri,6,0,36,30
1657220899922,MATH 103A,B02,083780,Greenfeld; Be'Eri,3,0,36,33
1657220899922,MATH 103A,B03,093562,Greenfeld; Be'Eri,3,0,36,33
1657220905944,MATH 105,A01,085443,Carter; Anne Toulson,15,0,35,20
1657220905944,MATH 105,A02,093477,Carter; Anne Toulson,20,0,35,15
1657220911970,MATH 109,A01,083213,Ganzberger; Geoffrey Michael,2,0,34,32
1657220911970,MATH 109,A02,083214,Ganzberger; Geoffrey Michael,4,0,34,30
1657220911970,MATH 109,A03,093478,Ganzberger; Geoffrey Michael,2,0,34,32
1657220911970,MATH 109,B01,083215,Ganzberger; Geoffrey Michael,1,0,32,31
1657220911970,MATH 109,B02,083216,Ganzberger; Geoffrey Michael,1,0,32,31
1657220911970,MATH 109,B03,093479,Ganzberger; Geoffrey Michael,7,0,32,25
1657220918002,MATH 142A,A01,083219,Chow; Bennett,6,0,32,26
1657220918002,MATH 142A,A02,083220,Chow; Bennett,10,0,32,22
1657220918002,MATH 142A,A03,093480,Chow; Bennett,7,0,32,25
1657220918002,MATH 142A,B03,093481,Chow; Bennett,8,0,32,24
1657220918002,MATH 142A,B04,093558,Chow; Bennett,11,0,32,21
1657220918002,MATH 142A,B05,093559,Chow; Bennett,6,0,32,26
1657220924025,MATH 193A,A01,083224,Rotar; Vladimir,7,0,34,27
1657220924025,MATH 193A,A02,083225,Rotar; Vladimir,6,0,34,28
1657220924025,MATH 193A,A03,083781,Rotar; Vladimir,1,0,34,33
1657220924025,MATH 193A,A04,083782,Rotar; Vladimir,8,0,34,26
1657220924025,MATH 193A,A05,093482,Rotar; Vladimir,6,0,34,28
1657220930049,MATH 197,001,091859,McAuley; Julian John,9999,0,9999,0
1657220930049,MATH 197,002,095566,Kedlaya; Kiran S.,9997,0,9999,2
1657220930049,MATH 197,003,095567,Xiao; Ming,9999,0,9999,0
1657220930049,MATH 197,004,095571,Perols; Johan Lars,9998,0,9999,1
1657220937098,COGS 9,A01,083615,Shannon; Kyle Michael,8,0,75,67
1657220943123,COGS 11,A01,083617,Boyle; Mary E. T.,22,0,48,26
1657220949144,COGS 13,A01,083071,Bastos; Amalia Pinkusfeld,9,0,71,62
1657220955166,COGS 14A,A01,092681,Semenuks; Arturs,1,1,100,99
1657220961194,COGS 14B,A01,083073,Cheng; Tzu-Han,6,0,63,57
1657220967216,COGS 17,A01,092677,Semenuks; Arturs,5,0,81,76
1657220973243,COGS 100,A01,083619,Allen; Michael Gordon,15,0,70,55
1657220979265,COGS 101A,A01,083621,Davis; Joshua Daniel,9,0,68,59
1657220985290,COGS 101B,A01,091572,Allen; Michael Gordon,9,0,65,56
1657220991313,COGS 101C,A01,083625,Delgado; Tania,17,0,35,18
1657220997340,COGS 107A,A01,083627,Boyle; Mary E. T.,13,0,60,47
1657221003367,COGS 118A,A01,083075,Gupta; Anjum,16,0,76,60
1657221009394,CSE 3,A50,083646,Miranda; Gregory Joseph,24,0,50,26
1657221015417,CSE 8A,A50,083650,Miranda; Gregory Joseph,17,1,56,39
1657221021442,CSE 11,A01,083080,Cao; Yingjun,5,15,40,35
1657221027465,CSE 12,A01,083652,Krause-Levy; Sophia Louisa,24,1,120,96
1657221033488,CSE 15L,A01,083654,Morris; Justin Loren,9,0,50,41
1657221033488,CSE 15L,A02,083655,Morris; Justin Loren,9,0,50,41
1657221039515,CSE 20,A01,083657,Tran; Khoa Dang,38,0,80,42
1657221045621,CSE 21,A01,095574,Bach; Quang Tran,22,0,48,26
1657221051648,CSE 30,A01,083084,Eldon; John,4,0,80,76
1657221051648,CSE 30,B01,095061,Bhaskar; Nishant,8,0,50,42
1657221057669,CSE 100,A01,083659,Cao; Yingjun,4,4,70,66
1657221063699,CSE 134B,A01,083661,Powell; Thomas Allan,21,0,100,79
1657221069720,CSE 140,A01,083663,Gungor; Onat,13,0,85,72
1657221075745,CSE 140L,A01,083088,Eldon; John,17,0,100,83
1657221081768,CSE 175,A01,083665,Kumar; Rakesh,3,0,25,22
1657221087790,CSE 190,A00,092507,Dubnov; Shlomo,7,0,20,13
1657221093816,ECE 45,A01,083139,Congero; Spencer William,5,0,75,70
1657221099844,ECE 65,A50,083695,Saad; Andrew S,12,0,30,18
1657221099844,ECE 65,A51,095125,Saad; Andrew S,25,0,26,1
1657221105878,ECE 109,A01,091882,Touri; Behrouz,19,0,70,51
1657221111907,ECE 180,A00,083140,Abi Samra; Nicholas Camill,1,0,30,29
1657221111907,ECE 180,B00,083141,Abi Samra; Nicholas Camill,0,0,30,30
1657221117930,MATH 10A,A01,083735,Patchell; Gregory David,2,0,30,28
1657221117930,MATH 10A,A02,083736,Patchell; Gregory David,20,0,30,10
1657221117930,MATH 10A,A03,083737,Patchell; Gregory David,16,0,30,14
1657221123954,MATH 10B,A01,083207,Lim; Seonhee,7,0,34,27
1657221123954,MATH 10B,A02,083208,Lim; Seonhee,9,0,35,26
1657221123954,MATH 10B,A03,093472,Lim; Seonhee,5,0,34,29
1657221123954,MATH 10B,B01,083739,Sinha; Shubham,10,0,30,20
1657221129977,MATH 18,A01,083743,Cinel; Cameron Alexander,6,0,30,24
1657221129977,MATH 18,A02,083744,Cinel; Cameron Alexander,16,0,30,14
1657221129977,MATH 18,A03,083745,Cinel; Cameron Alexander,8,0,30,22
1657221129977,MATH 18,B01,083748,Rideout; David Porter,4,0,37,33
1657221129977,MATH 18,B02,083749,Rideout; David Porter,4,0,36,32
1657221129977,MATH 18,B03,083750,Rideout; David Porter,2,0,37,35
1657221129977,MATH 18,B04,083751,Rideout; David Porter,5,0,36,31
1657221129977,MATH 18,B05,093473,Rideout; David Porter,5,0,36,31
1657221129977,MATH 18,B06,093474,Rideout; David Porter,5,0,36,31
1657221136000,MATH 20A,A01,083754,Zheng; Zequn,14,0,40,26
1657221142027,MATH 20B,A01,083756,Briones; Jor-el Thomas Caparas,2,0,36,34
1657221142027,MATH 20B,A02,083757,Briones; Jor-el Thomas Caparas,1,0,36,35
1657221142027,MATH 20B,A03,093475,Briones; Jor-el Thomas Caparas,1,0,36,35
1657221148054,MATH 20C,A01,083760,Briones; Jor-el Thomas Caparas,1,0,35,34
1657221148054,MATH 20C,A02,083761,Briones; Jor-el Thomas Caparas,8,0,35,27
1657221148054,MATH 20C,A03,093476,Briones; Jor-el Thomas Caparas,0,1,36,36
1657221148054,MATH 20C,B01,083762,Bach; Quang Tran,1,0,30,29
1657221154077,MATH 20D,A01,083765,Tran; Brian Kha,4,0,30,26
1657221154077,MATH 20D,A02,083766,Tran; Brian Kha,5,0,30,25
1657221154077,MATH 20D,A03,083767,Tran; Brian Kha,4,0,30,26
1657221160100,MATH 20E,A01,083771,Ganguly; Soumya,7,0,32,25
1657221160100,MATH 20E,A02,083772,Ganguly; Soumya,7,0,32,25
1657221160100,MATH 20E,B01,083773,Ciotti; Benjamin,19,0,35,16
1657221160100,MATH 20E,B02,083774,Ciotti; Benjamin,17,0,35,18
1657221166130,MATH 103A,A01,083777,Greenfeld; Be'Eri,2,0,36,34
1657221166130,MATH 103A,A02,083778,Greenfeld; Be'Eri,5,0,36,31
1657221166130,MATH 103A,A03,093561,Greenfeld; Be'Eri,4,0,36,32
1657221166130,MATH 103A,B01,083779,Greenfeld; Be'Eri,6,0,36,30
1657221166130,MATH 103A,B02,083780,Greenfeld; Be'Eri,3,0,36,33
1657221166130,MATH 103A,B03,093562,Greenfeld; Be'Eri,3,0,36,33
1657221172169,MATH 105,A01,085443,Carter; Anne Toulson,15,0,35,20
1657221172169,MATH 105,A02,093477,Carter; Anne Toulson,20,0,35,15
1657221178202,MATH 109,A01,083213,Ganzberger; Geoffrey Michael,2,0,34,32
1657221178202,MATH 109,A02,083214,Ganzberger; Geoffrey Michael,4,0,34,30
1657221178202,MATH 109,A03,093478,Ganzberger; Geoffrey Michael,2,0,34,32
1657221178202,MATH 109,B01,083215,Ganzberger; Geoffrey Michael,1,0,32,31
1657221178202,MATH 109,B02,083216,Ganzberger; Geoffrey Michael,1,0,32,31
1657221178202,MATH 109,B03,093479,Ganzberger; Geoffrey Michael,7,0,32,25
1657221184233,MATH 142A,A01,083219,Chow; Bennett,6,0,32,26
1657221184233,MATH 142A,A02,083220,Chow; Bennett,10,0,32,22
1657221184233,MATH 142A,A03,093480,Chow; Bennett,7,0,32,25
1657221184233,MATH 142A,B03,093481,Chow; Bennett,8,0,32,24
1657221184233,MATH 142A,B04,093558,Chow; Bennett,11,0,32,21
1657221184233,MATH 142A,B05,093559,Chow; Bennett,6,0,32,26
1657221190255,MATH 193A,A01,083224,Rotar; Vladimir,7,0,34,27
1657221190255,MATH 193A,A02,083225,Rotar; Vladimir,6,0,34,28
1657221190255,MATH 193A,A03,083781,Rotar; Vladimir,1,0,34,33
1657221190255,MATH 193A,A04,083782,Rotar; Vladimir,8,0,34,26
1657221190255,MATH 193A,A05,093482,Rotar; Vladimir,6,0,34,28
1657221196296,MATH 197,001,091859,McAuley; Julian John,9999,0,9999,0
1657221196296,MATH 197,002,095566,Kedlaya; Kiran S.,9997,0,9999,2
1657221196296,MATH 197,003,095567,Xiao; Ming,9999,0,9999,0
1657221196296,MATH 197,004,095571,Perols; Johan Lars,9998,0,9999,1
1657221203345,COGS 9,A01,083615,Shannon; Kyle Michael,8,0,75,67
1657221209371,COGS 11,A01,083617,Boyle; Mary E. T.,22,0,48,26
1657221215398,COGS 13,A01,083071,Bastos; Amalia Pinkusfeld,9,0,71,62
1657221221423,COGS 14A,A01,092681,Semenuks; Arturs,1,1,100,99
1657221227453,COGS 14B,A01,083073,Cheng; Tzu-Han,6,0,63,57
1657221233481,COGS 17,A01,092677,Semenuks; Arturs,5,0,81,76
1657221239509,COGS 100,A01,083619,Allen; Michael Gordon,15,0,70,55
1657221245536,COGS 101A,A01,083621,Davis; Joshua Daniel,9,0,68,59
1657221251564,COGS 101B,A01,091572,Allen; Michael Gordon,9,0,65,56
1657221257588,COGS 101C,A01,083625,Delgado; Tania,17,0,35,18
1657221263613,COGS 107A,A01,083627,Boyle; Mary E. T.,13,0,60,47
1657221269637,COGS 118A,A01,083075,Gupta; Anjum,16,0,76,60
1657221275660,CSE 3,A50,083646,Miranda; Gregory Joseph,24,0,50,26
1657221281688,CSE 8A,A50,083650,Miranda; Gregory Joseph,17,1,56,39
1657221287714,CSE 11,A01,083080,Cao; Yingjun,5,15,40,35
1657221293749,CSE 12,A01,083652,Krause-Levy; Sophia Louisa,24,1,120,96
1657221299779,CSE 15L,A01,083654,Morris; Justin Loren,9,0,50,41
1657221299779,CSE 15L,A02,083655,Morris; Justin Loren,9,0,50,41
1657221305801,CSE 20,A01,083657,Tran; Khoa Dang,38,0,80,42
1657221311846,CSE 21,A01,095574,Bach; Quang Tran,22,0,48,26
1657221317869,CSE 30,A01,083084,Eldon; John,4,0,80,76
1657221317869,CSE 30,B01,095061,Bhaskar; Nishant,8,0,50,42
1657221323893,CSE 100,A01,083659,Cao; Yingjun,4,4,70,66
1657221329915,CSE 134B,A01,083661,Powell; Thomas Allan,21,0,100,79
1657221335950,CSE 140,A01,083663,Gungor; Onat,13,0,85,72
1657221341972,CSE 140L,A01,083088,Eldon; John,17,0,100,83
1657221348002,CSE 175,A01,083665,Kumar; Rakesh,3,0,25,22
1657221354037,CSE 190,A00,092507,Dubnov; Shlomo,7,0,20,13
1657221360061,ECE 45,A01,083139,Congero; Spencer William,5,0,75,70
1657221366085,ECE 65,A50,083695,Saad; Andrew S,12,0,30,18
1657221366085,ECE 65,A51,095125,Saad; Andrew S,25,0,26,1
1657221372112,ECE 109,A01,091882,Touri; Behrouz,19,0,70,51
1657221378135,ECE 180,A00,083140,Abi Samra; Nicholas Camill,1,0,30,29
1657221378135,ECE 180,B00,083141,Abi Samra; Nicholas Camill,0,0,30,30
1657221384157,MATH 10A,A01,083735,Patchell; Gregory David,2,0,30,28
1657221384157,MATH 10A,A02,083736,Patchell; Gregory David,20,0,30,10
1657221384157,MATH 10A,A03,083737,Patchell; Gregory David,16,0,30,14
1657221390185,MATH 10B,A01,083207,Lim; Seonhee,7,0,34,27
1657221390185,MATH 10B,A02,083208,Lim; Seonhee,9,0,35,26
1657221390185,MATH 10B,A03,093472,Lim; Seonhee,5,0,34,29
1657221390185,MATH 10B,B01,083739,Sinha; Shubham,10,0,30,20
1657221396222,MATH 18,A01,083743,Cinel; Cameron Alexander,6,0,30,24
1657221396222,MATH 18,A02,083744,Cinel; Cameron Alexander,16,0,30,14
1657221396222,MATH 18,A03,083745,Cinel; Cameron Alexander,8,0,30,22
1657221396222,MATH 18,B01,083748,Rideout; David Porter,4,0,37,33
1657221396222,MATH 18,B02,083749,Rideout; David Porter,4,0,36,32
1657221396222,MATH 18,B03,083750,Rideout; David Porter,2,0,37,35
1657221396222,MATH 18,B04,083751,Rideout; David Porter,5,0,36,31
1657221396222,MATH 18,B05,093473,Rideout; David Porter,5,0,36,31
1657221396222,MATH 18,B06,093474,Rideout; David Porter,5,0,36,31
1657221402251,MATH 20A,A01,083754,Zheng; Zequn,14,0,40,26
1657221408281,MATH 20B,A01,083756,Briones; Jor-el Thomas Caparas,2,0,36,34
1657221408281,MATH 20B,A02,083757,Briones; Jor-el Thomas Caparas,1,0,36,35
1657221408281,MATH 20B,A03,093475,Briones; Jor-el Thomas Caparas,1,0,36,35
1657221414316,MATH 20C,A01,083760,Briones; Jor-el Thomas Caparas,1,0,35,34
1657221414316,MATH 20C,A02,083761,Briones; Jor-el Thomas Caparas,8,0,35,27
1657221414316,MATH 20C,A03,093476,Briones; Jor-el Thomas Caparas,0,1,36,36
1657221414316,MATH 20C,B01,083762,Bach; Quang Tran,1,0,30,29
1657221420348,MATH 20D,A01,083765,Tran; Brian Kha,4,0,30,26
1657221420348,MATH 20D,A02,083766,Tran; Brian Kha,5,0,30,25
1657221420348,MATH 20D,A03,083767,Tran; Brian Kha,4,0,30,26
1657221426375,MATH 20E,A01,083771,Ganguly; Soumya,7,0,32,25
1657221426375,MATH 20E,A02,083772,Ganguly; Soumya,7,0,32,25
1657221426375,MATH 20E,B01,083773,Ciotti; Benjamin,19,0,35,16
1657221426375,MATH 20E,B02,083774,Ciotti; Benjamin,17,0,35,18
1657221432411,MATH 103A,A01,083777,Greenfeld; Be'Eri,2,0,36,34
1657221432411,MATH 103A,A02,083778,Greenfeld; Be'Eri,5,0,36,31
1657221432411,MATH 103A,A03,093561,Greenfeld; Be'Eri,4,0,36,32
1657221432411,MATH 103A,B01,083779,Greenfeld; Be'Eri,6,0,36,30
1657221432411,MATH 103A,B02,083780,Greenfeld; Be'Eri,3,0,36,33
1657221432411,MATH 103A,B03,093562,Greenfeld; Be'Eri,3,0,36,33
1657221438439,MATH 105,A01,085443,Carter; Anne Toulson,15,0,35,20
1657221438439,MATH 105,A02,093477,Carter; Anne Toulson,20,0,35,15
1657221444471,MATH 109,A01,083213,Ganzberger; Geoffrey Michael,2,0,34,32
1657221444471,MATH 109,A02,083214,Ganzberger; Geoffrey Michael,4,0,34,30
1657221444471,MATH 109,A03,093478,Ganzberger; Geoffrey Michael,2,0,34,32
1657221444471,MATH 109,B01,083215,Ganzberger; Geoffrey Michael,1,0,32,31
1657221444471,MATH 109,B02,083216,Ganzberger; Geoffrey Michael,1,0,32,31
1657221444471,MATH 109,B03,093479,Ganzberger; Geoffrey Michael,7,0,32,25
1657221450500,MATH 142A,A01,083219,Chow; Bennett,6,0,32,26
1657221450500,MATH 142A,A02,083220,Chow; Bennett,10,0,32,22
1657221450500,MATH 142A,A03,093480,Chow; Bennett,7,0,32,25
1657221450500,MATH 142A,B03,093481,Chow; Bennett,8,0,32,24
1657221450500,MATH 142A,B04,093558,Chow; Bennett,11,0,32,21
1657221450500,MATH 142A,B05,093559,Chow; Bennett,6,0,32,26
1657221456532,MATH 193A,A01,083224,Rotar; Vladimir,7,0,34,27
1657221456532,MATH 193A,A02,083225,Rotar; Vladimir,6,0,34,28
1657221456532,MATH 193A,A03,083781,Rotar; Vladimir,1,0,34,33
1657221456532,MATH 193A,A04,083782,Rotar; Vladimir,8,0,34,26
1657221456532,MATH 193A,A05,093482,Rotar; Vladimir,6,0,34,28
1657221462561,MATH 197,001,091859,McAuley; Julian John,9999,0,9999,0
1657221462561,MATH 197,002,095566,Kedlaya; Kiran S.,9997,0,9999,2
1657221462561,MATH 197,003,095567,Xiao; Ming,9999,0,9999,0
1657221462561,MATH 197,004,095571,Perols; Johan Lars,9998,0,9999,1
1657221469620,COGS 9,A01,083615,Shannon; Kyle Michael,8,0,75,67
1657221475642,COGS 11,A01,083617,Boyle; Mary E. T.,22,0,48,26
1657221481666,COGS 13,A01,083071,Bastos; Amalia Pinkusfeld,9,0,71,62
1657221487691,COGS 14A,A01,092681,Semenuks; Arturs,1,1,100,99
1657221493725,COGS 14B,A01,083073,Cheng; Tzu-Han,6,0,63,57
1657221499747,COGS 17,A01,092677,Semenuks; Arturs,5,0,81,76
1657221505770,COGS 100,A01,083619,Allen; Michael Gordon,15,0,70,55
1657221511801,COGS 101A,A01,083621,Davis; Joshua Daniel,9,0,68,59
1657221517835,COGS 101B,A01,091572,Allen; Michael Gordon,9,0,65,56
1657221523860,COGS 101C,A01,083625,Delgado; Tania,17,0,35,18
1657221529883,COGS 107A,A01,083627,Boyle; Mary E. T.,13,0,60,47
1657221535910,COGS 118A,A01,083075,Gupta; Anjum,16,0,76,60
1657221541937,CSE 3,A50,083646,Miranda; Gregory Joseph,24,0,50,26
1657221547959,CSE 8A,A50,083650,Miranda; Gregory Joseph,17,1,56,39
1657221553997,CSE 11,A01,083080,Cao; Yingjun,5,15,40,35
1657221560026,CSE 12,A01,083652,Krause-Levy; Sophia Louisa,24,1,120,96
1657221566051,CSE 15L,A01,083654,Morris; Justin Loren,9,0,50,41
1657221566051,CSE 15L,A02,083655,Morris; Justin Loren,9,0,50,41
1657221572076,CSE 20,A01,083657,Tran; Khoa Dang,38,0,80,42
1657221578100,CSE 21,A01,095574,Bach; Quang Tran,22,0,48,26
1657221584132,CSE 30,A01,083084,Eldon; John,4,0,80,76
1657221584132,CSE 30,B01,095061,Bhaskar; Nishant,8,0,50,42
1657221590156,CSE 100,A01,083659,Cao; Yingjun,4,4,70,66
1657221596178,CSE 134B,A01,083661,Powell; Thomas Allan,21,0,100,79
1657221602217,CSE 140,A01,083663,Gungor; Onat,13,0,85,72
1657221608243,CSE 140L,A01,083088,Eldon; John,17,0,100,83
1657221614271,CSE 175,A01,083665,Kumar; Rakesh,3,0,25,22
1657221620296,CSE 190,A00,092507,Dubnov; Shlomo,7,0,20,13
1657221626331,ECE 45,A01,083139,Congero; Spencer William,5,0,75,70
1657221632359,ECE 65,A50,083695,Saad; Andrew S,12,0,30,18
1657221632359,ECE 65,A51,095125,Saad; Andrew S,25,0,26,1
1657221638383,ECE 109,A01,091882,Touri; Behrouz,19,0,70,51
1657221644478,ECE 180,A00,083140,Abi Samra; Nicholas Camill,1,0,30,29
1657221644478,ECE 180,B00,083141,Abi Samra; Nicholas Camill,0,0,30,30
1657221650508,MATH 10A,A01,083735,Patchell; Gregory David,2,0,30,28
1657221650508,MATH 10A,A02,083736,Patchell; Gregory David,20,0,30,10
1657221650508,MATH 10A,A03,083737,Patchell; Gregory David,16,0,30,14
1657221656539,MATH 10B,A01,083207,Lim; Seonhee,7,0,34,27
1657221656539,MATH 10B,A02,083208,Lim; Seonhee,9,0,35,26
1657221656539,MATH 10B,A03,093472,Lim; Seonhee,5,0,34,29
1657221656539,MATH 10B,B01,083739,Sinha; Shubham,10,0,30,20
1657221662565,MATH 18,A01,083743,Cinel; Cameron Alexander,6,0,30,24
1657221662565,MATH 18,A02,083744,Cinel; Cameron Alexander,16,0,30,14
1657221662565,MATH 18,A03,083745,Cinel; Cameron Alexander,8,0,30,22
1657221662565,MATH 18,B01,083748,Rideout; David Porter,4,0,37,33
1657221662565,MATH 18,B02,083749,Rideout; David Porter,4,0,36,32
1657221662565,MATH 18,B03,083750,Rideout; David Porter,2,0,37,35
1657221662565,MATH 18,B04,083751,Rideout; David Porter,5,0,36,31
1657221662565,MATH 18,B05,093473,Rideout; David Porter,5,0,36,31
1657221662565,MATH 18,B06,093474,Rideout; David Porter,5,0,36,31
1657221668589,MATH 20A,A01,083754,Zheng; Zequn,14,0,40,26
1657221674620,MATH 20B,A01,083756,Briones; Jor-el Thomas Caparas,2,0,36,34
1657221674620,MATH 20B,A02,083757,Briones; Jor-el Thomas Caparas,1,0,36,35
1657221674620,MATH 20B,A03,093475,Briones; Jor-el Thomas Caparas,1,0,36,35
1657221680645,MATH 20C,A01,083760,Briones; Jor-el Thomas Caparas,1,0,35,34
1657221680645,MATH 20C,A02,083761,Briones; Jor-el Thomas Caparas,8,0,35,27
1657221680645,MATH 20C,A03,093476,Briones; Jor-el Thomas Caparas,0,1,36,36
1657221680645,MATH 20C,B01,083762,Bach; Quang Tran,1,0,30,29
1657221686672,MATH 20D,A01,083765,Tran; Brian Kha,4,0,30,26
1657221686672,MATH 20D,A02,083766,Tran; Brian Kha,5,0,30,25
1657221686672,MATH 20D,A03,083767,Tran; Brian Kha,4,0,30,26
1657221692703,MATH 20E,A01,083771,Ganguly; Soumya,7,0,32,25
1657221692703,MATH 20E,A02,083772,Ganguly; Soumya,7,0,32,25
1657221692703,MATH 20E,B01,083773,Ciotti; Benjamin,19,0,35,16
1657221692703,MATH 20E,B02,083774,Ciotti; Benjamin,17,0,35,18
1657221698741,MATH 103A,A01,083777,Greenfeld; Be'Eri,2,0,36,34
1657221698741,MATH 103A,A02,083778,Greenfeld; Be'Eri,5,0,36,31
1657221698741,MATH 103A,A03,093561,Greenfeld; Be'Eri,4,0,36,32
1657221698741,MATH 103A,B01,083779,Greenfeld; Be'Eri,6,0,36,30
1657221698741,MATH 103A,B02,083780,Greenfeld; Be'Eri,3,0,36,33
1657221698741,MATH 103A,B03,093562,Greenfeld; Be'Eri,3,0,36,33
1657221704768,MATH 105,A01,085443,Carter; Anne Toulson,15,0,35,20
1657221704768,MATH 105,A02,093477,Carter; Anne Toulson,20,0,35,15
1657221710797,MATH 109,A01,083213,Ganzberger; Geoffrey Michael,2,0,34,32
1657221710797,MATH 109,A02,083214,Ganzberger; Geoffrey Michael,4,0,34,30
1657221710797,MATH 109,A03,093478,Ganzberger; Geoffrey Michael,2,0,34,32
1657221710797,MATH 109,B01,083215,Ganzberger; Geoffrey Michael,1,0,32,31
1657221710797,MATH 109,B02,083216,Ganzberger; Geoffrey Michael,1,0,32,31
1657221710797,MATH 109,B03,093479,Ganzberger; Geoffrey Michael,7,0,32,25
1657221716826,MATH 142A,A01,083219,Chow; Bennett,6,0,32,26
1657221716826,MATH 142A,A02,083220,Chow; Bennett,10,0,32,22
1657221716826,MATH 142A,A03,093480,Chow; Bennett,7,0,32,25
1657221716826,MATH 142A,B03,093481,Chow; Bennett,8,0,32,24
1657221716826,MATH 142A,B04,093558,Chow; Bennett,11,0,32,21
1657221716826,MATH 142A,B05,093559,Chow; Bennett,6,0,32,26
1657221722850,MATH 193A,A01,083224,Rotar; Vladimir,7,0,34,27
1657221722850,MATH 193A,A02,083225,Rotar; Vladimir,6,0,34,28
1657221722850,MATH 193A,A03,083781,Rotar; Vladimir,1,0,34,33
1657221722850,MATH 193A,A04,083782,Rotar; Vladimir,8,0,34,26
1657221722850,MATH 193A,A05,093482,Rotar; Vladimir,6,0,34,28
1657221728884,MATH 197,001,091859,McAuley; Julian John,9999,0,9999,0
1657221728884,MATH 197,002,095566,Kedlaya; Kiran S.,9997,0,9999,2
1657221728884,MATH 197,003,095567,Xiao; Ming,9999,0,9999,0
1657221728884,MATH 197,004,095571,Perols; Johan Lars,9998,0,9999,1
1657221735936,COGS 9,A01,083615,Shannon; Kyle Michael,8,0,75,67
1657221741963,COGS 11,A01,083617,Boyle; Mary E. T.,22,0,48,26
1657221747989,COGS 13,A01,083071,Bastos; Amalia Pinkusfeld,9,0,71,62
1657221754010,COGS 14A,A01,092681,Semenuks; Arturs,1,1,100,99
1657221760040,COGS 14B,A01,083073,Cheng; Tzu-Han,6,0,63,57
1657221766062,COGS 17,A01,092677,Semenuks; Arturs,5,0,81,76
1657221772085,COGS 100,A01,083619,Allen; Michael Gordon,15,0,70,55
1657221778117,COGS 101A,A01,083621,Davis; Joshua Daniel,9,0,68,59
1657221784140,COGS 101B,A01,091572,Allen; Michael Gordon,9,0,65,56
1657221790166,COGS 101C,A01,083625,Delgado; Tania,17,0,35,18
1657221796189,COGS 107A,A01,083627,Boyle; Mary E. T.,13,0,60,47
1657221802217,COGS 118A,A01,083075,Gupta; Anjum,16,0,76,60
1657221808240,CSE 3,A50,083646,Miranda; Gregory Joseph,24,0,50,26
1657221814273,CSE 8A,A50,083650,Miranda; Gregory Joseph,17,1,56,39
1657221820295,CSE 11,A01,083080,Cao; Yingjun,5,15,40,35
1657221826330,CSE 12,A01,083652,Krause-Levy; Sophia Louisa,24,1,120,96
1657221832352,CSE 15L,A01,083654,Morris; Justin Loren,9,0,50,41
1657221832352,CSE 15L,A02,083655,Morris; Justin Loren,9,0,50,41
1657221838379,CSE 20,A01,083657,Tran; Khoa Dang,38,0,80,42
1657221844406,CSE 21,A01,095574,Bach; Quang Tran,22,0,48,26
1657221850429,CSE 30,A01,083084,Eldon; John,4,0,80,76
1657221850429,CSE 30,B01,095061,Bhaskar; Nishant,8,0,50,42
1657221856457,CSE 100,A01,083659,Cao; Yingjun,4,4,70,66
1657221862481,CSE 134B,A01,083661,Powell; Thomas Allan,21,0,100,79
1657221868507,CSE 140,A01,083663,Gungor; Onat,13,0,85,72
1657221874531,CSE 140L,A01,083088,Eldon; John,17,0,100,83
1657221880554,CSE 175,A01,083665,Kumar; Rakesh,3,0,25,22
1657221886575,CSE 190,A00,092507,Dubnov; Shlomo,7,0,20,13
1657221892603,ECE 45,A01,083139,Congero; Spencer William,5,0,75,70
1657221898625,ECE 65,A50,083695,Saad; Andrew S,12,0,30,18
1657221898625,ECE 65,A51,095125,Saad; Andrew S,25,0,26,1
1657221904649,ECE 109,A01,091882,Touri; Behrouz,19,0,70,51
1657221910672,ECE 180,A00,083140,Abi Samra; Nicholas Camill,1,0,30,29
1657221910672,ECE 180,B00,083141,Abi Samra; Nicholas Camill,0,0,30,30
1657221916700,MATH 10A,A01,083735,Patchell; Gregory David,2,0,30,28
1657221916700,MATH 10A,A02,083736,Patchell; Gregory David,20,0,30,10
1657221916700,MATH 10A,A03,083737,Patchell; Gregory David,16,0,30,14
1657221922727,MATH 10B,A01,083207,Lim; Seonhee,7,0,34,27
1657221922727,MATH 10B,A02,083208,Lim; Seonhee,9,0,35,26
1657221922727,MATH 10B,A03,093472,Lim; Seonhee,5,0,34,29
1657221922727,MATH 10B,B01,083739,Sinha; Shubham,10,0,30,20
1657221928755,MATH 18,A01,083743,Cinel; Cameron Alexander,6,0,30,24
1657221928755,MATH 18,A02,083744,Cinel; Cameron Alexander,16,0,30,14
1657221928755,MATH 18,A03,083745,Cinel; Cameron Alexander,8,0,30,22
1657221928755,MATH 18,B01,083748,Rideout; David Porter,4,0,37,33
1657221928755,MATH 18,B02,083749,Rideout; David Porter,4,0,36,32
1657221928755,MATH 18,B03,083750,Rideout; David Porter,2,0,37,35
1657221928755,MATH 18,B04,083751,Rideout; David Porter,5,0,36,31
1657221928755,MATH 18,B05,093473,Rideout; David Porter,5,0,36,31
1657221928755,MATH 18,B06,093474,Rideout; David Porter,5,0,36,31
1657221934777,MATH 20A,A01,083754,Zheng; Zequn,14,0,40,26
1657221940799,MATH 20B,A01,083756,Briones; Jor-el Thomas Caparas,2,0,36,34
1657221940799,MATH 20B,A02,083757,Briones; Jor-el Thomas Caparas,1,0,36,35
1657221940799,MATH 20B,A03,093475,Briones; Jor-el Thomas Caparas,1,0,36,35
1657221946840,MATH 20C,A01,083760,Briones; Jor-el Thomas Caparas,1,0,35,34
1657221946840,MATH 20C,A02,083761,Briones; Jor-el Thomas Caparas,8,0,35,27
1657221946840,MATH 20C,A03,093476,Briones; Jor-el Thomas Caparas,0,1,36,36
1657221946840,MATH 20C,B01,083762,Bach; Quang Tran,1,0,30,29
1657221952868,MATH 20D,A01,083765,Tran; Brian Kha,4,0,30,26
1657221952868,MATH 20D,A02,083766,Tran; Brian Kha,5,0,30,25
1657221952868,MATH 20D,A03,083767,Tran; Brian Kha,4,0,30,26
1657221958900,MATH 20E,A01,083771,Ganguly; Soumya,7,0,32,25
1657221958900,MATH 20E,A02,083772,Ganguly; Soumya,7,0,32,25
1657221958900,MATH 20E,B01,083773,Ciotti; Benjamin,19,0,35,16
1657221958900,MATH 20E,B02,083774,Ciotti; Benjamin,17,0,35,18
1657221964929,MATH 103A,A01,083777,Greenfeld; Be'Eri,2,0,36,34
1657221964929,MATH 103A,A02,083778,Greenfeld; Be'Eri,5,0,36,31
1657221964929,MATH 103A,A03,093561,Greenfeld; Be'Eri,4,0,36,32
1657221964929,MATH 103A,B01,083779,Greenfeld; Be'Eri,6,0,36,30
1657221964929,MATH 103A,B02,083780,Greenfeld; Be'Eri,3,0,36,33
1657221964929,MATH 103A,B03,093562,Greenfeld; Be'Eri,3,0,36,33
1657221970953,MATH 105,A01,085443,Carter; Anne Toulson,15,0,35,20
1657221970953,MATH 105,A02,093477,Carter; Anne Toulson,20,0,35,15
1657221976980,MATH 109,A01,083213,Ganzberger; Geoffrey Michael,2,0,34,32
1657221976980,MATH 109,A02,083214,Ganzberger; Geoffrey Michael,4,0,34,30
1657221976980,MATH 109,A03,093478,Ganzberger; Geoffrey Michael,2,0,34,32
1657221976980,MATH 109,B01,083215,Ganzberger; Geoffrey Michael,1,0,32,31
1657221976980,MATH 109,B02,083216,Ganzberger; Geoffrey Michael,1,0,32,31
1657221976980,MATH 109,B03,093479,Ganzberger; Geoffrey Michael,7,0,32,25
1657221983002,MATH 142A,A01,083219,Chow; Bennett,6,0,32,26
1657221983002,MATH 142A,A02,083220,Chow; Bennett,10,0,32,22
1657221983002,MATH 142A,A03,093480,Chow; Bennett,7,0,32,25
1657221983002,MATH 142A,B03,093481,Chow; Bennett,8,0,32,24
1657221983002,MATH 142A,B04,093558,Chow; Bennett,11,0,32,21
1657221983002,MATH 142A,B05,093559,Chow; Bennett,6,0,32,26
1657221989035,MATH 193A,A01,083224,Rotar; Vladimir,7,0,34,27
1657221989035,MATH 193A,A02,083225,Rotar; Vladimir,6,0,34,28
1657221989035,MATH 193A,A03,083781,Rotar; Vladimir,1,0,34,33
1657221989035,MATH 193A,A04,083782,Rotar; Vladimir,8,0,34,26
1657221989035,MATH 193A,A05,093482,Rotar; Vladimir,6,0,34,28
1657221995060,MATH 197,001,091859,McAuley; Julian John,9999,0,9999,0
1657221995060,MATH 197,002,095566,Kedlaya; Kiran S.,9997,0,9999,2
1657221995060,MATH 197,003,095567,Xiao; Ming,9999,0,9999,0
1657221995060,MATH 197,004,095571,Perols; Johan Lars,9998,0,9999,1
1657222002120,COGS 9,A01,083615,Shannon; Kyle Michael,8,0,75,67
1657222008149,COGS 11,A01,083617,Boyle; Mary E. T.,22,0,48,26
1657222014172,COGS 13,A01,083071,Bastos; Amalia Pinkusfeld,9,0,71,62
1657222020198,COGS 14A,A01,092681,Semenuks; Arturs,1,1,100,99
1657222026225,COGS 14B,A01,083073,Cheng; Tzu-Han,6,0,63,57
1657222032247,COGS 17,A01,092677,Semenuks; Arturs,5,0,81,76
1657222038272,COGS 100,A01,083619,Allen; Michael Gordon,15,0,70,55
1657222044300,COGS 101A,A01,083621,Davis; Joshua Daniel,9,0,68,59
1657222050332,COGS 101B,A01,091572,Allen; Michael Gordon,9,0,65,56
1657222056359,COGS 101C,A01,083625,Delgado; Tania,17,0,35,18
1657222062386,COGS 107A,A01,083627,Boyle; Mary E. T.,13,0,60,47
1657222068409,COGS 118A,A01,083075,Gupta; Anjum,16,0,76,60
1657222074432,CSE 3,A50,083646,Miranda; Gregory Joseph,24,0,50,26
1657222080459,CSE 8A,A50,083650,Miranda; Gregory Joseph,17,1,56,39
1657222086489,CSE 11,A01,083080,Cao; Yingjun,5,15,40,35
1657222092528,CSE 12,A01,083652,Krause-Levy; Sophia Louisa,24,1,120,96
1657222098555,CSE 15L,A01,083654,Morris; Justin Loren,9,0,50,41
1657222098555,CSE 15L,A02,083655,Morris; Justin Loren,9,0,50,41
1657222104577,CSE 20,A01,083657,Tran; Khoa Dang,38,0,80,42
1657222110600,CSE 21,A01,095574,Bach; Quang Tran,22,0,48,26
1657222116633,CSE 30,A01,083084,Eldon; John,4,0,80,76
1657222116633,CSE 30,B01,095061,Bhaskar; Nishant,8,0,50,42
1657222122656,CSE 100,A01,083659,Cao; Yingjun,4,4,70,66
1657222128683,CSE 134B,A01,083661,Powell; Thomas Allan,21,0,100,79
1657222134717,CSE 140,A01,083663,Gungor; Onat,13,0,85,72
1657222140739,CSE 140L,A01,083088,Eldon; John,17,0,100,83
1657222146761,CSE 175,A01,083665,Kumar; Rakesh,3,0,25,22
1657222152788,CSE 190,A00,092507,Dubnov; Shlomo,7,0,20,13
1657222158816,ECE 45,A01,083139,Congero; Spencer William,5,0,75,70
1657222164841,ECE 65,A50,083695,Saad; Andrew S,12,0,30,18
1657222164841,ECE 65,A51,095125,Saad; Andrew S,25,0,26,1
1657222170867,ECE 109,A01,091882,Touri; Behrouz,19,0,70,51
1657222176890,ECE 180,A00,083140,Abi Samra; Nicholas Camill,1,0,30,29
1657222176890,ECE 180,B00,083141,Abi Samra; Nicholas Camill,0,0,30,30
1657222182913,MATH 10A,A01,083735,Patchell; Gregory David,2,0,30,28
1657222182913,MATH 10A,A02,083736,Patchell; Gregory David,20,0,30,10
1657222182913,MATH 10A,A03,083737,Patchell; Gregory David,16,0,30,14
1657222188943,MATH 10B,A01,083207,Lim; Seonhee,7,0,34,27
1657222188943,MATH 10B,A02,083208,Lim; Seonhee,9,0,35,26
1657222188943,MATH 10B,A03,093472,Lim; Seonhee,5,0,34,29
1657222188943,MATH 10B,B01,083739,Sinha; Shubham,10,0,30,20
1657222194976,MATH 18,A01,083743,Cinel; Cameron Alexander,6,0,30,24
1657222194976,MATH 18,A02,083744,Cinel; Cameron Alexander,16,0,30,14
1657222194976,MATH 18,A03,083745,Cinel; Cameron Alexander,8,0,30,22
1657222194976,MATH 18,B01,083748,Rideout; David Porter,4,0,37,33
1657222194976,MATH 18,B02,083749,Rideout; David Porter,4,0,36,32
1657222194976,MATH 18,B03,083750,Rideout; David Porter,2,0,37,35
1657222194976,MATH 18,B04,083751,Rideout; David Porter,5,0,36,31
1657222194976,MATH 18,B05,093473,Rideout; David Porter,5,0,36,31
1657222194976,MATH 18,B06,093474,Rideout; David Porter,5,0,36,31
1657222201006,MATH 20A,A01,083754,Zheng; Zequn,14,0,40,26
1657222207034,MATH 20B,A01,083756,Briones; Jor-el Thomas Caparas,2,0,36,34
1657222207034,MATH 20B,A02,083757,Briones; Jor-el Thomas Caparas,1,0,36,35
1657222207034,MATH 20B,A03,093475,Briones; Jor-el Thomas Caparas,2,0,36,34
1657222213066,MATH 20C,A01,083760,Briones; Jor-el Thomas Caparas,1,0,35,34
1657222213066,MATH 20C,A02,083761,Briones; Jor-el Thomas Caparas,8,0,35,27
1657222213066,MATH 20C,A03,093476,Briones; Jor-el Thomas Caparas,0,1,36,36
1657222213066,MATH 20C,B01,083762,Bach; Quang Tran,1,0,30,29
1657222219094,MATH 20D,A01,083765,Tran; Brian Kha,4,0,30,26
1657222219094,MATH 20D,A02,083766,Tran; Brian Kha,5,0,30,25
1657222219094,MATH 20D,A03,083767,Tran; Brian Kha,4,0,30,26
1657222225122,MATH 20E,A01,083771,Ganguly; Soumya,7,0,32,25
1657222225122,MATH 20E,A02,083772,Ganguly; Soumya,7,0,32,25
1657222225122,MATH 20E,B01,083773,Ciotti; Benjamin,19,0,35,16
1657222225122,MATH 20E,B02,083774,Ciotti; Benjamin,17,0,35,18
1657222231147,MATH 103A,A01,083777,Greenfeld; Be'Eri,2,0,36,34
1657222231147,MATH 103A,A02,083778,Greenfeld; Be'Eri,5,0,36,31
1657222231147,MATH 103A,A03,093561,Greenfeld; Be'Eri,4,0,36,32
1657222231147,MATH 103A,B01,083779,Greenfeld; Be'Eri,6,0,36,30
1657222231147,MATH 103A,B02,083780,Greenfeld; Be'Eri,3,0,36,33
1657222231147,MATH 103A,B03,093562,Greenfeld; Be'Eri,3,0,36,33
1657222237172,MATH 105,A01,085443,Carter; Anne Toulson,15,0,35,20
1657222237172,MATH 105,A02,093477,Carter; Anne Toulson,20,0,35,15
1657222243292,MATH 109,A01,083213,Ganzberger; Geoffrey Michael,2,0,34,32
1657222243292,MATH 109,A02,083214,Ganzberger; Geoffrey Michael,4,0,34,30
1657222243292,MATH 109,A03,093478,Ganzberger; Geoffrey Michael,2,0,34,32
1657222243292,MATH 109,B01,083215,Ganzberger; Geoffrey Michael,1,0,32,31
1657222243292,MATH 109,B02,083216,Ganzberger; Geoffrey Michael,1,0,32,31
1657222243292,MATH 109,B03,093479,Ganzberger; Geoffrey Michael,7,0,32,25
1657222249335,MATH 142A,A01,083219,Chow; Bennett,6,0,32,26
1657222249335,MATH 142A,A02,083220,Chow; Bennett,10,0,32,22
1657222249335,MATH 142A,A03,093480,Chow; Bennett,7,0,32,25
1657222249335,MATH 142A,B03,093481,Chow; Bennett,8,0,32,24
1657222249335,MATH 142A,B04,093558,Chow; Bennett,11,0,32,21
1657222249335,MATH 142A,B05,093559,Chow; Bennett,6,0,32,26
1657222255357,MATH 193A,A01,083224,Rotar; Vladimir,7,0,34,27
1657222255357,MATH 193A,A02,083225,Rotar; Vladimir,6,0,34,28
1657222255357,MATH 193A,A03,083781,Rotar; Vladimir,1,0,34,33
1657222255357,MATH 193A,A04,083782,Rotar; Vladimir,8,0,34,26
1657222255357,MATH 193A,A05,093482,Rotar; Vladimir,6,0,34,28
1657222261381,MATH 197,001,091859,McAuley; Julian John,9999,0,9999,0
1657222261381,MATH 197,002,095566,Kedlaya; Kiran S.,9997,0,9999,2
1657222261381,MATH 197,003,095567,Xiao; Ming,9999,0,9999,0
1657222261381,MATH 197,004,095571,Perols; Johan Lars,9998,0,9999,1
1657222268439,COGS 9,A01,083615,Shannon; Kyle Michael,8,0,75,67
1657222274464,COGS 11,A01,083617,Boyle; Mary E. T.,22,0,48,26
1657222280489,COGS 13,A01,083071,Bastos; Amalia Pinkusfeld,9,0,71,62
1657222286515,COGS 14A,A01,092681,Semenuks; Arturs,1,1,100,99
1657222292543,COGS 14B,A01,083073,Cheng; Tzu-Han,6,0,63,57
1657222298568,COGS 17,A01,092677,Semenuks; Arturs,5,0,81,76
1657222304594,COGS 100,A01,083619,Allen; Michael Gordon,15,0,70,55
1657222310619,COGS 101A,A01,083621,Davis; Joshua Daniel,9,0,68,59
1657222316648,COGS 101B,A01,091572,Allen; Michael Gordon,9,0,65,56
1657222322675,COGS 101C,A01,083625,Delgado; Tania,17,0,35,18
1657222328699,COGS 107A,A01,083627,Boyle; Mary E. T.,13,0,60,47
1657222334723,COGS 118A,A01,083075,Gupta; Anjum,16,0,76,60
1657222340746,CSE 3,A50,083646,Miranda; Gregory Joseph,24,0,50,26
1657222346775,CSE 8A,A50,083650,Miranda; Gregory Joseph,17,1,56,39
1657222352802,CSE 11,A01,083080,Cao; Yingjun,5,15,40,35
1657222358829,CSE 12,A01,083652,Krause-Levy; Sophia Louisa,24,1,120,96
1657222364852,CSE 15L,A01,083654,Morris; Justin Loren,9,0,50,41
1657222364852,CSE 15L,A02,083655,Morris; Justin Loren,9,0,50,41
1657222370875,CSE 20,A01,083657,Tran; Khoa Dang,38,0,80,42
1657222376898,CSE 21,A01,095574,Bach; Quang Tran,22,0,48,26
1657222382921,CSE 30,A01,083084,Eldon; John,4,0,80,76
1657222382921,CSE 30,B01,095061,Bhaskar; Nishant,8,0,50,42
1657222388949,CSE 100,A01,083659,Cao; Yingjun,4,4,70,66
1657222394971,CSE 134B,A01,083661,Powell; Thomas Allan,21,0,100,79
1657222400993,CSE 140,A01,083663,Gungor; Onat,13,0,85,72
1657222407026,CSE 140L,A01,083088,Eldon; John,17,0,100,83
1657222413050,CSE 175,A01,083665,Kumar; Rakesh,3,0,25,22
1657222419073,CSE 190,A00,092507,Dubnov; Shlomo,7,0,20,13
1657222425101,ECE 45,A01,083139,Congero; Spencer William,5,0,75,70
1657222431125,ECE 65,A50,083695,Saad; Andrew S,12,0,30,18
1657222431125,ECE 65,A51,095125,Saad; Andrew S,25,0,26,1
1657222437151,ECE 109,A01,091882,Touri; Behrouz,19,0,70,51
1657222443178,ECE 180,A00,083140,Abi Samra; Nicholas Camill,1,0,30,29
1657222443178,ECE 180,B00,083141,Abi Samra; Nicholas Camill,0,0,30,30
1657222449219,MATH 10A,A01,083735,Patchell; Gregory David,2,0,30,28
1657222449219,MATH 10A,A02,083736,Patchell; Gregory David,20,0,30,10
1657222449219,MATH 10A,A03,083737,Patchell; Gregory David,16,0,30,14
1657222455249,MATH 10B,A01,083207,Lim; Seonhee,7,0,34,27
1657222455249,MATH 10B,A02,083208,Lim; Seonhee,9,0,35,26
1657222455249,MATH 10B,A03,093472,Lim; Seonhee,5,0,34,29
1657222455249,MATH 10B,B01,083739,Sinha; Shubham,10,0,30,20
1657222461279,MATH 18,A01,083743,Cinel; Cameron Alexander,6,0,30,24
1657222461279,MATH 18,A02,083744,Cinel; Cameron Alexander,16,0,30,14
1657222461279,MATH 18,A03,083745,Cinel; Cameron Alexander,8,0,30,22
1657222461279,MATH 18,B01,083748,Rideout; David Porter,4,0,37,33
1657222461279,MATH 18,B02,083749,Rideout; David Porter,4,0,36,32
1657222461279,MATH 18,B03,083750,Rideout; David Porter,2,0,37,35
1657222461279,MATH 18,B04,083751,Rideout; David Porter,5,0,36,31
1657222461279,MATH 18,B05,093473,Rideout; David Porter,5,0,36,31
1657222461279,MATH 18,B06,093474,Rideout; David Porter,5,0,36,31
1657222467309,MATH 20A,A01,083754,Zheng; Zequn,14,0,40,26
1657222473336,MATH 20B,A01,083756,Briones; Jor-el Thomas Caparas,2,0,36,34
1657222473336,MATH 20B,A02,083757,Briones; Jor-el Thomas Caparas,1,0,36,35
1657222473336,MATH 20B,A03,093475,Briones; Jor-el Thomas Caparas,2,0,36,34
1657222479363,MATH 20C,A01,083760,Briones; Jor-el Thomas Caparas,1,0,35,34
1657222479363,MATH 20C,A02,083761,Briones; Jor-el Thomas Caparas,8,0,35,27
1657222479363,MATH 20C,A03,093476,Briones; Jor-el Thomas Caparas,0,1,36,36
1657222479363,MATH 20C,B01,083762,Bach; Quang Tran,1,0,30,29
1657222485387,MATH 20D,A01,083765,Tran; Brian Kha,4,0,30,26
1657222485387,MATH 20D,A02,083766,Tran; Brian Kha,5,0,30,25
1657222485387,MATH 20D,A03,083767,Tran; Brian Kha,4,0,30,26
1657222491420,MATH 20E,A01,083771,Ganguly; Soumya,7,0,32,25
1657222491420,MATH 20E,A02,083772,Ganguly; Soumya,7,0,32,25
1657222491420,MATH 20E,B01,083773,Ciotti; Benjamin,19,0,35,16
1657222491420,MATH 20E,B02,083774,Ciotti; Benjamin,17,0,35,18
1657222497465,MATH 103A,A01,083777,Greenfeld; Be'Eri,2,0,36,34
1657222497465,MATH 103A,A02,083778,Greenfeld; Be'Eri,5,0,36,31
1657222497465,MATH 103A,A03,093561,Greenfeld; Be'Eri,4,0,36,32
1657222497465,MATH 103A,B01,083779,Greenfeld; Be'Eri,6,0,36,30
1657222497465,MATH 103A,B02,083780,Greenfeld; Be'Eri,3,0,36,33
1657222497465,MATH 103A,B03,093562,Greenfeld; Be'Eri,3,0,36,33
1657222503491,MATH 105,A01,085443,Carter; Anne Toulson,15,0,35,20
1657222503491,MATH 105,A02,093477,Carter; Anne Toulson,20,0,35,15
1657222509519,MATH 109,A01,083213,Ganzberger; Geoffrey Michael,2,0,34,32
1657222509519,MATH 109,A02,083214,Ganzberger; Geoffrey Michael,4,0,34,30
1657222509519,MATH 109,A03,093478,Ganzberger; Geoffrey Michael,2,0,34,32
1657222509519,MATH 109,B01,083215,Ganzberger; Geoffrey Michael,1,0,32,31
1657222509519,MATH 109,B02,083216,Ganzberger; Geoffrey Michael,1,0,32,31
1657222509519,MATH 109,B03,093479,Ganzberger; Geoffrey Michael,7,0,32,25
1657222515556,MATH 142A,A01,083219,Chow; Bennett,6,0,32,26
1657222515556,MATH 142A,A02,083220,Chow; Bennett,10,0,32,22
1657222515556,MATH 142A,A03,093480,Chow; Bennett,7,0,32,25
1657222515556,MATH 142A,B03,093481,Chow; Bennett,8,0,32,24
1657222515556,MATH 142A,B04,093558,Chow; Bennett,11,0,32,21
1657222515556,MATH 142A,B05,093559,Chow; Bennett,6,0,32,26
1657222521580,MATH 193A,A01,083224,Rotar; Vladimir,7,0,34,27
1657222521580,MATH 193A,A02,083225,Rotar; Vladimir,6,0,34,28
1657222521580,MATH 193A,A03,083781,Rotar; Vladimir,1,0,34,33
1657222521580,MATH 193A,A04,083782,Rotar; Vladimir,8,0,34,26
1657222521580,MATH 193A,A05,093482,Rotar; Vladimir,6,0,34,28
1657222527605,MATH 197,001,091859,McAuley; Julian John,9999,0,9999,0
1657222527605,MATH 197,002,095566,Kedlaya; Kiran S.,9997,0,9999,2
1657222527605,MATH 197,003,095567,Xiao; Ming,9999,0,9999,0
1657222527605,MATH 197,004,095571,Perols; Johan Lars,9998,0,9999,1
1657222534657,COGS 9,A01,083615,Shannon; Kyle Michael,8,0,75,67
1657222540679,COGS 11,A01,083617,Boyle; Mary E. T.,22,0,48,26
1657222546706,COGS 13,A01,083071,Bastos; Amalia Pinkusfeld,9,0,71,62
1657222552732,COGS 14A,A01,092681,Semenuks; Arturs,1,1,100,99
1657222558755,COGS 14B,A01,083073,Cheng; Tzu-Han,6,0,63,57
1657222564782,COGS 17,A01,092677,Semenuks; Arturs,5,0,81,76
1657222570806,COGS 100,A01,083619,Allen; Michael Gordon,15,0,70,55
1657222576829,COGS 101A,A01,083621,Davis; Joshua Daniel,9,0,68,59
1657222582853,COGS 101B,A01,091572,Allen; Michael Gordon,9,0,65,56
1657222588878,COGS 101C,A01,083625,Delgado; Tania,17,0,35,18
1657222594905,COGS 107A,A01,083627,Boyle; Mary E. T.,13,0,60,47
1657222600936,COGS 118A,A01,083075,Gupta; Anjum,16,0,76,60
1657222606959,CSE 3,A50,083646,Miranda; Gregory Joseph,24,0,50,26
1657222612984,CSE 8A,A50,083650,Miranda; Gregory Joseph,17,1,56,39
1657222619008,CSE 11,A01,083080,Cao; Yingjun,5,15,40,35
1657222625037,CSE 12,A01,083652,Krause-Levy; Sophia Louisa,24,1,120,96
1657222631067,CSE 15L,A01,083654,Morris; Justin Loren,9,0,50,41
1657222631067,CSE 15L,A02,083655,Morris; Justin Loren,9,0,50,41
1657222637094,CSE 20,A01,083657,Tran; Khoa Dang,38,0,80,42
1657222643117,CSE 21,A01,095574,Bach; Quang Tran,22,0,48,26
1657222649148,CSE 30,A01,083084,Eldon; John,4,0,80,76
1657222649148,CSE 30,B01,095061,Bhaskar; Nishant,8,0,50,42
1657222655175,CSE 100,A01,083659,Cao; Yingjun,4,4,70,66
1657222661199,CSE 134B,A01,083661,Powell; Thomas Allan,21,0,100,79
1657222667220,CSE 140,A01,083663,Gungor; Onat,13,0,85,72
1657222673243,CSE 140L,A01,083088,Eldon; John,17,0,100,83
1657222679267,CSE 175,A01,083665,Kumar; Rakesh,3,0,25,22
1657222685289,CSE 190,A00,092507,Dubnov; Shlomo,7,0,20,13
1657222691318,ECE 45,A01,083139,Congero; Spencer William,5,0,75,70
1657222697345,ECE 65,A50,083695,Saad; Andrew S,12,0,30,18
1657222697345,ECE 65,A51,095125,Saad; Andrew S,25,0,26,1
1657222703369,ECE 109,A01,091882,Touri; Behrouz,19,0,70,51
1657222709390,ECE 180,A00,083140,Abi Samra; Nicholas Camill,1,0,30,29
1657222709390,ECE 180,B00,083141,Abi Samra; Nicholas Camill,0,0,30,30
1657222715414,MATH 10A,A01,083735,Patchell; Gregory David,2,0,30,28
1657222715414,MATH 10A,A02,083736,Patchell; Gregory David,20,0,30,10
1657222715414,MATH 10A,A03,083737,Patchell; Gregory David,16,0,30,14
1657222721439,MATH 10B,A01,083207,Lim; Seonhee,7,0,34,27
1657222721439,MATH 10B,A02,083208,Lim; Seonhee,9,0,35,26
1657222721439,MATH 10B,A03,093472,Lim; Seonhee,5,0,34,29
1657222721439,MATH 10B,B01,083739,Sinha; Shubham,10,0,30,20
1657222727464,MATH 18,A01,083743,Cinel; Cameron Alexander,6,0,30,24
1657222727464,MATH 18,A02,083744,Cinel; Cameron Alexander,16,0,30,14
1657222727464,MATH 18,A03,083745,Cinel; Cameron Alexander,8,0,30,22
1657222727464,MATH 18,B01,083748,Rideout; David Porter,4,0,37,33
1657222727464,MATH 18,B02,083749,Rideout; David Porter,4,0,36,32
1657222727464,MATH 18,B03,083750,Rideout; David Porter,2,0,37,35
1657222727464,MATH 18,B04,083751,Rideout; David Porter,5,0,36,31
1657222727464,MATH 18,B05,093473,Rideout; David Porter,5,0,36,31
1657222727464,MATH 18,B06,093474,Rideout; David Porter,5,0,36,31
1657222733510,MATH 20A,A01,083754,Zheng; Zequn,14,0,40,26
1657222739541,MATH 20B,A01,083756,Briones; Jor-el Thomas Caparas,2,0,36,34
1657222739541,MATH 20B,A02,083757,Briones; Jor-el Thomas Caparas,1,0,36,35
1657222739541,MATH 20B,A03,093475,Briones; Jor-el Thomas Caparas,2,0,36,34
1657222745569,MATH 20C,A01,083760,Briones; Jor-el Thomas Caparas,1,0,35,34
1657222745569,MATH 20C,A02,083761,Briones; Jor-el Thomas Caparas,8,0,35,27
1657222745569,MATH 20C,A03,093476,Briones; Jor-el Thomas Caparas,0,1,36,36
1657222745569,MATH 20C,B01,083762,Bach; Quang Tran,1,0,30,29
1657222751598,MATH 20D,A01,083765,Tran; Brian Kha,4,0,30,26
1657222751598,MATH 20D,A02,083766,Tran; Brian Kha,5,0,30,25
1657222751598,MATH 20D,A03,083767,Tran; Brian Kha,4,0,30,26
1657222757623,MATH 20E,A01,083771,Ganguly; Soumya,7,0,32,25
1657222757623,MATH 20E,A02,083772,Ganguly; Soumya,7,0,32,25
1657222757623,MATH 20E,B01,083773,Ciotti; Benjamin,19,0,35,16
1657222757623,MATH 20E,B02,083774,Ciotti; Benjamin,17,0,35,18
1657222763647,MATH 103A,A01,083777,Greenfeld; Be'Eri,2,0,36,34
1657222763647,MATH 103A,A02,083778,Greenfeld; Be'Eri,5,0,36,31
1657222763647,MATH 103A,A03,093561,Greenfeld; Be'Eri,4,0,36,32
1657222763647,MATH 103A,B01,083779,Greenfeld; Be'Eri,6,0,36,30
1657222763647,MATH 103A,B02,083780,Greenfeld; Be'Eri,3,0,36,33
1657222763647,MATH 103A,B03,093562,Greenfeld; Be'Eri,3,0,36,33
1657222769669,MATH 105,A01,085443,Carter; Anne Toulson,15,0,35,20
1657222769669,MATH 105,A02,093477,Carter; Anne Toulson,20,0,35,15
1657222775698,MATH 109,A01,083213,Ganzberger; Geoffrey Michael,2,0,34,32
1657222775698,MATH 109,A02,083214,Ganzberger; Geoffrey Michael,4,0,34,30
1657222775698,MATH 109,A03,093478,Ganzberger; Geoffrey Michael,2,0,34,32
1657222775698,MATH 109,B01,083215,Ganzberger; Geoffrey Michael,1,0,32,31
1657222775698,MATH 109,B02,083216,Ganzberger; Geoffrey Michael,1,0,32,31
1657222775698,MATH 109,B03,093479,Ganzberger; Geoffrey Michael,7,0,32,25
1657222781723,MATH 142A,A01,083219,Chow; Bennett,6,0,32,26
1657222781723,MATH 142A,A02,083220,Chow; Bennett,10,0,32,22
1657222781723,MATH 142A,A03,093480,Chow; Bennett,7,0,32,25
1657222781723,MATH 142A,B03,093481,Chow; Bennett,8,0,32,24
1657222781723,MATH 142A,B04,093558,Chow; Bennett,11,0,32,21
1657222781723,MATH 142A,B05,093559,Chow; Bennett,6,0,32,26
1657222787746,MATH 193A,A01,083224,Rotar; Vladimir,7,0,34,27
1657222787746,MATH 193A,A02,083225,Rotar; Vladimir,6,0,34,28
1657222787746,MATH 193A,A03,083781,Rotar; Vladimir,1,0,34,33
1657222787746,MATH 193A,A04,083782,Rotar; Vladimir,8,0,34,26
1657222787746,MATH 193A,A05,093482,Rotar; Vladimir,6,0,34,28
1657222793776,MATH 197,001,091859,McAuley; Julian John,9999,0,9999,0
1657222793776,MATH 197,002,095566,Kedlaya; Kiran S.,9997,0,9999,2
1657222793776,MATH 197,003,095567,Xiao; Ming,9999,0,9999,0
1657222793776,MATH 197,004,095571,Perols; Johan Lars,9998,0,9999,1
1657222800837,COGS 9,A01,083615,Shannon; Kyle Michael,8,0,75,67
1657222806864,COGS 11,A01,083617,Boyle; Mary E. T.,22,0,48,26
1657222812891,COGS 13,A01,083071,Bastos; Amalia Pinkusfeld,9,0,71,62
1657222818918,COGS 14A,A01,092681,Semenuks; Arturs,1,1,100,99
1657222824943,COGS 14B,A01,083073,Cheng; Tzu-Han,6,0,63,57
1657222830967,COGS 17,A01,092677,Semenuks; Arturs,5,0,81,76
1657222837101,COGS 100,A01,083619,Allen; Michael Gordon,15,0,70,55
1657222843131,COGS 101A,A01,083621,Davis; Joshua Daniel,9,0,68,59
1657222849165,COGS 101B,A01,091572,Allen; Michael Gordon,9,0,65,56
1657222855195,COGS 101C,A01,083625,Delgado; Tania,17,0,35,18
1657222861223,COGS 107A,A01,083627,Boyle; Mary E. T.,13,0,60,47
1657222867249,COGS 118A,A01,083075,Gupta; Anjum,16,0,76,60
1657222873279,CSE 3,A50,083646,Miranda; Gregory Joseph,24,0,50,26
1657222879305,CSE 8A,A50,083650,Miranda; Gregory Joseph,17,1,56,39
1657222885333,CSE 11,A01,083080,Cao; Yingjun,5,15,40,35
1657222891360,CSE 12,A01,083652,Krause-Levy; Sophia Louisa,24,1,120,96
1657222897390,CSE 15L,A01,083654,Morris; Justin Loren,9,0,50,41
1657222897390,CSE 15L,A02,083655,Morris; Justin Loren,9,0,50,41
1657222903418,CSE 20,A01,083657,Tran; Khoa Dang,38,0,80,42
1657222909453,CSE 21,A01,095574,Bach; Quang Tran,22,0,48,26
1657222915476,CSE 30,A01,083084,Eldon; John,4,0,80,76
1657222915476,CSE 30,B01,095061,Bhaskar; Nishant,8,0,50,42
1657222921505,CSE 100,A01,083659,Cao; Yingjun,4,4,70,66
1657222941006,CSE 134B,A01,083661,Powell; Thomas Allan,21,0,100,79
1657222947031,CSE 140,A01,083663,Gungor; Onat,13,0,85,72
1657222953060,CSE 140L,A01,083088,Eldon; John,17,0,100,83
1657222959083,CSE 175,A01,083665,Kumar; Rakesh,3,0,25,22
1657222965108,CSE 190,A00,092507,Dubnov; Shlomo,7,0,20,13
1657222971131,ECE 45,A01,083139,Congero; Spencer William,5,0,75,70
1657222977158,ECE 65,A50,083695,Saad; Andrew S,12,0,30,18
1657222977158,ECE 65,A51,095125,Saad; Andrew S,25,0,26,1
1657222983186,ECE 109,A01,091882,Touri; Behrouz,19,0,70,51
1657222989209,ECE 180,A00,083140,Abi Samra; Nicholas Camill,1,0,30,29
1657222989209,ECE 180,B00,083141,Abi Samra; Nicholas Camill,0,0,30,30
1657222995236,MATH 10A,A01,083735,Patchell; Gregory David,2,0,30,28
1657222995236,MATH 10A,A02,083736,Patchell; Gregory David,20,0,30,10
1657222995236,MATH 10A,A03,083737,Patchell; Gregory David,16,0,30,14
1657223001269,MATH 10B,A01,083207,Lim; Seonhee,7,0,34,27
1657223001269,MATH 10B,A02,083208,Lim; Seonhee,9,0,35,26
1657223001269,MATH 10B,A03,093472,Lim; Seonhee,5,0,34,29
1657223001269,MATH 10B,B01,083739,Sinha; Shubham,10,0,30,20
1657223007295,MATH 18,A01,083743,Cinel; Cameron Alexander,6,0,30,24
1657223007295,MATH 18,A02,083744,Cinel; Cameron Alexander,16,0,30,14
1657223007295,MATH 18,A03,083745,Cinel; Cameron Alexander,8,0,30,22
1657223007295,MATH 18,B01,083748,Rideout; David Porter,4,0,37,33
1657223007295,MATH 18,B02,083749,Rideout; David Porter,4,0,36,32
1657223007295,MATH 18,B03,083750,Rideout; David Porter,2,0,37,35
1657223007295,MATH 18,B04,083751,Rideout; David Porter,5,0,36,31
1657223007295,MATH 18,B05,093473,Rideout; David Porter,5,0,36,31
1657223007295,MATH 18,B06,093474,Rideout; David Porter,5,0,36,31
1657223013321,MATH 20A,A01,083754,Zheng; Zequn,14,0,40,26
1657223019348,MATH 20B,A01,083756,Briones; Jor-el Thomas Caparas,2,0,36,34
1657223019348,MATH 20B,A02,083757,Briones; Jor-el Thomas Caparas,1,0,36,35
1657223019348,MATH 20B,A03,093475,Briones; Jor-el Thomas Caparas,2,0,36,34
1657223025377,MATH 20C,A01,083760,Briones; Jor-el Thomas Caparas,1,0,35,34
1657223025377,MATH 20C,A02,083761,Briones; Jor-el Thomas Caparas,8,0,35,27
1657223025377,MATH 20C,A03,093476,Briones; Jor-el Thomas Caparas,0,1,36,36
1657223025377,MATH 20C,B01,083762,Bach; Quang Tran,1,0,30,29
1657223031404,MATH 20D,A01,083765,Tran; Brian Kha,4,0,30,26
1657223031404,MATH 20D,A02,083766,Tran; Brian Kha,5,0,30,25
1657223031404,MATH 20D,A03,083767,Tran; Brian Kha,4,0,30,26
1657223037429,MATH 20E,A01,083771,Ganguly; Soumya,7,0,32,25
1657223037429,MATH 20E,A02,083772,Ganguly; Soumya,7,0,32,25
1657223037429,MATH 20E,B01,083773,Ciotti; Benjamin,19,0,35,16
1657223037429,MATH 20E,B02,083774,Ciotti; Benjamin,17,0,35,18
1657223043452,MATH 103A,A01,083777,Greenfeld; Be'Eri,2,0,36,34
1657223043452,MATH 103A,A02,083778,Greenfeld; Be'Eri,5,0,36,31
1657223043452,MATH 103A,A03,093561,Greenfeld; Be'Eri,4,0,36,32
1657223043452,MATH 103A,B01,083779,Greenfeld; Be'Eri,6,0,36,30
1657223043452,MATH 103A,B02,083780,Greenfeld; Be'Eri,3,0,36,33
1657223043452,MATH 103A,B03,093562,Greenfeld; Be'Eri,3,0,36,33
1657223049481,MATH 105,A01,085443,Carter; Anne Toulson,15,0,35,20
1657223049481,MATH 105,A02,093477,Carter; Anne Toulson,20,0,35,15
1657223055504,MATH 109,A01,083213,Ganzberger; Geoffrey Michael,2,0,34,32
1657223055504,MATH 109,A02,083214,Ganzberger; Geoffrey Michael,4,0,34,30
1657223055504,MATH 109,A03,093478,Ganzberger; Geoffrey Michael,2,0,34,32
1657223055504,MATH 109,B01,083215,Ganzberger; Geoffrey Michael,1,0,32,31
1657223055504,MATH 109,B02,083216,Ganzberger; Geoffrey Michael,1,0,32,31
1657223055504,MATH 109,B03,093479,Ganzberger; Geoffrey Michael,7,0,32,25
1657223061529,MATH 142A,A01,083219,Chow; Bennett,6,0,32,26
1657223061529,MATH 142A,A02,083220,Chow; Bennett,10,0,32,22
1657223061529,MATH 142A,A03,093480,Chow; Bennett,7,0,32,25
1657223061529,MATH 142A,B03,093481,Chow; Bennett,8,0,32,24
1657223061529,MATH 142A,B04,093558,Chow; Bennett,11,0,32,21
1657223061529,MATH 142A,B05,093559,Chow; Bennett,6,0,32,26
1657223067554,MATH 193A,A01,083224,Rotar; Vladimir,7,0,34,27
1657223067554,MATH 193A,A02,083225,Rotar; Vladimir,6,0,34,28
1657223067554,MATH 193A,A03,083781,Rotar; Vladimir,1,0,34,33
1657223067554,MATH 193A,A04,083782,Rotar; Vladimir,8,0,34,26
1657223067554,MATH 193A,A05,093482,Rotar; Vladimir,6,0,34,28
1657223073580,MATH 197,001,091859,McAuley; Julian John,9999,0,9999,0
1657223073580,MATH 197,002,095566,Kedlaya; Kiran S.,9997,0,9999,2
1657223073580,MATH 197,003,095567,Xiao; Ming,9999,0,9999,0
1657223073580,MATH 197,004,095571,Perols; Johan Lars,9998,0,9999,1
1657223080644,COGS 9,A01,083615,Shannon; Kyle Michael,8,0,75,67
1657223086671,COGS 11,A01,083617,Boyle; Mary E. T.,22,0,48,26
1657223092696,COGS 13,A01,083071,Bastos; Amalia Pinkusfeld,9,0,71,62
1657223098721,COGS 14A,A01,092681,Semenuks; Arturs,1,1,100,99
1657223104743,COGS 14B,A01,083073,Cheng; Tzu-Han,6,0,63,57
1657223110765,COGS 17,A01,092677,Semenuks; Arturs,5,0,81,76
1657223116791,COGS 100,A01,083619,Allen; Michael Gordon,15,0,70,55
1657223122814,COGS 101A,A01,083621,Davis; Joshua Daniel,9,0,68,59
1657223128839,COGS 101B,A01,091572,Allen; Michael Gordon,9,0,65,56
1657223134872,COGS 101C,A01,083625,Delgado; Tania,17,0,35,18
1657223140896,COGS 107A,A01,083627,Boyle; Mary E. T.,13,0,60,47
1657223146926,COGS 118A,A01,083075,Gupta; Anjum,16,0,76,60
1657223152961,CSE 3,A50,083646,Miranda; Gregory Joseph,24,0,50,26
1657223158987,CSE 8A,A50,083650,Miranda; Gregory Joseph,17,1,56,39
1657223165013,CSE 11,A01,083080,Cao; Yingjun,5,15,40,35
1657223171050,CSE 12,A01,083652,Krause-Levy; Sophia Louisa,24,1,120,96
1657223177076,CSE 15L,A01,083654,Morris; Justin Loren,9,0,50,41
1657223177076,CSE 15L,A02,083655,Morris; Justin Loren,9,0,50,41
1657223183101,CSE 20,A01,083657,Tran; Khoa Dang,38,0,80,42
1657223189128,CSE 21,A01,095574,Bach; Quang Tran,22,0,48,26
1657223195166,CSE 30,A01,083084,Eldon; John,4,0,80,76
1657223195166,CSE 30,B01,095061,Bhaskar; Nishant,8,0,50,42
1657223201192,CSE 100,A01,083659,Cao; Yingjun,4,4,70,66
1657223207217,CSE 134B,A01,083661,Powell; Thomas Allan,21,0,100,79
1657223213249,CSE 140,A01,083663,Gungor; Onat,13,0,85,72
1657223219273,CSE 140L,A01,083088,Eldon; John,17,0,100,83
1657223225300,CSE 175,A01,083665,Kumar; Rakesh,3,0,25,22
1657223231327,CSE 190,A00,092507,Dubnov; Shlomo,7,0,20,13
1657223237349,ECE 45,A01,083139,Congero; Spencer William,5,0,75,70
1657223243373,ECE 65,A50,083695,Saad; Andrew S,12,0,30,18
1657223243373,ECE 65,A51,095125,Saad; Andrew S,25,0,26,1
1657223249395,ECE 109,A01,091882,Touri; Behrouz,19,0,70,51
1657223255422,ECE 180,A00,083140,Abi Samra; Nicholas Camill,1,0,30,29
1657223255422,ECE 180,B00,083141,Abi Samra; Nicholas Camill,0,0,30,30
1657223261451,MATH 10A,A01,083735,Patchell; Gregory David,2,0,30,28
1657223261451,MATH 10A,A02,083736,Patchell; Gregory David,20,0,30,10
1657223261451,MATH 10A,A03,083737,Patchell; Gregory David,16,0,30,14
1657223267475,MATH 10B,A01,083207,Lim; Seonhee,7,0,34,27
1657223267475,MATH 10B,A02,083208,Lim; Seonhee,9,0,35,26
1657223267475,MATH 10B,A03,093472,Lim; Seonhee,5,0,34,29
1657223267475,MATH 10B,B01,083739,Sinha; Shubham,10,0,30,20
1657223273500,MATH 18,A01,083743,Cinel; Cameron Alexander,6,0,30,24
1657223273500,MATH 18,A02,083744,Cinel; Cameron Alexander,16,0,30,14
1657223273500,MATH 18,A03,083745,Cinel; Cameron Alexander,8,0,30,22
1657223273500,MATH 18,B01,083748,Rideout; David Porter,4,0,37,33
1657223273500,MATH 18,B02,083749,Rideout; David Porter,4,0,36,32
1657223273500,MATH 18,B03,083750,Rideout; David Porter,2,0,37,35
1657223273500,MATH 18,B04,083751,Rideout; David Porter,5,0,36,31
1657223273500,MATH 18,B05,093473,Rideout; David Porter,5,0,36,31
1657223273500,MATH 18,B06,093474,Rideout; David Porter,5,0,36,31
1657223279523,MATH 20A,A01,083754,Zheng; Zequn,14,0,40,26
1657223285551,MATH 20B,A01,083756,Briones; Jor-el Thomas Caparas,2,0,36,34
1657223285551,MATH 20B,A02,083757,Briones; Jor-el Thomas Caparas,1,0,36,35
1657223285551,MATH 20B,A03,093475,Briones; Jor-el Thomas Caparas,2,0,36,34
1657223291576,MATH 20C,A01,083760,Briones; Jor-el Thomas Caparas,1,0,35,34
1657223291576,MATH 20C,A02,083761,Briones; Jor-el Thomas Caparas,8,0,35,27
1657223291576,MATH 20C,A03,093476,Briones; Jor-el Thomas Caparas,0,1,36,36
1657223291576,MATH 20C,B01,083762,Bach; Quang Tran,1,0,30,29
1657223297603,MATH 20D,A01,083765,Tran; Brian Kha,4,0,30,26
1657223297603,MATH 20D,A02,083766,Tran; Brian Kha,5,0,30,25
1657223297603,MATH 20D,A03,083767,Tran; Brian Kha,4,0,30,26
1657223303636,MATH 20E,A01,083771,Ganguly; Soumya,7,0,32,25
1657223303636,MATH 20E,A02,083772,Ganguly; Soumya,7,0,32,25
1657223303636,MATH 20E,B01,083773,Ciotti; Benjamin,19,0,35,16
1657223303636,MATH 20E,B02,083774,Ciotti; Benjamin,17,0,35,18
1657223309659,MATH 103A,A01,083777,Greenfeld; Be'Eri,2,0,36,34
1657223309659,MATH 103A,A02,083778,Greenfeld; Be'Eri,5,0,36,31
1657223309659,MATH 103A,A03,093561,Greenfeld; Be'Eri,4,0,36,32
1657223309659,MATH 103A,B01,083779,Greenfeld; Be'Eri,6,0,36,30
1657223309659,MATH 103A,B02,083780,Greenfeld; Be'Eri,3,0,36,33
1657223309659,MATH 103A,B03,093562,Greenfeld; Be'Eri,3,0,36,33
1657223315697,MATH 105,A01,085443,Carter; Anne Toulson,15,0,35,20
1657223315697,MATH 105,A02,093477,Carter; Anne Toulson,20,0,35,15
1657223321720,MATH 109,A01,083213,Ganzberger; Geoffrey Michael,2,0,34,32
1657223321720,MATH 109,A02,083214,Ganzberger; Geoffrey Michael,4,0,34,30
1657223321720,MATH 109,A03,093478,Ganzberger; Geoffrey Michael,2,0,34,32
1657223321720,MATH 109,B01,083215,Ganzberger; Geoffrey Michael,1,0,32,31
1657223321720,MATH 109,B02,083216,Ganzberger; Geoffrey Michael,1,0,32,31
1657223321720,MATH 109,B03,093479,Ganzberger; Geoffrey Michael,7,0,32,25
1657223327742,MATH 142A,A01,083219,Chow; Bennett,6,0,32,26
1657223327742,MATH 142A,A02,083220,Chow; Bennett,10,0,32,22
1657223327742,MATH 142A,A03,093480,Chow; Bennett,7,0,32,25
1657223327742,MATH 142A,B03,093481,Chow; Bennett,8,0,32,24
1657223327742,MATH 142A,B04,093558,Chow; Bennett,11,0,32,21
1657223327742,MATH 142A,B05,093559,Chow; Bennett,6,0,32,26
1657223333785,MATH 193A,A01,083224,Rotar; Vladimir,7,0,34,27
1657223333785,MATH 193A,A02,083225,Rotar; Vladimir,6,0,34,28
1657223333785,MATH 193A,A03,083781,Rotar; Vladimir,1,0,34,33
1657223333785,MATH 193A,A04,083782,Rotar; Vladimir,8,0,34,26
1657223333785,MATH 193A,A05,093482,Rotar; Vladimir,6,0,34,28
1657223339809,MATH 197,001,091859,McAuley; Julian John,9999,0,9999,0
1657223339809,MATH 197,002,095566,Kedlaya; Kiran S.,9997,0,9999,2
1657223339809,MATH 197,003,095567,Xiao; Ming,9999,0,9999,0
1657223339809,MATH 197,004,095571,Perols; Johan Lars,9998,0,9999,1
1657223346863,COGS 9,A01,083615,Shannon; Kyle Michael,8,0,75,67
1657223352887,COGS 11,A01,083617,Boyle; Mary E. T.,22,0,48,26
1657223358911,COGS 13,A01,083071,Bastos; Amalia Pinkusfeld,9,0,71,62
1657223364936,COGS 14A,A01,092681,Semenuks; Arturs,1,1,100,99
1657223370970,COGS 14B,A01,083073,Cheng; Tzu-Han,6,0,63,57
1657223376992,COGS 17,A01,092677,Semenuks; Arturs,5,0,81,76
1657223383023,COGS 100,A01,083619,Allen; Michael Gordon,15,0,70,55
1657223389047,COGS 101A,A01,083621,Davis; Joshua Daniel,9,0,68,59
1657223395073,COGS 101B,A01,091572,Allen; Michael Gordon,9,0,65,56
1657223401101,COGS 101C,A01,083625,Delgado; Tania,17,0,35,18
1657223407128,COGS 107A,A01,083627,Boyle; Mary E. T.,13,0,60,47
1657223413153,COGS 118A,A01,083075,Gupta; Anjum,16,0,76,60
1657223419177,CSE 3,A50,083646,Miranda; Gregory Joseph,24,0,50,26
1657223425200,CSE 8A,A50,083650,Miranda; Gregory Joseph,17,1,56,39
1657223431229,CSE 11,A01,083080,Cao; Yingjun,5,15,40,35
1657223437252,CSE 12,A01,083652,Krause-Levy; Sophia Louisa,24,1,120,96
1657223443283,CSE 15L,A01,083654,Morris; Justin Loren,9,0,50,41
1657223443283,CSE 15L,A02,083655,Morris; Justin Loren,9,0,50,41
1657223449397,CSE 20,A01,083657,Tran; Khoa Dang,38,0,80,42
1657223455421,CSE 21,A01,095574,Bach; Quang Tran,22,0,48,26
1657223461447,CSE 30,A01,083084,Eldon; John,4,0,80,76
1657223461447,CSE 30,B01,095061,Bhaskar; Nishant,8,0,50,42
1657223467474,CSE 100,A01,083659,Cao; Yingjun,4,4,70,66
1657223473496,CSE 134B,A01,083661,Powell; Thomas Allan,21,0,100,79
1657223479519,CSE 140,A01,083663,Gungor; Onat,13,0,85,72
1657223485556,CSE 140L,A01,083088,Eldon; John,17,0,100,83
1657223491578,CSE 175,A01,083665,Kumar; Rakesh,3,0,25,22
1657223497600,CSE 190,A00,092507,Dubnov; Shlomo,7,0,20,13
1657223503626,ECE 45,A01,083139,Congero; Spencer William,5,0,75,70
1657223509647,ECE 65,A50,083695,Saad; Andrew S,12,0,30,18
1657223509647,ECE 65,A51,095125,Saad; Andrew S,25,0,26,1
1657223515669,ECE 109,A01,091882,Touri; Behrouz,19,0,70,51
1657223521696,ECE 180,A00,083140,Abi Samra; Nicholas Camill,1,0,30,29
1657223521696,ECE 180,B00,083141,Abi Samra; Nicholas Camill,0,0,30,30
1657223527724,MATH 10A,A01,083735,Patchell; Gregory David,2,0,30,28
1657223527724,MATH 10A,A02,083736,Patchell; Gregory David,20,0,30,10
1657223527724,MATH 10A,A03,083737,Patchell; Gregory David,16,0,30,14
1657223533747,MATH 10B,A01,083207,Lim; Seonhee,7,0,34,27
1657223533747,MATH 10B,A02,083208,Lim; Seonhee,9,0,35,26
1657223533747,MATH 10B,A03,093472,Lim; Seonhee,5,0,34,29
1657223533747,MATH 10B,B01,083739,Sinha; Shubham,10,0,30,20
1657223539773,MATH 18,A01,083743,Cinel; Cameron Alexander,6,0,30,24
1657223539773,MATH 18,A02,083744,Cinel; Cameron Alexander,16,0,30,14
1657223539773,MATH 18,A03,083745,Cinel; Cameron Alexander,8,0,30,22
1657223539773,MATH 18,B01,083748,Rideout; David Porter,4,0,37,33
1657223539773,MATH 18,B02,083749,Rideout; David Porter,4,0,36,32
1657223539773,MATH 18,B03,083750,Rideout; David Porter,2,0,37,35
1657223539773,MATH 18,B04,083751,Rideout; David Porter,5,0,36,31
1657223539773,MATH 18,B05,093473,Rideout; David Porter,5,0,36,31
1657223539773,MATH 18,B06,093474,Rideout; David Porter,5,0,36,31
1657223545796,MATH 20A,A01,083754,Zheng; Zequn,14,0,40,26
1657223551819,MATH 20B,A01,083756,Briones; Jor-el Thomas Caparas,2,0,36,34
1657223551819,MATH 20B,A02,083757,Briones; Jor-el Thomas Caparas,1,0,36,35
1657223551819,MATH 20B,A03,093475,Briones; Jor-el Thomas Caparas,2,0,36,34
1657223557846,MATH 20C,A01,083760,Briones; Jor-el Thomas Caparas,1,0,35,34
1657223557846,MATH 20C,A02,083761,Briones; Jor-el Thomas Caparas,8,0,35,27
1657223557846,MATH 20C,A03,093476,Briones; Jor-el Thomas Caparas,0,1,36,36
1657223557846,MATH 20C,B01,083762,Bach; Quang Tran,1,0,30,29
1657223563874,MATH 20D,A01,083765,Tran; Brian Kha,4,0,30,26
1657223563874,MATH 20D,A02,083766,Tran; Brian Kha,5,0,30,25
1657223563874,MATH 20D,A03,083767,Tran; Brian Kha,4,0,30,26
1657223569904,MATH 20E,A01,083771,Ganguly; Soumya,7,0,32,25
1657223569904,MATH 20E,A02,083772,Ganguly; Soumya,7,0,32,25
1657223569904,MATH 20E,B01,083773,Ciotti; Benjamin,19,0,35,16
1657223569904,MATH 20E,B02,083774,Ciotti; Benjamin,17,0,35,18
1657223575928,MATH 103A,A01,083777,Greenfeld; Be'Eri,2,0,36,34
1657223575928,MATH 103A,A02,083778,Greenfeld; Be'Eri,5,0,36,31
1657223575928,MATH 103A,A03,093561,Greenfeld; Be'Eri,4,0,36,32
1657223575928,MATH 103A,B01,083779,Greenfeld; Be'Eri,6,0,36,30
1657223575928,MATH 103A,B02,083780,Greenfeld; Be'Eri,3,0,36,33
1657223575928,MATH 103A,B03,093562,Greenfeld; Be'Eri,3,0,36,33
1657223581954,MATH 105,A01,085443,Carter; Anne Toulson,15,0,35,20
1657223581954,MATH 105,A02,093477,Carter; Anne Toulson,20,0,35,15
1657223587983,MATH 109,A01,083213,Ganzberger; Geoffrey Michael,2,0,34,32
1657223587983,MATH 109,A02,083214,Ganzberger; Geoffrey Michael,4,0,34,30
1657223587983,MATH 109,A03,093478,Ganzberger; Geoffrey Michael,2,0,34,32
1657223587983,MATH 109,B01,083215,Ganzberger; Geoffrey Michael,1,0,32,31
1657223587983,MATH 109,B02,083216,Ganzberger; Geoffrey Michael,1,0,32,31
1657223587983,MATH 109,B03,093479,Ganzberger; Geoffrey Michael,7,0,32,25
1657223594006,MATH 142A,A01,083219,Chow; Bennett,6,0,32,26
1657223594006,MATH 142A,A02,083220,Chow; Bennett,10,0,32,22
1657223594006,MATH 142A,A03,093480,Chow; Bennett,7,0,32,25
1657223594006,MATH 142A,B03,093481,Chow; Bennett,8,0,32,24
1657223594006,MATH 142A,B04,093558,Chow; Bennett,11,0,32,21
1657223594006,MATH 142A,B05,093559,Chow; Bennett,6,0,32,26
1657223600030,MATH 193A,A01,083224,Rotar; Vladimir,7,0,34,27
1657223600030,MATH 193A,A02,083225,Rotar; Vladimir,6,0,34,28
1657223600030,MATH 193A,A03,083781,Rotar; Vladimir,1,0,34,33
1657223600030,MATH 193A,A04,083782,Rotar; Vladimir,8,0,34,26
1657223600030,MATH 193A,A05,093482,Rotar; Vladimir,6,0,34,28
1657223606059,MATH 197,001,091859,McAuley; Julian John,9999,0,9999,0
1657223606059,MATH 197,002,095566,Kedlaya; Kiran S.,9997,0,9999,2
1657223606059,MATH 197,003,095567,Xiao; Ming,9999,0,9999,0
1657223606059,MATH 197,004,095571,Perols; Johan Lars,9998,0,9999,1
1657223613112,COGS 9,A01,083615,Shannon; Kyle Michael,8,0,75,67
1657223619139,COGS 11,A01,083617,Boyle; Mary E. T.,22,0,48,26
1657223625162,COGS 13,A01,083071,Bastos; Amalia Pinkusfeld,9,0,71,62
1657223631187,COGS 14A,A01,092681,Semenuks; Arturs,1,1,100,99
1657223637209,COGS 14B,A01,083073,Cheng; Tzu-Han,6,0,63,57
1657223643239,COGS 17,A01,092677,Semenuks; Arturs,5,0,81,76
1657223649261,COGS 100,A01,083619,Allen; Michael Gordon,15,0,70,55
1657223655289,COGS 101A,A01,083621,Davis; Joshua Daniel,9,0,68,59
1657223661316,COGS 101B,A01,091572,Allen; Michael Gordon,9,0,65,56
1657223667340,COGS 101C,A01,083625,Delgado; Tania,17,0,35,18
1657223673363,COGS 107A,A01,083627,Boyle; Mary E. T.,13,0,60,47
1657223679388,COGS 118A,A01,083075,Gupta; Anjum,16,0,76,60
1657223685413,CSE 3,A50,083646,Miranda; Gregory Joseph,24,0,50,26
1657223691442,CSE 8A,A50,083650,Miranda; Gregory Joseph,17,1,56,39
1657223697464,CSE 11,A01,083080,Cao; Yingjun,5,15,40,35
1657223703487,CSE 12,A01,083652,Krause-Levy; Sophia Louisa,24,1,120,96
1657223709515,CSE 15L,A01,083654,Morris; Justin Loren,9,0,50,41
1657223709515,CSE 15L,A02,083655,Morris; Justin Loren,9,0,50,41
1657223715545,CSE 20,A01,083657,Tran; Khoa Dang,38,0,80,42
1657223721594,CSE 21,A01,095574,Bach; Quang Tran,22,0,48,26
1657223727628,CSE 30,A01,083084,Eldon; John,4,0,80,76
1657223727628,CSE 30,B01,095061,Bhaskar; Nishant,8,0,50,42
1657223733653,CSE 100,A01,083659,Cao; Yingjun,4,4,70,66
1657223739677,CSE 134B,A01,083661,Powell; Thomas Allan,21,0,100,79
1657223745698,CSE 140,A01,083663,Gungor; Onat,13,0,85,72
1657223751723,CSE 140L,A01,083088,Eldon; John,17,0,100,83
1657223757748,CSE 175,A01,083665,Kumar; Rakesh,3,0,25,22
1657223763774,CSE 190,A00,092507,Dubnov; Shlomo,7,0,20,13
1657223769801,ECE 45,A01,083139,Congero; Spencer William,5,0,75,70
1657223775828,ECE 65,A50,083695,Saad; Andrew S,12,0,30,18
1657223775828,ECE 65,A51,095125,Saad; Andrew S,25,0,26,1
1657223781855,ECE 109,A01,091882,Touri; Behrouz,19,0,70,51
1657223787884,ECE 180,A00,083140,Abi Samra; Nicholas Camill,1,0,30,29
1657223787884,ECE 180,B00,083141,Abi Samra; Nicholas Camill,0,0,30,30
1657223793908,MATH 10A,A01,083735,Patchell; Gregory David,2,0,30,28
1657223793908,MATH 10A,A02,083736,Patchell; Gregory David,20,0,30,10
1657223793908,MATH 10A,A03,083737,Patchell; Gregory David,16,0,30,14
1657223799930,MATH 10B,A01,083207,Lim; Seonhee,7,0,34,27
1657223799930,MATH 10B,A02,083208,Lim; Seonhee,9,0,35,26
1657223799930,MATH 10B,A03,093472,Lim; Seonhee,5,0,34,29
1657223799930,MATH 10B,B01,083739,Sinha; Shubham,10,0,30,20
1657223805956,MATH 18,A01,083743,Cinel; Cameron Alexander,6,0,30,24
1657223805956,MATH 18,A02,083744,Cinel; Cameron Alexander,16,0,30,14
1657223805956,MATH 18,A03,083745,Cinel; Cameron Alexander,8,0,30,22
1657223805956,MATH 18,B01,083748,Rideout; David Porter,4,0,37,33
1657223805956,MATH 18,B02,083749,Rideout; David Porter,4,0,36,32
1657223805956,MATH 18,B03,083750,Rideout; David Porter,2,0,37,35
1657223805956,MATH 18,B04,083751,Rideout; David Porter,5,0,36,31
1657223805956,MATH 18,B05,093473,Rideout; David Porter,5,0,36,31
1657223805956,MATH 18,B06,093474,Rideout; David Porter,5,0,36,31
1657223811979,MATH 20A,A01,083754,Zheng; Zequn,14,0,40,26
1657223818006,MATH 20B,A01,083756,Briones; Jor-el Thomas Caparas,2,0,36,34
1657223818006,MATH 20B,A02,083757,Briones; Jor-el Thomas Caparas,1,0,36,35
1657223818006,MATH 20B,A03,093475,Briones; Jor-el Thomas Caparas,2,0,36,34
1657223824030,MATH 20C,A01,083760,Briones; Jor-el Thomas Caparas,1,0,35,34
1657223824030,MATH 20C,A02,083761,Briones; Jor-el Thomas Caparas,8,0,35,27
1657223824030,MATH 20C,A03,093476,Briones; Jor-el Thomas Caparas,0,1,36,36
1657223824030,MATH 20C,B01,083762,Bach; Quang Tran,1,0,30,29
1657223830052,MATH 20D,A01,083765,Tran; Brian Kha,4,0,30,26
1657223830052,MATH 20D,A02,083766,Tran; Brian Kha,5,0,30,25
1657223830052,MATH 20D,A03,083767,Tran; Brian Kha,4,0,30,26
1657223836074,MATH 20E,A01,083771,Ganguly; Soumya,7,0,32,25
1657223836074,MATH 20E,A02,083772,Ganguly; Soumya,7,0,32,25
1657223836074,MATH 20E,B01,083773,Ciotti; Benjamin,19,0,35,16
1657223836074,MATH 20E,B02,083774,Ciotti; Benjamin,17,0,35,18
1657223842099,MATH 103A,A01,083777,Greenfeld; Be'Eri,2,0,36,34
1657223842099,MATH 103A,A02,083778,Greenfeld; Be'Eri,5,0,36,31
1657223842099,MATH 103A,A03,093561,Greenfeld; Be'Eri,4,0,36,32
1657223842099,MATH 103A,B01,083779,Greenfeld; Be'Eri,6,0,36,30
1657223842099,MATH 103A,B02,083780,Greenfeld; Be'Eri,3,0,36,33
1657223842099,MATH 103A,B03,093562,Greenfeld; Be'Eri,3,0,36,33
1657223848138,MATH 105,A01,085443,Carter; Anne Toulson,15,0,35,20
1657223848138,MATH 105,A02,093477,Carter; Anne Toulson,20,0,35,15
1657223854171,MATH 109,A01,083213,Ganzberger; Geoffrey Michael,2,0,34,32
1657223854171,MATH 109,A02,083214,Ganzberger; Geoffrey Michael,4,0,34,30
1657223854171,MATH 109,A03,093478,Ganzberger; Geoffrey Michael,2,0,34,32
1657223854171,MATH 109,B01,083215,Ganzberger; Geoffrey Michael,1,0,32,31
1657223854171,MATH 109,B02,083216,Ganzberger; Geoffrey Michael,1,0,32,31
1657223854171,MATH 109,B03,093479,Ganzberger; Geoffrey Michael,7,0,32,25
1657223860202,MATH 142A,A01,083219,Chow; Bennett,6,0,32,26
1657223860202,MATH 142A,A02,083220,Chow; Bennett,10,0,32,22
1657223860202,MATH 142A,A03,093480,Chow; Bennett,7,0,32,25
1657223860202,MATH 142A,B03,093481,Chow; Bennett,8,0,32,24
1657223860202,MATH 142A,B04,093558,Chow; Bennett,11,0,32,21
1657223860202,MATH 142A,B05,093559,Chow; Bennett,6,0,32,26
1657223866231,MATH 193A,A01,083224,Rotar; Vladimir,7,0,34,27
1657223866231,MATH 193A,A02,083225,Rotar; Vladimir,6,0,34,28
1657223866231,MATH 193A,A03,083781,Rotar; Vladimir,1,0,34,33
1657223866231,MATH 193A,A04,083782,Rotar; Vladimir,8,0,34,26
1657223866231,MATH 193A,A05,093482,Rotar; Vladimir,6,0,34,28
1657223872253,MATH 197,001,091859,McAuley; Julian John,9999,0,9999,0
1657223872253,MATH 197,002,095566,Kedlaya; Kiran S.,9997,0,9999,2
1657223872253,MATH 197,003,095567,Xiao; Ming,9999,0,9999,0
1657223872253,MATH 197,004,095571,Perols; Johan Lars,9998,0,9999,1
1657223879320,COGS 9,A01,083615,Shannon; Kyle Michael,8,0,75,67
1657223885343,COGS 11,A01,083617,Boyle; Mary E. T.,22,0,48,26
1657223891365,COGS 13,A01,083071,Bastos; Amalia Pinkusfeld,9,0,71,62
1657223897398,COGS 14A,A01,092681,Semenuks; Arturs,1,1,100,99
1657223903420,COGS 14B,A01,083073,Cheng; Tzu-Han,6,0,63,57
1657223909456,COGS 17,A01,092677,Semenuks; Arturs,5,0,81,76
1657223915481,COGS 100,A01,083619,Allen; Michael Gordon,15,0,70,55
1657223921504,COGS 101A,A01,083621,Davis; Joshua Daniel,9,0,68,59
1657223927530,COGS 101B,A01,091572,Allen; Michael Gordon,9,0,65,56
1657223933557,COGS 101C,A01,083625,Delgado; Tania,17,0,35,18
1657223939583,COGS 107A,A01,083627,Boyle; Mary E. T.,13,0,60,47
1657223945622,COGS 118A,A01,083075,Gupta; Anjum,16,0,76,60
1657223951655,CSE 3,A50,083646,Miranda; Gregory Joseph,24,0,50,26
1657223957689,CSE 8A,A50,083650,Miranda; Gregory Joseph,17,1,56,39
1657223963715,CSE 11,A01,083080,Cao; Yingjun,5,15,40,35
1657223969738,CSE 12,A01,083652,Krause-Levy; Sophia Louisa,24,1,120,96
1657223975760,CSE 15L,A01,083654,Morris; Justin Loren,9,0,50,41
1657223975760,CSE 15L,A02,083655,Morris; Justin Loren,9,0,50,41
1657223981802,CSE 20,A01,083657,Tran; Khoa Dang,38,0,80,42
1657223987833,CSE 21,A01,095574,Bach; Quang Tran,22,0,48,26
1657223993854,CSE 30,A01,083084,Eldon; John,4,0,80,76
1657223993854,CSE 30,B01,095061,Bhaskar; Nishant,8,0,50,42
1657223999881,CSE 100,A01,083659,Cao; Yingjun,4,4,70,66
1657224005907,CSE 134B,A01,083661,Powell; Thomas Allan,21,0,100,79
1657224011929,CSE 140,A01,083663,Gungor; Onat,13,0,85,72
1657224017955,CSE 140L,A01,083088,Eldon; John,17,0,100,83
1657224023984,CSE 175,A01,083665,Kumar; Rakesh,3,0,25,22
1657224030014,CSE 190,A00,092507,Dubnov; Shlomo,7,0,20,13
1657224036036,ECE 45,A01,083139,Congero; Spencer William,5,0,75,70
1657224042068,ECE 65,A50,083695,Saad; Andrew S,12,0,30,18
1657224042068,ECE 65,A51,095125,Saad; Andrew S,25,0,26,1
1657224048170,ECE 109,A01,091882,Touri; Behrouz,19,0,70,51
1657224054197,ECE 180,A00,083140,Abi Samra; Nicholas Camill,1,0,30,29
1657224054197,ECE 180,B00,083141,Abi Samra; Nicholas Camill,0,0,30,30
1657224060220,MATH 10A,A01,083735,Patchell; Gregory David,2,0,30,28
1657224060220,MATH 10A,A02,083736,Patchell; Gregory David,20,0,30,10
1657224060220,MATH 10A,A03,083737,Patchell; Gregory David,16,0,30,14
1657224066247,MATH 10B,A01,083207,Lim; Seonhee,7,0,34,27
1657224066247,MATH 10B,A02,083208,Lim; Seonhee,9,0,35,26
1657224066247,MATH 10B,A03,093472,Lim; Seonhee,5,0,34,29
1657224066247,MATH 10B,B01,083739,Sinha; Shubham,10,0,30,20
1657224072271,MATH 18,A01,083743,Cinel; Cameron Alexander,6,0,30,24
1657224072271,MATH 18,A02,083744,Cinel; Cameron Alexander,16,0,30,14
1657224072271,MATH 18,A03,083745,Cinel; Cameron Alexander,8,0,30,22
1657224072271,MATH 18,B01,083748,Rideout; David Porter,4,0,37,33
1657224072271,MATH 18,B02,083749,Rideout; David Porter,4,0,36,32
1657224072271,MATH 18,B03,083750,Rideout; David Porter,2,0,37,35
1657224072271,MATH 18,B04,083751,Rideout; David Porter,5,0,36,31
1657224072271,MATH 18,B05,093473,Rideout; David Porter,5,0,36,31
1657224072271,MATH 18,B06,093474,Rideout; David Porter,5,0,36,31
1657224078294,MATH 20A,A01,083754,Zheng; Zequn,14,0,40,26
1657224084320,MATH 20B,A01,083756,Briones; Jor-el Thomas Caparas,2,0,36,34
1657224084320,MATH 20B,A02,083757,Briones; Jor-el Thomas Caparas,1,0,36,35
1657224084320,MATH 20B,A03,093475,Briones; Jor-el Thomas Caparas,2,0,36,34
1657224090344,MATH 20C,A01,083760,Briones; Jor-el Thomas Caparas,1,0,35,34
1657224090344,MATH 20C,A02,083761,Briones; Jor-el Thomas Caparas,8,0,35,27
1657224090344,MATH 20C,A03,093476,Briones; Jor-el Thomas Caparas,0,1,36,36
1657224090344,MATH 20C,B01,083762,Bach; Quang Tran,1,0,30,29
1657224096380,MATH 20D,A01,083765,Tran; Brian Kha,4,0,30,26
1657224096380,MATH 20D,A02,083766,Tran; Brian Kha,5,0,30,25
1657224096380,MATH 20D,A03,083767,Tran; Brian Kha,4,0,30,26
1657224102402,MATH 20E,A01,083771,Ganguly; Soumya,7,0,32,25
1657224102402,MATH 20E,A02,083772,Ganguly; Soumya,7,0,32,25
1657224102402,MATH 20E,B01,083773,Ciotti; Benjamin,19,0,35,16
1657224102402,MATH 20E,B02,083774,Ciotti; Benjamin,17,0,35,18
1657224108430,MATH 103A,A01,083777,Greenfeld; Be'Eri,2,0,36,34
1657224108430,MATH 103A,A02,083778,Greenfeld; Be'Eri,5,0,36,31
1657224108430,MATH 103A,A03,093561,Greenfeld; Be'Eri,4,0,36,32
1657224108430,MATH 103A,B01,083779,Greenfeld; Be'Eri,6,0,36,30
1657224108430,MATH 103A,B02,083780,Greenfeld; Be'Eri,3,0,36,33
1657224108430,MATH 103A,B03,093562,Greenfeld; Be'Eri,3,0,36,33
1657224114454,MATH 105,A01,085443,Carter; Anne Toulson,15,0,35,20
1657224114454,MATH 105,A02,093477,Carter; Anne Toulson,20,0,35,15
1657224120498,MATH 109,A01,083213,Ganzberger; Geoffrey Michael,2,0,34,32
1657224120498,MATH 109,A02,083214,Ganzberger; Geoffrey Michael,4,0,34,30
1657224120498,MATH 109,A03,093478,Ganzberger; Geoffrey Michael,2,0,34,32
1657224120498,MATH 109,B01,083215,Ganzberger; Geoffrey Michael,1,0,32,31
1657224120498,MATH 109,B02,083216,Ganzberger; Geoffrey Michael,1,0,32,31
1657224120498,MATH 109,B03,093479,Ganzberger; Geoffrey Michael,7,0,32,25
1657224126522,MATH 142A,A01,083219,Chow; Bennett,6,0,32,26
1657224126522,MATH 142A,A02,083220,Chow; Bennett,10,0,32,22
1657224126522,MATH 142A,A03,093480,Chow; Bennett,7,0,32,25
1657224126522,MATH 142A,B03,093481,Chow; Bennett,8,0,32,24
1657224126522,MATH 142A,B04,093558,Chow; Bennett,11,0,32,21
1657224126522,MATH 142A,B05,093559,Chow; Bennett,6,0,32,26
1657224132548,MATH 193A,A01,083224,Rotar; Vladimir,7,0,34,27
1657224132548,MATH 193A,A02,083225,Rotar; Vladimir,6,0,34,28
1657224132548,MATH 193A,A03,083781,Rotar; Vladimir,1,0,34,33
1657224132548,MATH 193A,A04,083782,Rotar; Vladimir,8,0,34,26
1657224132548,MATH 193A,A05,093482,Rotar; Vladimir,6,0,34,28
1657224138581,MATH 197,001,091859,McAuley; Julian John,9999,0,9999,0
1657224138581,MATH 197,002,095566,Kedlaya; Kiran S.,9997,0,9999,2
1657224138581,MATH 197,003,095567,Xiao; Ming,9999,0,9999,0
1657224138581,MATH 197,004,095571,Perols; Johan Lars,9998,0,9999,1
1657224145643,COGS 9,A01,083615,Shannon; Kyle Michael,8,0,75,67
1657224151667,COGS 11,A01,083617,Boyle; Mary E. T.,22,0,48,26
1657224157688,COGS 13,A01,083071,Bastos; Amalia Pinkusfeld,9,0,71,62
1657224163714,COGS 14A,A01,092681,Semenuks; Arturs,1,1,100,99
1657224169740,COGS 14B,A01,083073,Cheng; Tzu-Han,6,0,63,57
1657224175762,COGS 17,A01,092677,Semenuks; Arturs,5,0,81,76
1657224181783,COGS 100,A01,083619,Allen; Michael Gordon,15,0,70,55
1657224187809,COGS 101A,A01,083621,Davis; Joshua Daniel,9,0,68,59
1657224193835,COGS 101B,A01,091572,Allen; Michael Gordon,9,0,65,56
1657224199856,COGS 101C,A01,083625,Delgado; Tania,17,0,35,18
1657224205887,COGS 107A,A01,083627,Boyle; Mary E. T.,13,0,60,47
1657224211910,COGS 118A,A01,083075,Gupta; Anjum,16,0,76,60
1657224217933,CSE 3,A50,083646,Miranda; Gregory Joseph,24,0,50,26
1657224223956,CSE 8A,A50,083650,Miranda; Gregory Joseph,17,1,56,39
1657224229979,CSE 11,A01,083080,Cao; Yingjun,5,15,40,35
1657224236003,CSE 12,A01,083652,Krause-Levy; Sophia Louisa,24,1,120,96
1657224242027,CSE 15L,A01,083654,Morris; Justin Loren,9,0,50,41
1657224242027,CSE 15L,A02,083655,Morris; Justin Loren,9,0,50,41
1657224248052,CSE 20,A01,083657,Tran; Khoa Dang,38,0,80,42
1657224254076,CSE 21,A01,095574,Bach; Quang Tran,22,0,48,26
1657224260098,CSE 30,A01,083084,Eldon; John,4,0,80,76
1657224260098,CSE 30,B01,095061,Bhaskar; Nishant,8,0,50,42
1657224266122,CSE 100,A01,083659,Cao; Yingjun,4,4,70,66
1657224272160,CSE 134B,A01,083661,Powell; Thomas Allan,21,0,100,79
1657224278183,CSE 140,A01,083663,Gungor; Onat,13,0,85,72
1657224284212,CSE 140L,A01,083088,Eldon; John,17,0,100,83
1657224290247,CSE 175,A01,083665,Kumar; Rakesh,3,0,25,22
1657224296274,CSE 190,A00,092507,Dubnov; Shlomo,7,0,20,13
1657224302299,ECE 45,A01,083139,Congero; Spencer William,5,0,75,70
1657224308330,ECE 65,A50,083695,Saad; Andrew S,12,0,30,18
1657224308330,ECE 65,A51,095125,Saad; Andrew S,25,0,26,1
1657224314353,ECE 109,A01,091882,Touri; Behrouz,19,0,70,51
1657224320380,ECE 180,A00,083140,Abi Samra; Nicholas Camill,1,0,30,29
1657224320380,ECE 180,B00,083141,Abi Samra; Nicholas Camill,0,0,30,30
1657224326408,MATH 10A,A01,083735,Patchell; Gregory David,2,0,30,28
1657224326408,MATH 10A,A02,083736,Patchell; Gregory David,20,0,30,10
1657224326408,MATH 10A,A03,083737,Patchell; Gregory David,16,0,30,14
1657224332431,MATH 10B,A01,083207,Lim; Seonhee,7,0,34,27
1657224332431,MATH 10B,A02,083208,Lim; Seonhee,9,0,35,26
1657224332431,MATH 10B,A03,093472,Lim; Seonhee,5,0,34,29
1657224332431,MATH 10B,B01,083739,Sinha; Shubham,10,0,30,20
1657224338460,MATH 18,A01,083743,Cinel; Cameron Alexander,6,0,30,24
1657224338460,MATH 18,A02,083744,Cinel; Cameron Alexander,16,0,30,14
1657224338460,MATH 18,A03,083745,Cinel; Cameron Alexander,8,0,30,22
1657224338460,MATH 18,B01,083748,Rideout; David Porter,4,0,37,33
1657224338460,MATH 18,B02,083749,Rideout; David Porter,4,0,36,32
1657224338460,MATH 18,B03,083750,Rideout; David Porter,2,0,37,35
1657224338460,MATH 18,B04,083751,Rideout; David Porter,5,0,36,31
1657224338460,MATH 18,B05,093473,Rideout; David Porter,5,0,36,31
1657224338460,MATH 18,B06,093474,Rideout; David Porter,5,0,36,31
1657224344488,MATH 20A,A01,083754,Zheng; Zequn,14,0,40,26
1657224350517,MATH 20B,A01,083756,Briones; Jor-el Thomas Caparas,2,0,36,34
1657224350517,MATH 20B,A02,083757,Briones; Jor-el Thomas Caparas,1,0,36,35
1657224350517,MATH 20B,A03,093475,Briones; Jor-el Thomas Caparas,2,0,36,34
1657224356568,MATH 20C,A01,083760,Briones; Jor-el Thomas Caparas,1,0,35,34
1657224356568,MATH 20C,A02,083761,Briones; Jor-el Thomas Caparas,8,0,35,27
1657224356568,MATH 20C,A03,093476,Briones; Jor-el Thomas Caparas,0,1,36,36
1657224356568,MATH 20C,B01,083762,Bach; Quang Tran,1,0,30,29
1657224362601,MATH 20D,A01,083765,Tran; Brian Kha,4,0,30,26
1657224362601,MATH 20D,A02,083766,Tran; Brian Kha,5,0,30,25
1657224362601,MATH 20D,A03,083767,Tran; Brian Kha,4,0,30,26
1657224368633,MATH 20E,A01,083771,Ganguly; Soumya,7,0,32,25
1657224368633,MATH 20E,A02,083772,Ganguly; Soumya,7,0,32,25
1657224368633,MATH 20E,B01,083773,Ciotti; Benjamin,19,0,35,16
1657224368633,MATH 20E,B02,083774,Ciotti; Benjamin,17,0,35,18
1657224374657,MATH 103A,A01,083777,Greenfeld; Be'Eri,2,0,36,34
1657224374657,MATH 103A,A02,083778,Greenfeld; Be'Eri,5,0,36,31
1657224374657,MATH 103A,A03,093561,Greenfeld; Be'Eri,4,0,36,32
1657224374657,MATH 103A,B01,083779,Greenfeld; Be'Eri,6,0,36,30
1657224374657,MATH 103A,B02,083780,Greenfeld; Be'Eri,3,0,36,33
1657224374657,MATH 103A,B03,093562,Greenfeld; Be'Eri,3,0,36,33
1657224380680,MATH 105,A01,085443,Carter; Anne Toulson,15,0,35,20
1657224380680,MATH 105,A02,093477,Carter; Anne Toulson,20,0,35,15
1657224386713,MATH 109,A01,083213,Ganzberger; Geoffrey Michael,2,0,34,32
1657224386713,MATH 109,A02,083214,Ganzberger; Geoffrey Michael,4,0,34,30
1657224386713,MATH 109,A03,093478,Ganzberger; Geoffrey Michael,2,0,34,32
1657224386713,MATH 109,B01,083215,Ganzberger; Geoffrey Michael,1,0,32,31
1657224386713,MATH 109,B02,083216,Ganzberger; Geoffrey Michael,1,0,32,31
1657224386713,MATH 109,B03,093479,Ganzberger; Geoffrey Michael,7,0,32,25
1657224392738,MATH 142A,A01,083219,Chow; Bennett,6,0,32,26
1657224392738,MATH 142A,A02,083220,Chow; Bennett,10,0,32,22
1657224392738,MATH 142A,A03,093480,Chow; Bennett,7,0,32,25
1657224392738,MATH 142A,B03,093481,Chow; Bennett,8,0,32,24
1657224392738,MATH 142A,B04,093558,Chow; Bennett,11,0,32,21
1657224392738,MATH 142A,B05,093559,Chow; Bennett,6,0,32,26
1657224398767,MATH 193A,A01,083224,Rotar; Vladimir,7,0,34,27
1657224398767,MATH 193A,A02,083225,Rotar; Vladimir,6,0,34,28
1657224398767,MATH 193A,A03,083781,Rotar; Vladimir,1,0,34,33
1657224398767,MATH 193A,A04,083782,Rotar; Vladimir,8,0,34,26
1657224398767,MATH 193A,A05,093482,Rotar; Vladimir,6,0,34,28
1657224404793,MATH 197,001,091859,McAuley; Julian John,9999,0,9999,0
1657224404793,MATH 197,002,095566,Kedlaya; Kiran S.,9997,0,9999,2
1657224404793,MATH 197,003,095567,Xiao; Ming,9999,0,9999,0
1657224404793,MATH 197,004,095571,Perols; Johan Lars,9998,0,9999,1
1657224411846,COGS 9,A01,083615,Shannon; Kyle Michael,8,0,75,67
1657224417872,COGS 11,A01,083617,Boyle; Mary E. T.,22,0,48,26
1657224423898,COGS 13,A01,083071,Bastos; Amalia Pinkusfeld,9,0,71,62
1657224429919,COGS 14A,A01,092681,Semenuks; Arturs,1,1,100,99
1657224435943,COGS 14B,A01,083073,Cheng; Tzu-Han,6,0,63,57
1657224441967,COGS 17,A01,092677,Semenuks; Arturs,5,0,81,76
1657224447992,COGS 100,A01,083619,Allen; Michael Gordon,15,0,70,55
1657224454019,COGS 101A,A01,083621,Davis; Joshua Daniel,9,0,68,59
1657224460041,COGS 101B,A01,091572,Allen; Michael Gordon,9,0,65,56
1657224466067,COGS 101C,A01,083625,Delgado; Tania,17,0,35,18
1657224472089,COGS 107A,A01,083627,Boyle; Mary E. T.,13,0,60,47
1657224478115,COGS 118A,A01,083075,Gupta; Anjum,16,0,76,60
1657224484139,CSE 3,A50,083646,Miranda; Gregory Joseph,24,0,50,26
1657224490164,CSE 8A,A50,083650,Miranda; Gregory Joseph,17,1,56,39
1657224496187,CSE 11,A01,083080,Cao; Yingjun,5,15,40,35
1657224502210,CSE 12,A01,083652,Krause-Levy; Sophia Louisa,24,1,120,96
1657224508238,CSE 15L,A01,083654,Morris; Justin Loren,9,0,50,41
1657224508238,CSE 15L,A02,083655,Morris; Justin Loren,9,0,50,41
1657224514269,CSE 20,A01,083657,Tran; Khoa Dang,38,0,80,42
1657224520296,CSE 21,A01,095574,Bach; Quang Tran,22,0,48,26
1657224526325,CSE 30,A01,083084,Eldon; John,4,0,80,76
1657224526325,CSE 30,B01,095061,Bhaskar; Nishant,8,0,50,42
1657224532350,CSE 100,A01,083659,Cao; Yingjun,4,4,70,66
1657224538376,CSE 134B,A01,083661,Powell; Thomas Allan,21,0,100,79
1657224544400,CSE 140,A01,083663,Gungor; Onat,13,0,85,72
1657224550424,CSE 140L,A01,083088,Eldon; John,17,0,100,83
1657224556447,CSE 175,A01,083665,Kumar; Rakesh,3,0,25,22
1657224562473,CSE 190,A00,092507,Dubnov; Shlomo,7,0,20,13
1657224568500,ECE 45,A01,083139,Congero; Spencer William,5,0,75,70
1657224574528,ECE 65,A50,083695,Saad; Andrew S,12,0,30,18
1657224574528,ECE 65,A51,095125,Saad; Andrew S,25,0,26,1
1657224580550,ECE 109,A01,091882,Touri; Behrouz,19,0,70,51
1657224586572,ECE 180,A00,083140,Abi Samra; Nicholas Camill,1,0,30,29
1657224586572,ECE 180,B00,083141,Abi Samra; Nicholas Camill,0,0,30,30
1657224592595,MATH 10A,A01,083735,Patchell; Gregory David,2,0,30,28
1657224592595,MATH 10A,A02,083736,Patchell; Gregory David,20,0,30,10
1657224592595,MATH 10A,A03,083737,Patchell; Gregory David,16,0,30,14
1657224598617,MATH 10B,A01,083207,Lim; Seonhee,7,0,34,27
1657224598617,MATH 10B,A02,083208,Lim; Seonhee,9,0,35,26
1657224598617,MATH 10B,A03,093472,Lim; Seonhee,5,0,34,29
1657224598617,MATH 10B,B01,083739,Sinha; Shubham,10,0,30,20
1657224604640,MATH 18,A01,083743,Cinel; Cameron Alexander,6,0,30,24
1657224604640,MATH 18,A02,083744,Cinel; Cameron Alexander,16,0,30,14
1657224604640,MATH 18,A03,083745,Cinel; Cameron Alexander,8,0,30,22
1657224604640,MATH 18,B01,083748,Rideout; David Porter,4,0,37,33
1657224604640,MATH 18,B02,083749,Rideout; David Porter,4,0,36,32
1657224604640,MATH 18,B03,083750,Rideout; David Porter,2,0,37,35
1657224604640,MATH 18,B04,083751,Rideout; David Porter,5,0,36,31
1657224604640,MATH 18,B05,093473,Rideout; David Porter,5,0,36,31
1657224604640,MATH 18,B06,093474,Rideout; David Porter,5,0,36,31
1657224610667,MATH 20A,A01,083754,Zheng; Zequn,14,0,40,26
1657224616689,MATH 20B,A01,083756,Briones; Jor-el Thomas Caparas,2,0,36,34
1657224616689,MATH 20B,A02,083757,Briones; Jor-el Thomas Caparas,1,0,36,35
1657224616689,MATH 20B,A03,093475,Briones; Jor-el Thomas Caparas,2,0,36,34
1657224622717,MATH 20C,A01,083760,Briones; Jor-el Thomas Caparas,1,0,35,34
1657224622717,MATH 20C,A02,083761,Briones; Jor-el Thomas Caparas,8,0,35,27
1657224622717,MATH 20C,A03,093476,Briones; Jor-el Thomas Caparas,0,1,36,36
1657224622717,MATH 20C,B01,083762,Bach; Quang Tran,1,0,30,29
1657224628743,MATH 20D,A01,083765,Tran; Brian Kha,4,0,30,26
1657224628743,MATH 20D,A02,083766,Tran; Brian Kha,5,0,30,25
1657224628743,MATH 20D,A03,083767,Tran; Brian Kha,4,0,30,26
1657224634765,MATH 20E,A01,083771,Ganguly; Soumya,7,0,32,25
1657224634765,MATH 20E,A02,083772,Ganguly; Soumya,7,0,32,25
1657224634765,MATH 20E,B01,083773,Ciotti; Benjamin,19,0,35,16
1657224634765,MATH 20E,B02,083774,Ciotti; Benjamin,17,0,35,18
1657224640795,MATH 103A,A01,083777,Greenfeld; Be'Eri,2,0,36,34
1657224640795,MATH 103A,A02,083778,Greenfeld; Be'Eri,5,0,36,31
1657224640795,MATH 103A,A03,093561,Greenfeld; Be'Eri,4,0,36,32
1657224640795,MATH 103A,B01,083779,Greenfeld; Be'Eri,6,0,36,30
1657224640795,MATH 103A,B02,083780,Greenfeld; Be'Eri,3,0,36,33
1657224640795,MATH 103A,B03,093562,Greenfeld; Be'Eri,3,0,36,33
1657224646894,MATH 105,A01,085443,Carter; Anne Toulson,15,0,35,20
1657224646894,MATH 105,A02,093477,Carter; Anne Toulson,20,0,35,15
1657224652923,MATH 109,A01,083213,Ganzberger; Geoffrey Michael,2,0,34,32
1657224652923,MATH 109,A02,083214,Ganzberger; Geoffrey Michael,4,0,34,30
1657224652923,MATH 109,A03,093478,Ganzberger; Geoffrey Michael,2,0,34,32
1657224652923,MATH 109,B01,083215,Ganzberger; Geoffrey Michael,1,0,32,31
1657224652923,MATH 109,B02,083216,Ganzberger; Geoffrey Michael,1,0,32,31
1657224652923,MATH 109,B03,093479,Ganzberger; Geoffrey Michael,7,0,32,25
1657224658947,MATH 142A,A01,083219,Chow; Bennett,6,0,32,26
1657224658947,MATH 142A,A02,083220,Chow; Bennett,10,0,32,22
1657224658947,MATH 142A,A03,093480,Chow; Bennett,7,0,32,25
1657224658947,MATH 142A,B03,093481,Chow; Bennett,8,0,32,24
1657224658947,MATH 142A,B04,093558,Chow; Bennett,11,0,32,21
1657224658947,MATH 142A,B05,093559,Chow; Bennett,6,0,32,26
1657224664984,MATH 193A,A01,083224,Rotar; Vladimir,7,0,34,27
1657224664984,MATH 193A,A02,083225,Rotar; Vladimir,6,0,34,28
1657224664984,MATH 193A,A03,083781,Rotar; Vladimir,1,0,34,33
1657224664984,MATH 193A,A04,083782,Rotar; Vladimir,8,0,34,26
1657224664984,MATH 193A,A05,093482,Rotar; Vladimir,6,0,34,28
1657224671010,MATH 197,001,091859,McAuley; Julian John,9999,0,9999,0
1657224671010,MATH 197,002,095566,Kedlaya; Kiran S.,9997,0,9999,2
1657224671010,MATH 197,003,095567,Xiao; Ming,9999,0,9999,0
1657224671010,MATH 197,004,095571,Perols; Johan Lars,9998,0,9999,1
1657224678076,COGS 9,A01,083615,Shannon; Kyle Michael,8,0,75,67
1657224684106,COGS 11,A01,083617,Boyle; Mary E. T.,22,0,48,26
1657224690132,COGS 13,A01,083071,Bastos; Amalia Pinkusfeld,9,0,71,62
1657224696156,COGS 14A,A01,092681,Semenuks; Arturs,1,1,100,99
1657224702192,COGS 14B,A01,083073,Cheng; Tzu-Han,6,0,63,57
1657224708222,COGS 17,A01,092677,Semenuks; Arturs,5,0,81,76
1657224714249,COGS 100,A01,083619,Allen; Michael Gordon,15,0,70,55
1657224720275,COGS 101A,A01,083621,Davis; Joshua Daniel,9,0,68,59
1657224726298,COGS 101B,A01,091572,Allen; Michael Gordon,9,0,65,56
1657224732324,COGS 101C,A01,083625,Delgado; Tania,17,0,35,18
1657224738348,COGS 107A,A01,083627,Boyle; Mary E. T.,13,0,60,47
1657224744372,COGS 118A,A01,083075,Gupta; Anjum,16,0,76,60
1657224750401,CSE 3,A50,083646,Miranda; Gregory Joseph,24,0,50,26
1657224756424,CSE 8A,A50,083650,Miranda; Gregory Joseph,17,1,56,39
1657224762448,CSE 11,A01,083080,Cao; Yingjun,5,15,40,35
1657224768471,CSE 12,A01,083652,Krause-Levy; Sophia Louisa,24,1,120,96
1657224774496,CSE 15L,A01,083654,Morris; Justin Loren,9,0,50,41
1657224774496,CSE 15L,A02,083655,Morris; Justin Loren,9,0,50,41
1657224780522,CSE 20,A01,083657,Tran; Khoa Dang,38,0,80,42
1657224786546,CSE 21,A01,095574,Bach; Quang Tran,22,0,48,26
1657224792569,CSE 30,A01,083084,Eldon; John,4,0,80,76
1657224792569,CSE 30,B01,095061,Bhaskar; Nishant,8,0,50,42
1657224798599,CSE 100,A01,083659,Cao; Yingjun,4,4,70,66
1657224804632,CSE 134B,A01,083661,Powell; Thomas Allan,21,0,100,79
1657224810655,CSE 140,A01,083663,Gungor; Onat,13,0,85,72
1657224816683,CSE 140L,A01,083088,Eldon; John,17,0,100,83
1657224822709,CSE 175,A01,083665,Kumar; Rakesh,3,0,25,22
1657224828736,CSE 190,A00,092507,Dubnov; Shlomo,7,0,20,13
1657224834760,ECE 45,A01,083139,Congero; Spencer William,5,0,75,70
1657224840787,ECE 65,A50,083695,Saad; Andrew S,12,0,30,18
1657224840787,ECE 65,A51,095125,Saad; Andrew S,25,0,26,1
1657224846811,ECE 109,A01,091882,Touri; Behrouz,19,0,70,51
1657224852835,ECE 180,A00,083140,Abi Samra; Nicholas Camill,1,0,30,29
1657224852835,ECE 180,B00,083141,Abi Samra; Nicholas Camill,0,0,30,30
1657224858858,MATH 10A,A01,083735,Patchell; Gregory David,2,0,30,28
1657224858858,MATH 10A,A02,083736,Patchell; Gregory David,20,0,30,10
1657224858858,MATH 10A,A03,083737,Patchell; Gregory David,16,0,30,14
1657224864883,MATH 10B,A01,083207,Lim; Seonhee,7,0,34,27
1657224864883,MATH 10B,A02,083208,Lim; Seonhee,9,0,35,26
1657224864883,MATH 10B,A03,093472,Lim; Seonhee,5,0,34,29
1657224864883,MATH 10B,B01,083739,Sinha; Shubham,10,0,30,20
1657224870908,MATH 18,A01,083743,Cinel; Cameron Alexander,6,0,30,24
1657224870908,MATH 18,A02,083744,Cinel; Cameron Alexander,16,0,30,14
1657224870908,MATH 18,A03,083745,Cinel; Cameron Alexander,8,0,30,22
1657224870908,MATH 18,B01,083748,Rideout; David Porter,4,0,37,33
1657224870908,MATH 18,B02,083749,Rideout; David Porter,4,0,36,32
1657224870908,MATH 18,B03,083750,Rideout; David Porter,2,0,37,35
1657224870908,MATH 18,B04,083751,Rideout; David Porter,5,0,36,31
1657224870908,MATH 18,B05,093473,Rideout; David Porter,5,0,36,31
1657224870908,MATH 18,B06,093474,Rideout; David Porter,5,0,36,31
1657224876936,MATH 20A,A01,083754,Zheng; Zequn,14,0,40,26
1657224882959,MATH 20B,A01,083756,Briones; Jor-el Thomas Caparas,2,0,36,34
1657224882959,MATH 20B,A02,083757,Briones; Jor-el Thomas Caparas,1,0,36,35
1657224882959,MATH 20B,A03,093475,Briones; Jor-el Thomas Caparas,2,0,36,34
1657224888995,MATH 20C,A01,083760,Briones; Jor-el Thomas Caparas,1,0,35,34
1657224888995,MATH 20C,A02,083761,Briones; Jor-el Thomas Caparas,8,0,35,27
1657224888995,MATH 20C,A03,093476,Briones; Jor-el Thomas Caparas,0,1,36,36
1657224888995,MATH 20C,B01,083762,Bach; Quang Tran,1,0,30,29
1657224895023,MATH 20D,A01,083765,Tran; Brian Kha,4,0,30,26
1657224895023,MATH 20D,A02,083766,Tran; Brian Kha,5,0,30,25
1657224895023,MATH 20D,A03,083767,Tran; Brian Kha,4,0,30,26
1657224901047,MATH 20E,A01,083771,Ganguly; Soumya,7,0,32,25
1657224901047,MATH 20E,A02,083772,Ganguly; Soumya,7,0,32,25
1657224901047,MATH 20E,B01,083773,Ciotti; Benjamin,19,0,35,16
1657224901047,MATH 20E,B02,083774,Ciotti; Benjamin,17,0,35,18
1657224907076,MATH 103A,A01,083777,Greenfeld; Be'Eri,2,0,36,34
1657224907076,MATH 103A,A02,083778,Greenfeld; Be'Eri,5,0,36,31
1657224907076,MATH 103A,A03,093561,Greenfeld; Be'Eri,4,0,36,32
1657224907076,MATH 103A,B01,083779,Greenfeld; Be'Eri,6,0,36,30
1657224907076,MATH 103A,B02,083780,Greenfeld; Be'Eri,3,0,36,33
1657224907076,MATH 103A,B03,093562,Greenfeld; Be'Eri,3,0,36,33
1657224913098,MATH 105,A01,085443,Carter; Anne Toulson,15,0,35,20
1657224913098,MATH 105,A02,093477,Carter; Anne Toulson,20,0,35,15
1657224919123,MATH 109,A01,083213,Ganzberger; Geoffrey Michael,2,0,34,32
1657224919123,MATH 109,A02,083214,Ganzberger; Geoffrey Michael,4,0,34,30
1657224919123,MATH 109,A03,093478,Ganzberger; Geoffrey Michael,2,0,34,32
1657224919123,MATH 109,B01,083215,Ganzberger; Geoffrey Michael,1,0,32,31
1657224919123,MATH 109,B02,083216,Ganzberger; Geoffrey Michael,1,0,32,31
1657224919123,MATH 109,B03,093479,Ganzberger; Geoffrey Michael,7,0,32,25
1657224925152,MATH 142A,A01,083219,Chow; Bennett,6,0,32,26
1657224925152,MATH 142A,A02,083220,Chow; Bennett,10,0,32,22
1657224925152,MATH 142A,A03,093480,Chow; Bennett,7,0,32,25
1657224925152,MATH 142A,B03,093481,Chow; Bennett,8,0,32,24
1657224925152,MATH 142A,B04,093558,Chow; Bennett,11,0,32,21
1657224925152,MATH 142A,B05,093559,Chow; Bennett,6,0,32,26
1657224931181,MATH 193A,A01,083224,Rotar; Vladimir,7,0,34,27
1657224931181,MATH 193A,A02,083225,Rotar; Vladimir,6,0,34,28
1657224931181,MATH 193A,A03,083781,Rotar; Vladimir,1,0,34,33
1657224931181,MATH 193A,A04,083782,Rotar; Vladimir,8,0,34,26
1657224931181,MATH 193A,A05,093482,Rotar; Vladimir,6,0,34,28
1657224937207,MATH 197,001,091859,McAuley; Julian John,9999,0,9999,0
1657224937207,MATH 197,002,095566,Kedlaya; Kiran S.,9997,0,9999,2
1657224937207,MATH 197,003,095567,Xiao; Ming,9999,0,9999,0
1657224937207,MATH 197,004,095571,Perols; Johan Lars,9998,0,9999,1
1657224944266,COGS 9,A01,083615,Shannon; Kyle Michael,8,0,75,67
1657224950300,COGS 11,A01,083617,Boyle; Mary E. T.,22,0,48,26
1657224956327,COGS 13,A01,083071,Bastos; Amalia Pinkusfeld,9,0,71,62
1657224962349,COGS 14A,A01,092681,Semenuks; Arturs,1,1,100,99
1657224968377,COGS 14B,A01,083073,Cheng; Tzu-Han,6,0,63,57
1657224974401,COGS 17,A01,092677,Semenuks; Arturs,5,0,81,76
1657224980427,COGS 100,A01,083619,Allen; Michael Gordon,15,0,70,55
1657224986458,COGS 101A,A01,083621,Davis; Joshua Daniel,9,0,68,59
1657224992489,COGS 101B,A01,091572,Allen; Michael Gordon,9,0,65,56
1657224998514,COGS 101C,A01,083625,Delgado; Tania,17,0,35,18
1657225004537,COGS 107A,A01,083627,Boyle; Mary E. T.,13,0,60,47
1657225010564,COGS 118A,A01,083075,Gupta; Anjum,16,0,76,60
1657225016591,CSE 3,A50,083646,Miranda; Gregory Joseph,24,0,50,26
1657225022614,CSE 8A,A50,083650,Miranda; Gregory Joseph,17,1,56,39
1657225028648,CSE 11,A01,083080,Cao; Yingjun,5,15,40,35
1657225034678,CSE 12,A01,083652,Krause-Levy; Sophia Louisa,24,1,120,96
1657225040701,CSE 15L,A01,083654,Morris; Justin Loren,9,0,50,41
1657225040701,CSE 15L,A02,083655,Morris; Justin Loren,9,0,50,41
1657225046731,CSE 20,A01,083657,Tran; Khoa Dang,38,0,80,42
1657225052753,CSE 21,A01,095574,Bach; Quang Tran,22,0,48,26
1657225058775,CSE 30,A01,083084,Eldon; John,4,0,80,76
1657225058775,CSE 30,B01,095061,Bhaskar; Nishant,8,0,50,42
1657225064802,CSE 100,A01,083659,Cao; Yingjun,4,4,70,66
1657225070829,CSE 134B,A01,083661,Powell; Thomas Allan,21,0,100,79
1657225076853,CSE 140,A01,083663,Gungor; Onat,13,0,85,72
1657225082880,CSE 140L,A01,083088,Eldon; John,17,0,100,83
1657225088912,CSE 175,A01,083665,Kumar; Rakesh,3,0,25,22
1657225094941,CSE 190,A00,092507,Dubnov; Shlomo,7,0,20,13
1657225100965,ECE 45,A01,083139,Congero; Spencer William,5,0,75,70
1657225106988,ECE 65,A50,083695,Saad; Andrew S,12,0,30,18
1657225106988,ECE 65,A51,095125,Saad; Andrew S,25,0,26,1
1657225113011,ECE 109,A01,091882,Touri; Behrouz,19,0,70,51
1657225119035,ECE 180,A00,083140,Abi Samra; Nicholas Camill,1,0,30,29
1657225119035,ECE 180,B00,083141,Abi Samra; Nicholas Camill,0,0,30,30
1657225125065,MATH 10A,A01,083735,Patchell; Gregory David,2,0,30,28
1657225125065,MATH 10A,A02,083736,Patchell; Gregory David,20,0,30,10
1657225125065,MATH 10A,A03,083737,Patchell; Gregory David,16,0,30,14
1657225131090,MATH 10B,A01,083207,Lim; Seonhee,7,0,34,27
1657225131090,MATH 10B,A02,083208,Lim; Seonhee,9,0,35,26
1657225131090,MATH 10B,A03,093472,Lim; Seonhee,5,0,34,29
1657225131090,MATH 10B,B01,083739,Sinha; Shubham,10,0,30,20
1657225137122,MATH 18,A01,083743,Cinel; Cameron Alexander,6,0,30,24
1657225137122,MATH 18,A02,083744,Cinel; Cameron Alexander,16,0,30,14
1657225137122,MATH 18,A03,083745,Cinel; Cameron Alexander,8,0,30,22
1657225137122,MATH 18,B01,083748,Rideout; David Porter,4,0,37,33
1657225137122,MATH 18,B02,083749,Rideout; David Porter,4,0,36,32
1657225137122,MATH 18,B03,083750,Rideout; David Porter,2,0,37,35
1657225137122,MATH 18,B04,083751,Rideout; David Porter,5,0,36,31
1657225137122,MATH 18,B05,093473,Rideout; David Porter,5,0,36,31
1657225137122,MATH 18,B06,093474,Rideout; David Porter,5,0,36,31
1657225143149,MATH 20A,A01,083754,Zheng; Zequn,14,0,40,26
1657225149175,MATH 20B,A01,083756,Briones; Jor-el Thomas Caparas,2,0,36,34
1657225149175,MATH 20B,A02,083757,Briones; Jor-el Thomas Caparas,1,0,36,35
1657225149175,MATH 20B,A03,093475,Briones; Jor-el Thomas Caparas,2,0,36,34
1657225155199,MATH 20C,A01,083760,Briones; Jor-el Thomas Caparas,1,0,35,34
1657225155199,MATH 20C,A02,083761,Briones; Jor-el Thomas Caparas,8,0,35,27
1657225155199,MATH 20C,A03,093476,Briones; Jor-el Thomas Caparas,0,1,36,36
1657225155199,MATH 20C,B01,083762,Bach; Quang Tran,1,0,30,29
1657225161230,MATH 20D,A01,083765,Tran; Brian Kha,4,0,30,26
1657225161230,MATH 20D,A02,083766,Tran; Brian Kha,5,0,30,25
1657225161230,MATH 20D,A03,083767,Tran; Brian Kha,4,0,30,26
1657225167256,MATH 20E,A01,083771,Ganguly; Soumya,7,0,32,25
1657225167256,MATH 20E,A02,083772,Ganguly; Soumya,7,0,32,25
1657225167256,MATH 20E,B01,083773,Ciotti; Benjamin,19,0,35,16
1657225167256,MATH 20E,B02,083774,Ciotti; Benjamin,17,0,35,18
1657225173286,MATH 103A,A01,083777,Greenfeld; Be'Eri,2,0,36,34
1657225173286,MATH 103A,A02,083778,Greenfeld; Be'Eri,5,0,36,31
1657225173286,MATH 103A,A03,093561,Greenfeld; Be'Eri,4,0,36,32
1657225173286,MATH 103A,B01,083779,Greenfeld; Be'Eri,6,0,36,30
1657225173286,MATH 103A,B02,083780,Greenfeld; Be'Eri,3,0,36,33
1657225173286,MATH 103A,B03,093562,Greenfeld; Be'Eri,3,0,36,33
1657225179311,MATH 105,A01,085443,Carter; Anne Toulson,15,0,35,20
1657225179311,MATH 105,A02,093477,Carter; Anne Toulson,20,0,35,15
1657225185335,MATH 109,A01,083213,Ganzberger; Geoffrey Michael,2,0,34,32
1657225185335,MATH 109,A02,083214,Ganzberger; Geoffrey Michael,4,0,34,30
1657225185335,MATH 109,A03,093478,Ganzberger; Geoffrey Michael,2,0,34,32
1657225185335,MATH 109,B01,083215,Ganzberger; Geoffrey Michael,1,0,32,31
1657225185335,MATH 109,B02,083216,Ganzberger; Geoffrey Michael,1,0,32,31
1657225185335,MATH 109,B03,093479,Ganzberger; Geoffrey Michael,7,0,32,25
1657225191372,MATH 142A,A01,083219,Chow; Bennett,6,0,32,26
1657225191372,MATH 142A,A02,083220,Chow; Bennett,10,0,32,22
1657225191372,MATH 142A,A03,093480,Chow; Bennett,7,0,32,25
1657225191372,MATH 142A,B03,093481,Chow; Bennett,8,0,32,24
1657225191372,MATH 142A,B04,093558,Chow; Bennett,11,0,32,21
1657225191372,MATH 142A,B05,093559,Chow; Bennett,6,0,32,26
1657225197401,MATH 193A,A01,083224,Rotar; Vladimir,7,0,34,27
1657225197401,MATH 193A,A02,083225,Rotar; Vladimir,6,0,34,28
1657225197401,MATH 193A,A03,083781,Rotar; Vladimir,1,0,34,33
1657225197401,MATH 193A,A04,083782,Rotar; Vladimir,8,0,34,26
1657225197401,MATH 193A,A05,093482,Rotar; Vladimir,6,0,34,28
1657225203425,MATH 197,001,091859,McAuley; Julian John,9999,0,9999,0
1657225203425,MATH 197,002,095566,Kedlaya; Kiran S.,9997,0,9999,2
1657225203425,MATH 197,003,095567,Xiao; Ming,9999,0,9999,0
1657225203425,MATH 197,004,095571,Perols; Johan Lars,9998,0,9999,1
1657225210500,COGS 9,A01,083615,Shannon; Kyle Michael,8,0,75,67
1657225216525,COGS 11,A01,083617,Boyle; Mary E. T.,22,0,48,26
1657225222551,COGS 13,A01,083071,Bastos; Amalia Pinkusfeld,9,0,71,62
1657225228578,COGS 14A,A01,092681,Semenuks; Arturs,1,1,100,99
1657225234601,COGS 14B,A01,083073,Cheng; Tzu-Han,6,0,63,57
1657225240701,COGS 17,A01,092677,Semenuks; Arturs,5,0,81,76
1657225246724,COGS 100,A01,083619,Allen; Michael Gordon,15,0,70,55
1657225252772,COGS 101A,A01,083621,Davis; Joshua Daniel,9,0,68,59
1657225258796,COGS 101B,A01,091572,Allen; Michael Gordon,9,0,65,56
1657225264837,COGS 101C,A01,083625,Delgado; Tania,17,0,35,18
1657225270866,COGS 107A,A01,083627,Boyle; Mary E. T.,13,0,60,47
1657225276899,COGS 118A,A01,083075,Gupta; Anjum,16,0,76,60
1657225282926,CSE 3,A50,083646,Miranda; Gregory Joseph,24,0,50,26
1657225288951,CSE 8A,A50,083650,Miranda; Gregory Joseph,17,1,56,39
1657225294983,CSE 11,A01,083080,Cao; Yingjun,5,15,40,35
1657225301007,CSE 12,A01,083652,Krause-Levy; Sophia Louisa,24,1,120,96
1657225307036,CSE 15L,A01,083654,Morris; Justin Loren,9,0,50,41
1657225307036,CSE 15L,A02,083655,Morris; Justin Loren,9,0,50,41
1657225313062,CSE 20,A01,083657,Tran; Khoa Dang,38,0,80,42
1657225319089,CSE 21,A01,095574,Bach; Quang Tran,22,0,48,26
1657225325117,CSE 30,A01,083084,Eldon; John,4,0,80,76
1657225325117,CSE 30,B01,095061,Bhaskar; Nishant,8,0,50,42
1657225331151,CSE 100,A01,083659,Cao; Yingjun,4,4,70,66
1657225337179,CSE 134B,A01,083661,Powell; Thomas Allan,21,0,100,79
1657225343202,CSE 140,A01,083663,Gungor; Onat,13,0,85,72
1657225349233,CSE 140L,A01,083088,Eldon; John,17,0,100,83
1657225355265,CSE 175,A01,083665,Kumar; Rakesh,3,0,25,22
1657225361301,CSE 190,A00,092507,Dubnov; Shlomo,7,0,20,13
1657225367334,ECE 45,A01,083139,Congero; Spencer William,5,0,75,70
1657225373356,ECE 65,A50,083695,Saad; Andrew S,12,0,30,18
1657225373356,ECE 65,A51,095125,Saad; Andrew S,25,0,26,1
1657225379379,ECE 109,A01,091882,Touri; Behrouz,19,0,70,51
1657225385405,ECE 180,A00,083140,Abi Samra; Nicholas Camill,1,0,30,29
1657225385405,ECE 180,B00,083141,Abi Samra; Nicholas Camill,0,0,30,30
1657225391438,MATH 10A,A01,083735,Patchell; Gregory David,2,0,30,28
1657225391438,MATH 10A,A02,083736,Patchell; Gregory David,20,0,30,10
1657225391438,MATH 10A,A03,083737,Patchell; Gregory David,16,0,30,14
1657225397464,MATH 10B,A01,083207,Lim; Seonhee,7,0,34,27
1657225397464,MATH 10B,A02,083208,Lim; Seonhee,9,0,35,26
1657225397464,MATH 10B,A03,093472,Lim; Seonhee,5,0,34,29
1657225397464,MATH 10B,B01,083739,Sinha; Shubham,10,0,30,20
1657225403494,MATH 18,A01,083743,Cinel; Cameron Alexander,6,0,30,24
1657225403494,MATH 18,A02,083744,Cinel; Cameron Alexander,16,0,30,14
1657225403494,MATH 18,A03,083745,Cinel; Cameron Alexander,8,0,30,22
1657225403494,MATH 18,B01,083748,Rideout; David Porter,4,0,37,33
1657225403494,MATH 18,B02,083749,Rideout; David Porter,4,0,36,32
1657225403494,MATH 18,B03,083750,Rideout; David Porter,2,0,37,35
1657225403494,MATH 18,B04,083751,Rideout; David Porter,5,0,36,31
1657225403494,MATH 18,B05,093473,Rideout; David Porter,5,0,36,31
1657225403494,MATH 18,B06,093474,Rideout; David Porter,5,0,36,31
1657225409525,MATH 20A,A01,083754,Zheng; Zequn,14,0,40,26
1657225415548,MATH 20B,A01,083756,Briones; Jor-el Thomas Caparas,2,0,36,34
1657225415548,MATH 20B,A02,083757,Briones; Jor-el Thomas Caparas,1,0,36,35
1657225415548,MATH 20B,A03,093475,Briones; Jor-el Thomas Caparas,2,0,36,34
1657225421579,MATH 20C,A01,083760,Briones; Jor-el Thomas Caparas,1,0,35,34
1657225421579,MATH 20C,A02,083761,Briones; Jor-el Thomas Caparas,8,0,35,27
1657225421579,MATH 20C,A03,093476,Briones; Jor-el Thomas Caparas,0,1,36,36
1657225421579,MATH 20C,B01,083762,Bach; Quang Tran,1,0,30,29
1657225427610,MATH 20D,A01,083765,Tran; Brian Kha,4,0,30,26
1657225427610,MATH 20D,A02,083766,Tran; Brian Kha,5,0,30,25
1657225427610,MATH 20D,A03,083767,Tran; Brian Kha,4,0,30,26
1657225433633,MATH 20E,A01,083771,Ganguly; Soumya,7,0,32,25
1657225433633,MATH 20E,A02,083772,Ganguly; Soumya,7,0,32,25
1657225433633,MATH 20E,B01,083773,Ciotti; Benjamin,19,0,35,16
1657225433633,MATH 20E,B02,083774,Ciotti; Benjamin,17,0,35,18
1657225439660,MATH 103A,A01,083777,Greenfeld; Be'Eri,2,0,36,34
1657225439660,MATH 103A,A02,083778,Greenfeld; Be'Eri,5,0,36,31
1657225439660,MATH 103A,A03,093561,Greenfeld; Be'Eri,4,0,36,32
1657225439660,MATH 103A,B01,083779,Greenfeld; Be'Eri,6,0,36,30
1657225439660,MATH 103A,B02,083780,Greenfeld; Be'Eri,3,0,36,33
1657225439660,MATH 103A,B03,093562,Greenfeld; Be'Eri,3,0,36,33
1657225445683,MATH 105,A01,085443,Carter; Anne Toulson,15,0,35,20
1657225445683,MATH 105,A02,093477,Carter; Anne Toulson,20,0,35,15
1657225451715,MATH 109,A01,083213,Ganzberger; Geoffrey Michael,2,0,34,32
1657225451715,MATH 109,A02,083214,Ganzberger; Geoffrey Michael,4,0,34,30
1657225451715,MATH 109,A03,093478,Ganzberger; Geoffrey Michael,2,0,34,32
1657225451715,MATH 109,B01,083215,Ganzberger; Geoffrey Michael,1,0,32,31
1657225451715,MATH 109,B02,083216,Ganzberger; Geoffrey Michael,1,0,32,31
1657225451715,MATH 109,B03,093479,Ganzberger; Geoffrey Michael,7,0,32,25
1657225457740,MATH 142A,A01,083219,Chow; Bennett,6,0,32,26
1657225457740,MATH 142A,A02,083220,Chow; Bennett,10,0,32,22
1657225457740,MATH 142A,A03,093480,Chow; Bennett,7,0,32,25
1657225457740,MATH 142A,B03,093481,Chow; Bennett,8,0,32,24
1657225457740,MATH 142A,B04,093558,Chow; Bennett,11,0,32,21
1657225457740,MATH 142A,B05,093559,Chow; Bennett,6,0,32,26
1657225463769,MATH 193A,A01,083224,Rotar; Vladimir,7,0,34,27
1657225463769,MATH 193A,A02,083225,Rotar; Vladimir,6,0,34,28
1657225463769,MATH 193A,A03,083781,Rotar; Vladimir,1,0,34,33
1657225463769,MATH 193A,A04,083782,Rotar; Vladimir,8,0,34,26
1657225463769,MATH 193A,A05,093482,Rotar; Vladimir,6,0,34,28
1657225469795,MATH 197,001,091859,McAuley; Julian John,9999,0,9999,0
1657225469795,MATH 197,002,095566,Kedlaya; Kiran S.,9997,0,9999,2
1657225469795,MATH 197,003,095567,Xiao; Ming,9999,0,9999,0
1657225469795,MATH 197,004,095571,Perols; Johan Lars,9998,0,9999,1
1657225476867,COGS 9,A01,083615,Shannon; Kyle Michael,8,0,75,67
1657225482905,COGS 11,A01,083617,Boyle; Mary E. T.,22,0,48,26
1657225488932,COGS 13,A01,083071,Bastos; Amalia Pinkusfeld,9,0,71,62
1657225494955,COGS 14A,A01,092681,Semenuks; Arturs,1,1,100,99
1657225500988,COGS 14B,A01,083073,Cheng; Tzu-Han,6,0,63,57
1657225507030,COGS 17,A01,092677,Semenuks; Arturs,5,0,81,76
1657225513054,COGS 100,A01,083619,Allen; Michael Gordon,15,0,70,55
1657225519081,COGS 101A,A01,083621,Davis; Joshua Daniel,9,0,68,59
1657225525113,COGS 101B,A01,091572,Allen; Michael Gordon,9,0,65,56
1657225531135,COGS 101C,A01,083625,Delgado; Tania,17,0,35,18
1657225537157,COGS 107A,A01,083627,Boyle; Mary E. T.,13,0,60,47
1657225543188,COGS 118A,A01,083075,Gupta; Anjum,16,0,76,60
1657225549212,CSE 3,A50,083646,Miranda; Gregory Joseph,24,0,50,26
1657225555236,CSE 8A,A50,083650,Miranda; Gregory Joseph,17,1,56,39
1657225561263,CSE 11,A01,083080,Cao; Yingjun,5,15,40,35
1657225567287,CSE 12,A01,083652,Krause-Levy; Sophia Louisa,24,1,120,96
1657225573311,CSE 15L,A01,083654,Morris; Justin Loren,9,0,50,41
1657225573311,CSE 15L,A02,083655,Morris; Justin Loren,9,0,50,41
1657225579335,CSE 20,A01,083657,Tran; Khoa Dang,38,0,80,42
1657225585359,CSE 21,A01,095574,Bach; Quang Tran,22,0,48,26
1657225591384,CSE 30,A01,083084,Eldon; John,4,0,80,76
1657225591384,CSE 30,B01,095061,Bhaskar; Nishant,8,0,50,42
1657225597409,CSE 100,A01,083659,Cao; Yingjun,4,4,70,66
1657225603437,CSE 134B,A01,083661,Powell; Thomas Allan,21,0,100,79
1657225609463,CSE 140,A01,083663,Gungor; Onat,13,0,85,72
1657225615490,CSE 140L,A01,083088,Eldon; John,17,0,100,83
1657225621521,CSE 175,A01,083665,Kumar; Rakesh,3,0,25,22
1657225627554,CSE 190,A00,092507,Dubnov; Shlomo,7,0,20,13
1657225633580,ECE 45,A01,083139,Congero; Spencer William,5,0,75,70
1657225639604,ECE 65,A50,083695,Saad; Andrew S,12,0,30,18
1657225639604,ECE 65,A51,095125,Saad; Andrew S,25,0,26,1
1657225645639,ECE 109,A01,091882,Touri; Behrouz,19,0,70,51
1657225651678,ECE 180,A00,083140,Abi Samra; Nicholas Camill,1,0,30,29
1657225651678,ECE 180,B00,083141,Abi Samra; Nicholas Camill,0,0,30,30
1657225657702,MATH 10A,A01,083735,Patchell; Gregory David,2,0,30,28
1657225657702,MATH 10A,A02,083736,Patchell; Gregory David,20,0,30,10
1657225657702,MATH 10A,A03,083737,Patchell; Gregory David,16,0,30,14
1657225663731,MATH 10B,A01,083207,Lim; Seonhee,7,0,34,27
1657225663731,MATH 10B,A02,083208,Lim; Seonhee,9,0,35,26
1657225663731,MATH 10B,A03,093472,Lim; Seonhee,5,0,34,29
1657225663731,MATH 10B,B01,083739,Sinha; Shubham,10,0,30,20
1657225669754,MATH 18,A01,083743,Cinel; Cameron Alexander,6,0,30,24
1657225669754,MATH 18,A02,083744,Cinel; Cameron Alexander,16,0,30,14
1657225669754,MATH 18,A03,083745,Cinel; Cameron Alexander,8,0,30,22
1657225669754,MATH 18,B01,083748,Rideout; David Porter,4,0,37,33
1657225669754,MATH 18,B02,083749,Rideout; David Porter,4,0,36,32
1657225669754,MATH 18,B03,083750,Rideout; David Porter,2,0,37,35
1657225669754,MATH 18,B04,083751,Rideout; David Porter,5,0,36,31
1657225669754,MATH 18,B05,093473,Rideout; David Porter,5,0,36,31
1657225669754,MATH 18,B06,093474,Rideout; David Porter,5,0,36,31
1657225675779,MATH 20A,A01,083754,Zheng; Zequn,14,0,40,26
1657225681805,MATH 20B,A01,083756,Briones; Jor-el Thomas Caparas,2,0,36,34
1657225681805,MATH 20B,A02,083757,Briones; Jor-el Thomas Caparas,1,0,36,35
1657225681805,MATH 20B,A03,093475,Briones; Jor-el Thomas Caparas,2,0,36,34
1657225687830,MATH 20C,A01,083760,Briones; Jor-el Thomas Caparas,1,0,35,34
1657225687830,MATH 20C,A02,083761,Briones; Jor-el Thomas Caparas,8,0,35,27
1657225687830,MATH 20C,A03,093476,Briones; Jor-el Thomas Caparas,0,1,36,36
1657225687830,MATH 20C,B01,083762,Bach; Quang Tran,1,0,30,29
1657225693860,MATH 20D,A01,083765,Tran; Brian Kha,4,0,30,26
1657225693860,MATH 20D,A02,083766,Tran; Brian Kha,5,0,30,25
1657225693860,MATH 20D,A03,083767,Tran; Brian Kha,4,0,30,26
1657225699885,MATH 20E,A01,083771,Ganguly; Soumya,7,0,32,25
1657225699885,MATH 20E,A02,083772,Ganguly; Soumya,7,0,32,25
1657225699885,MATH 20E,B01,083773,Ciotti; Benjamin,19,0,35,16
1657225699885,MATH 20E,B02,083774,Ciotti; Benjamin,17,0,35,18
1657225705916,MATH 103A,A01,083777,Greenfeld; Be'Eri,2,0,36,34
1657225705916,MATH 103A,A02,083778,Greenfeld; Be'Eri,5,0,36,31
1657225705916,MATH 103A,A03,093561,Greenfeld; Be'Eri,4,0,36,32
1657225705916,MATH 103A,B01,083779,Greenfeld; Be'Eri,6,0,36,30
1657225705916,MATH 103A,B02,083780,Greenfeld; Be'Eri,3,0,36,33
1657225705916,MATH 103A,B03,093562,Greenfeld; Be'Eri,3,0,36,33
1657225711948,MATH 105,A01,085443,Carter; Anne Toulson,15,0,35,20
1657225711948,MATH 105,A02,093477,Carter; Anne Toulson,20,0,35,15
1657225717971,MATH 109,A01,083213,Ganzberger; Geoffrey Michael,2,0,34,32
1657225717971,MATH 109,A02,083214,Ganzberger; Geoffrey Michael,4,0,34,30
1657225717971,MATH 109,A03,093478,Ganzberger; Geoffrey Michael,2,0,34,32
1657225717971,MATH 109,B01,083215,Ganzberger; Geoffrey Michael,1,0,32,31
1657225717971,MATH 109,B02,083216,Ganzberger; Geoffrey Michael,1,0,32,31
1657225717971,MATH 109,B03,093479,Ganzberger; Geoffrey Michael,7,0,32,25
1657225724003,MATH 142A,A01,083219,Chow; Bennett,6,0,32,26
1657225724003,MATH 142A,A02,083220,Chow; Bennett,10,0,32,22
1657225724003,MATH 142A,A03,093480,Chow; Bennett,7,0,32,25
1657225724003,MATH 142A,B03,093481,Chow; Bennett,8,0,32,24
1657225724003,MATH 142A,B04,093558,Chow; Bennett,11,0,32,21
1657225724003,MATH 142A,B05,093559,Chow; Bennett,6,0,32,26
1657225730028,MATH 193A,A01,083224,Rotar; Vladimir,7,0,34,27
1657225730028,MATH 193A,A02,083225,Rotar; Vladimir,6,0,34,28
1657225730028,MATH 193A,A03,083781,Rotar; Vladimir,1,0,34,33
1657225730028,MATH 193A,A04,083782,Rotar; Vladimir,8,0,34,26
1657225730028,MATH 193A,A05,093482,Rotar; Vladimir,6,0,34,28
1657225736052,MATH 197,001,091859,McAuley; Julian John,9999,0,9999,0
1657225736052,MATH 197,002,095566,Kedlaya; Kiran S.,9997,0,9999,2
1657225736052,MATH 197,003,095567,Xiao; Ming,9999,0,9999,0
1657225736052,MATH 197,004,095571,Perols; Johan Lars,9998,0,9999,1
1657225743111,COGS 9,A01,083615,Shannon; Kyle Michael,8,0,75,67
1657225749135,COGS 11,A01,083617,Boyle; Mary E. T.,22,0,48,26
1657225755160,COGS 13,A01,083071,Bastos; Amalia Pinkusfeld,8,0,71,63
1657225761191,COGS 14A,A01,092681,Semenuks; Arturs,1,1,100,99
1657225767213,COGS 14B,A01,083073,Cheng; Tzu-Han,6,0,63,57
1657225773241,COGS 17,A01,092677,Semenuks; Arturs,5,0,81,76
1657225779274,COGS 100,A01,083619,Allen; Michael Gordon,15,0,70,55
1657225785300,COGS 101A,A01,083621,Davis; Joshua Daniel,9,0,68,59
1657225791340,COGS 101B,A01,091572,Allen; Michael Gordon,9,0,65,56
1657225797371,COGS 101C,A01,083625,Delgado; Tania,17,0,35,18
1657225803394,COGS 107A,A01,083627,Boyle; Mary E. T.,13,0,60,47
1657225809418,COGS 118A,A01,083075,Gupta; Anjum,16,0,76,60
1657225815443,CSE 3,A50,083646,Miranda; Gregory Joseph,24,0,50,26
1657225821485,CSE 8A,A50,083650,Miranda; Gregory Joseph,17,1,56,39
1657225827512,CSE 11,A01,083080,Cao; Yingjun,5,15,40,35
1657225833540,CSE 12,A01,083652,Krause-Levy; Sophia Louisa,24,1,120,96
1657225839644,CSE 15L,A01,083654,Morris; Justin Loren,9,0,50,41
1657225839644,CSE 15L,A02,083655,Morris; Justin Loren,9,0,50,41
1657225845673,CSE 20,A01,083657,Tran; Khoa Dang,38,0,80,42
1657225851701,CSE 21,A01,095574,Bach; Quang Tran,22,0,48,26
1657225857724,CSE 30,A01,083084,Eldon; John,4,0,80,76
1657225857724,CSE 30,B01,095061,Bhaskar; Nishant,8,0,50,42
1657225863751,CSE 100,A01,083659,Cao; Yingjun,4,4,70,66
1657225869780,CSE 134B,A01,083661,Powell; Thomas Allan,21,0,100,79
1657225875804,CSE 140,A01,083663,Gungor; Onat,13,0,85,72
1657225881832,CSE 140L,A01,083088,Eldon; John,17,0,100,83
1657225887854,CSE 175,A01,083665,Kumar; Rakesh,3,0,25,22
1657225893888,CSE 190,A00,092507,Dubnov; Shlomo,7,0,20,13
1657225899911,ECE 45,A01,083139,Congero; Spencer William,5,0,75,70
1657225905935,ECE 65,A50,083695,Saad; Andrew S,12,0,30,18
1657225905935,ECE 65,A51,095125,Saad; Andrew S,25,0,26,1
1657225911963,ECE 109,A01,091882,Touri; Behrouz,19,0,70,51
1657225918000,ECE 180,A00,083140,Abi Samra; Nicholas Camill,1,0,30,29
1657225918000,ECE 180,B00,083141,Abi Samra; Nicholas Camill,0,0,30,30
1657225924034,MATH 10A,A01,083735,Patchell; Gregory David,2,0,30,28
1657225924034,MATH 10A,A02,083736,Patchell; Gregory David,20,0,30,10
1657225924034,MATH 10A,A03,083737,Patchell; Gregory David,16,0,30,14
1657225930063,MATH 10B,A01,083207,Lim; Seonhee,7,0,34,27
1657225930063,MATH 10B,A02,083208,Lim; Seonhee,9,0,35,26
1657225930063,MATH 10B,A03,093472,Lim; Seonhee,5,0,34,29
1657225930063,MATH 10B,B01,083739,Sinha; Shubham,10,0,30,20
1657225936092,MATH 18,A01,083743,Cinel; Cameron Alexander,6,0,30,24
1657225936092,MATH 18,A02,083744,Cinel; Cameron Alexander,16,0,30,14
1657225936092,MATH 18,A03,083745,Cinel; Cameron Alexander,8,0,30,22
1657225936092,MATH 18,B01,083748,Rideout; David Porter,4,0,37,33
1657225936092,MATH 18,B02,083749,Rideout; David Porter,4,0,36,32
1657225936092,MATH 18,B03,083750,Rideout; David Porter,2,0,37,35
1657225936092,MATH 18,B04,083751,Rideout; David Porter,5,0,36,31
1657225936092,MATH 18,B05,093473,Rideout; David Porter,5,0,36,31
1657225936092,MATH 18,B06,093474,Rideout; David Porter,5,0,36,31
1657225942120,MATH 20A,A01,083754,Zheng; Zequn,14,0,40,26
1657225948145,MATH 20B,A01,083756,Briones; Jor-el Thomas Caparas,2,0,36,34
1657225948145,MATH 20B,A02,083757,Briones; Jor-el Thomas Caparas,1,0,36,35
1657225948145,MATH 20B,A03,093475,Briones; Jor-el Thomas Caparas,2,0,36,34
1657225954171,MATH 20C,A01,083760,Briones; Jor-el Thomas Caparas,1,0,35,34
1657225954171,MATH 20C,A02,083761,Briones; Jor-el Thomas Caparas,8,0,35,27
1657225954171,MATH 20C,A03,093476,Briones; Jor-el Thomas Caparas,0,1,36,36
1657225954171,MATH 20C,B01,083762,Bach; Quang Tran,1,0,30,29
1657225960199,MATH 20D,A01,083765,Tran; Brian Kha,4,0,30,26
1657225960199,MATH 20D,A02,083766,Tran; Brian Kha,5,0,30,25
1657225960199,MATH 20D,A03,083767,Tran; Brian Kha,4,0,30,26
1657225966227,MATH 20E,A01,083771,Ganguly; Soumya,7,0,32,25
1657225966227,MATH 20E,A02,083772,Ganguly; Soumya,7,0,32,25
1657225966227,MATH 20E,B01,083773,Ciotti; Benjamin,19,0,35,16
1657225966227,MATH 20E,B02,083774,Ciotti; Benjamin,17,0,35,18
1657225972252,MATH 103A,A01,083777,Greenfeld; Be'Eri,2,0,36,34
1657225972252,MATH 103A,A02,083778,Greenfeld; Be'Eri,5,0,36,31
1657225972252,MATH 103A,A03,093561,Greenfeld; Be'Eri,4,0,36,32
1657225972252,MATH 103A,B01,083779,Greenfeld; Be'Eri,6,0,36,30
1657225972252,MATH 103A,B02,083780,Greenfeld; Be'Eri,3,0,36,33
1657225972252,MATH 103A,B03,093562,Greenfeld; Be'Eri,3,0,36,33
1657225978277,MATH 105,A01,085443,Carter; Anne Toulson,15,0,35,20
1657225978277,MATH 105,A02,093477,Carter; Anne Toulson,20,0,35,15
1657225984305,MATH 109,A01,083213,Ganzberger; Geoffrey Michael,2,0,34,32
1657225984305,MATH 109,A02,083214,Ganzberger; Geoffrey Michael,4,0,34,30
1657225984305,MATH 109,A03,093478,Ganzberger; Geoffrey Michael,2,0,34,32
1657225984305,MATH 109,B01,083215,Ganzberger; Geoffrey Michael,1,0,32,31
1657225984305,MATH 109,B02,083216,Ganzberger; Geoffrey Michael,1,0,32,31
1657225984305,MATH 109,B03,093479,Ganzberger; Geoffrey Michael,7,0,32,25
1657225990327,MATH 142A,A01,083219,Chow; Bennett,6,0,32,26
1657225990327,MATH 142A,A02,083220,Chow; Bennett,10,0,32,22
1657225990327,MATH 142A,A03,093480,Chow; Bennett,7,0,32,25
1657225990327,MATH 142A,B03,093481,Chow; Bennett,8,0,32,24
1657225990327,MATH 142A,B04,093558,Chow; Bennett,11,0,32,21
1657225990327,MATH 142A,B05,093559,Chow; Bennett,6,0,32,26
1657225996353,MATH 193A,A01,083224,Rotar; Vladimir,7,0,34,27
1657225996353,MATH 193A,A02,083225,Rotar; Vladimir,6,0,34,28
1657225996353,MATH 193A,A03,083781,Rotar; Vladimir,1,0,34,33
1657225996353,MATH 193A,A04,083782,Rotar; Vladimir,8,0,34,26
1657225996353,MATH 193A,A05,093482,Rotar; Vladimir,6,0,34,28
1657226002378,MATH 197,001,091859,McAuley; Julian John,9999,0,9999,0
1657226002378,MATH 197,002,095566,Kedlaya; Kiran S.,9997,0,9999,2
1657226002378,MATH 197,003,095567,Xiao; Ming,9999,0,9999,0
1657226002378,MATH 197,004,095571,Perols; Johan Lars,9998,0,9999,1
1657226009446,COGS 9,A01,083615,Shannon; Kyle Michael,8,0,75,67
1657226015472,COGS 11,A01,083617,Boyle; Mary E. T.,22,0,48,26
1657226021495,COGS 13,A01,083071,Bastos; Amalia Pinkusfeld,8,0,71,63
1657226027521,COGS 14A,A01,092681,Semenuks; Arturs,1,1,100,99
1657226033543,COGS 14B,A01,083073,Cheng; Tzu-Han,6,0,63,57
1657226039570,COGS 17,A01,092677,Semenuks; Arturs,5,0,81,76
1657226045594,COGS 100,A01,083619,Allen; Michael Gordon,15,0,70,55
1657226051622,COGS 101A,A01,083621,Davis; Joshua Daniel,9,0,68,59
1657226057663,COGS 101B,A01,091572,Allen; Michael Gordon,9,0,65,56
1657226063696,COGS 101C,A01,083625,Delgado; Tania,17,0,35,18
1657226069720,COGS 107A,A01,083627,Boyle; Mary E. T.,13,0,60,47
1657226075748,COGS 118A,A01,083075,Gupta; Anjum,16,0,76,60
1657226081773,CSE 3,A50,083646,Miranda; Gregory Joseph,24,0,50,26
1657226087797,CSE 8A,A50,083650,Miranda; Gregory Joseph,17,1,56,39
1657226093834,CSE 11,A01,083080,Cao; Yingjun,5,15,40,35
1657226099856,CSE 12,A01,083652,Krause-Levy; Sophia Louisa,24,1,120,96
1657226105879,CSE 15L,A01,083654,Morris; Justin Loren,9,0,50,41
1657226105879,CSE 15L,A02,083655,Morris; Justin Loren,9,0,50,41
1657226111902,CSE 20,A01,083657,Tran; Khoa Dang,38,0,80,42
1657226117930,CSE 21,A01,095574,Bach; Quang Tran,22,0,48,26
1657226123952,CSE 30,A01,083084,Eldon; John,4,0,80,76
1657226123952,CSE 30,B01,095061,Bhaskar; Nishant,8,0,50,42
1657226129979,CSE 100,A01,083659,Cao; Yingjun,4,4,70,66
1657226136000,CSE 134B,A01,083661,Powell; Thomas Allan,21,0,100,79
1657226142026,CSE 140,A01,083663,Gungor; Onat,13,0,85,72
1657226148058,CSE 140L,A01,083088,Eldon; John,17,0,100,83
1657226154084,CSE 175,A01,083665,Kumar; Rakesh,3,0,25,22
1657226160111,CSE 190,A00,092507,Dubnov; Shlomo,7,0,20,13
1657226166137,ECE 45,A01,083139,Congero; Spencer William,5,0,75,70
1657226172165,ECE 65,A50,083695,Saad; Andrew S,12,0,30,18
1657226172165,ECE 65,A51,095125,Saad; Andrew S,25,0,26,1
1657226178189,ECE 109,A01,091882,Touri; Behrouz,19,0,70,51
1657226184212,ECE 180,A00,083140,Abi Samra; Nicholas Camill,1,0,30,29
1657226184212,ECE 180,B00,083141,Abi Samra; Nicholas Camill,0,0,30,30
1657226190239,MATH 10A,A01,083735,Patchell; Gregory David,2,0,30,28
1657226190239,MATH 10A,A02,083736,Patchell; Gregory David,20,0,30,10
1657226190239,MATH 10A,A03,083737,Patchell; Gregory David,16,0,30,14
1657226196264,MATH 10B,A01,083207,Lim; Seonhee,7,0,34,27
1657226196264,MATH 10B,A02,083208,Lim; Seonhee,9,0,35,26
1657226196264,MATH 10B,A03,093472,Lim; Seonhee,5,0,34,29
1657226196264,MATH 10B,B01,083739,Sinha; Shubham,10,0,30,20
1657226202319,MATH 18,A01,083743,Cinel; Cameron Alexander,6,0,30,24
1657226202319,MATH 18,A02,083744,Cinel; Cameron Alexander,16,0,30,14
1657226202319,MATH 18,A03,083745,Cinel; Cameron Alexander,8,0,30,22
1657226202319,MATH 18,B01,083748,Rideout; David Porter,4,0,37,33
1657226202319,MATH 18,B02,083749,Rideout; David Porter,4,0,36,32
1657226202319,MATH 18,B03,083750,Rideout; David Porter,2,0,37,35
1657226202319,MATH 18,B04,083751,Rideout; David Porter,5,0,36,31
1657226202319,MATH 18,B05,093473,Rideout; David Porter,5,0,36,31
1657226202319,MATH 18,B06,093474,Rideout; David Porter,5,0,36,31
1657226208346,MATH 20A,A01,083754,Zheng; Zequn,14,0,40,26
1657226214370,MATH 20B,A01,083756,Briones; Jor-el Thomas Caparas,2,0,36,34
1657226214370,MATH 20B,A02,083757,Briones; Jor-el Thomas Caparas,1,0,36,35
1657226214370,MATH 20B,A03,093475,Briones; Jor-el Thomas Caparas,2,0,36,34
1657226220395,MATH 20C,A01,083760,Briones; Jor-el Thomas Caparas,1,0,35,34
1657226220395,MATH 20C,A02,083761,Briones; Jor-el Thomas Caparas,8,0,35,27
1657226220395,MATH 20C,A03,093476,Briones; Jor-el Thomas Caparas,0,1,36,36
1657226220395,MATH 20C,B01,083762,Bach; Quang Tran,1,0,30,29
1657226226418,MATH 20D,A01,083765,Tran; Brian Kha,4,0,30,26
1657226226418,MATH 20D,A02,083766,Tran; Brian Kha,5,0,30,25
1657226226418,MATH 20D,A03,083767,Tran; Brian Kha,4,0,30,26
1657226232444,MATH 20E,A01,083771,Ganguly; Soumya,7,0,32,25
1657226232444,MATH 20E,A02,083772,Ganguly; Soumya,7,0,32,25
1657226232444,MATH 20E,B01,083773,Ciotti; Benjamin,19,0,35,16
1657226232444,MATH 20E,B02,083774,Ciotti; Benjamin,17,0,35,18
1657226238474,MATH 103A,A01,083777,Greenfeld; Be'Eri,2,0,36,34
1657226238474,MATH 103A,A02,083778,Greenfeld; Be'Eri,5,0,36,31
1657226238474,MATH 103A,A03,093561,Greenfeld; Be'Eri,4,0,36,32
1657226238474,MATH 103A,B01,083779,Greenfeld; Be'Eri,6,0,36,30
1657226238474,MATH 103A,B02,083780,Greenfeld; Be'Eri,3,0,36,33
1657226238474,MATH 103A,B03,093562,Greenfeld; Be'Eri,3,0,36,33
1657226244497,MATH 105,A01,085443,Carter; Anne Toulson,15,0,35,20
1657226244497,MATH 105,A02,093477,Carter; Anne Toulson,20,0,35,15
1657226250526,MATH 109,A01,083213,Ganzberger; Geoffrey Michael,2,0,34,32
1657226250526,MATH 109,A02,083214,Ganzberger; Geoffrey Michael,4,0,34,30
1657226250526,MATH 109,A03,093478,Ganzberger; Geoffrey Michael,2,0,34,32
1657226250526,MATH 109,B01,083215,Ganzberger; Geoffrey Michael,1,0,32,31
1657226250526,MATH 109,B02,083216,Ganzberger; Geoffrey Michael,1,0,32,31
1657226250526,MATH 109,B03,093479,Ganzberger; Geoffrey Michael,7,0,32,25
1657226256552,MATH 142A,A01,083219,Chow; Bennett,6,0,32,26
1657226256552,MATH 142A,A02,083220,Chow; Bennett,10,0,32,22
1657226256552,MATH 142A,A03,093480,Chow; Bennett,7,0,32,25
1657226256552,MATH 142A,B03,093481,Chow; Bennett,8,0,32,24
1657226256552,MATH 142A,B04,093558,Chow; Bennett,11,0,32,21
1657226256552,MATH 142A,B05,093559,Chow; Bennett,6,0,32,26
1657226262581,MATH 193A,A01,083224,Rotar; Vladimir,7,0,34,27
1657226262581,MATH 193A,A02,083225,Rotar; Vladimir,6,0,34,28
1657226262581,MATH 193A,A03,083781,Rotar; Vladimir,1,0,34,33
1657226262581,MATH 193A,A04,083782,Rotar; Vladimir,8,0,34,26
1657226262581,MATH 193A,A05,093482,Rotar; Vladimir,6,0,34,28
1657226268604,MATH 197,001,091859,McAuley; Julian John,9999,0,9999,0
1657226268604,MATH 197,002,095566,Kedlaya; Kiran S.,9997,0,9999,2
1657226268604,MATH 197,003,095567,Xiao; Ming,9999,0,9999,0
1657226268604,MATH 197,004,095571,Perols; Johan Lars,9998,0,9999,1
1657226275671,COGS 9,A01,083615,Shannon; Kyle Michael,8,0,75,67
1657226281694,COGS 11,A01,083617,Boyle; Mary E. T.,22,0,48,26
1657226287718,COGS 13,A01,083071,Bastos; Amalia Pinkusfeld,8,0,71,63
1657226293743,COGS 14A,A01,092681,Semenuks; Arturs,1,1,100,99
1657226299767,COGS 14B,A01,083073,Cheng; Tzu-Han,6,0,63,57
1657226305797,COGS 17,A01,092677,Semenuks; Arturs,5,0,81,76
1657226311824,COGS 100,A01,083619,Allen; Michael Gordon,15,0,70,55
1657226317854,COGS 101A,A01,083621,Davis; Joshua Daniel,9,0,68,59
1657226323876,COGS 101B,A01,091572,Allen; Michael Gordon,9,0,65,56
1657226329903,COGS 101C,A01,083625,Delgado; Tania,17,0,35,18
1657226335930,COGS 107A,A01,083627,Boyle; Mary E. T.,13,0,60,47
1657226341956,COGS 118A,A01,083075,Gupta; Anjum,16,0,76,60
1657226347979,CSE 3,A50,083646,Miranda; Gregory Joseph,24,0,50,26
1657226354010,CSE 8A,A50,083650,Miranda; Gregory Joseph,17,1,56,39
1657226360037,CSE 11,A01,083080,Cao; Yingjun,5,15,40,35
1657226366063,CSE 12,A01,083652,Krause-Levy; Sophia Louisa,24,1,120,96
1657226372088,CSE 15L,A01,083654,Morris; Justin Loren,9,0,50,41
1657226372088,CSE 15L,A02,083655,Morris; Justin Loren,9,0,50,41
1657226378114,CSE 20,A01,083657,Tran; Khoa Dang,38,0,80,42
1657226384136,CSE 21,A01,095574,Bach; Quang Tran,22,0,48,26
1657226390159,CSE 30,A01,083084,Eldon; John,4,0,80,76
1657226390159,CSE 30,B01,095061,Bhaskar; Nishant,8,0,50,42
1657226396182,CSE 100,A01,083659,Cao; Yingjun,4,4,70,66
1657226402208,CSE 134B,A01,083661,Powell; Thomas Allan,21,0,100,79
1657226408235,CSE 140,A01,083663,Gungor; Onat,13,0,85,72
1657226414257,CSE 140L,A01,083088,Eldon; John,17,0,100,83
1657226420293,CSE 175,A01,083665,Kumar; Rakesh,3,0,25,22
1657226426316,CSE 190,A00,092507,Dubnov; Shlomo,7,0,20,13
1657226432339,ECE 45,A01,083139,Congero; Spencer William,5,0,75,70
1657226438438,ECE 65,A50,083695,Saad; Andrew S,12,0,30,18
1657226438438,ECE 65,A51,095125,Saad; Andrew S,25,0,26,1
1657226444462,ECE 109,A01,091882,Touri; Behrouz,19,0,70,51
1657226450488,ECE 180,A00,083140,Abi Samra; Nicholas Camill,1,0,30,29
1657226450488,ECE 180,B00,083141,Abi Samra; Nicholas Camill,0,0,30,30
1657226456513,MATH 10A,A01,083735,Patchell; Gregory David,2,0,30,28
1657226456513,MATH 10A,A02,083736,Patchell; Gregory David,20,0,30,10
1657226456513,MATH 10A,A03,083737,Patchell; Gregory David,16,0,30,14
1657226462541,MATH 10B,A01,083207,Lim; Seonhee,7,0,34,27
1657226462541,MATH 10B,A02,083208,Lim; Seonhee,9,0,35,26
1657226462541,MATH 10B,A03,093472,Lim; Seonhee,5,0,34,29
1657226462541,MATH 10B,B01,083739,Sinha; Shubham,10,0,30,20
1657226468566,MATH 18,A01,083743,Cinel; Cameron Alexander,6,0,30,24
1657226468566,MATH 18,A02,083744,Cinel; Cameron Alexander,16,0,30,14
1657226468566,MATH 18,A03,083745,Cinel; Cameron Alexander,8,0,30,22
1657226468566,MATH 18,B01,083748,Rideout; David Porter,4,0,37,33
1657226468566,MATH 18,B02,083749,Rideout; David Porter,4,0,36,32
1657226468566,MATH 18,B03,083750,Rideout; David Porter,2,0,37,35
1657226468566,MATH 18,B04,083751,Rideout; David Porter,5,0,36,31
1657226468566,MATH 18,B05,093473,Rideout; David Porter,5,0,36,31
1657226468566,MATH 18,B06,093474,Rideout; David Porter,5,0,36,31
1657226474605,MATH 20A,A01,083754,Zheng; Zequn,14,0,40,26
1657226480629,MATH 20B,A01,083756,Briones; Jor-el Thomas Caparas,2,0,36,34
1657226480629,MATH 20B,A02,083757,Briones; Jor-el Thomas Caparas,1,0,36,35
1657226480629,MATH 20B,A03,093475,Briones; Jor-el Thomas Caparas,2,0,36,34
1657226486658,MATH 20C,A01,083760,Briones; Jor-el Thomas Caparas,1,0,35,34
1657226486658,MATH 20C,A02,083761,Briones; Jor-el Thomas Caparas,8,0,35,27
1657226486658,MATH 20C,A03,093476,Briones; Jor-el Thomas Caparas,0,1,36,36
1657226486658,MATH 20C,B01,083762,Bach; Quang Tran,1,0,30,29
1657226492688,MATH 20D,A01,083765,Tran; Brian Kha,4,0,30,26
1657226492688,MATH 20D,A02,083766,Tran; Brian Kha,5,0,30,25
1657226492688,MATH 20D,A03,083767,Tran; Brian Kha,4,0,30,26
1657226498713,MATH 20E,A01,083771,Ganguly; Soumya,7,0,32,25
1657226498713,MATH 20E,A02,083772,Ganguly; Soumya,7,0,32,25
1657226498713,MATH 20E,B01,083773,Ciotti; Benjamin,19,0,35,16
1657226498713,MATH 20E,B02,083774,Ciotti; Benjamin,17,0,35,18
1657226504738,MATH 103A,A01,083777,Greenfeld; Be'Eri,2,0,36,34
1657226504738,MATH 103A,A02,083778,Greenfeld; Be'Eri,5,0,36,31
1657226504738,MATH 103A,A03,093561,Greenfeld; Be'Eri,4,0,36,32
1657226504738,MATH 103A,B01,083779,Greenfeld; Be'Eri,6,0,36,30
1657226504738,MATH 103A,B02,083780,Greenfeld; Be'Eri,3,0,36,33
1657226504738,MATH 103A,B03,093562,Greenfeld; Be'Eri,3,0,36,33
1657226510764,MATH 105,A01,085443,Carter; Anne Toulson,15,0,35,20
1657226510764,MATH 105,A02,093477,Carter; Anne Toulson,20,0,35,15
1657226516799,MATH 109,A01,083213,Ganzberger; Geoffrey Michael,2,0,34,32
1657226516799,MATH 109,A02,083214,Ganzberger; Geoffrey Michael,4,0,34,30
1657226516799,MATH 109,A03,093478,Ganzberger; Geoffrey Michael,2,0,34,32
1657226516799,MATH 109,B01,083215,Ganzberger; Geoffrey Michael,1,0,32,31
1657226516799,MATH 109,B02,083216,Ganzberger; Geoffrey Michael,1,0,32,31
1657226516799,MATH 109,B03,093479,Ganzberger; Geoffrey Michael,7,0,32,25
1657226522822,MATH 142A,A01,083219,Chow; Bennett,6,0,32,26
1657226522822,MATH 142A,A02,083220,Chow; Bennett,10,0,32,22
1657226522822,MATH 142A,A03,093480,Chow; Bennett,7,0,32,25
1657226522822,MATH 142A,B03,093481,Chow; Bennett,8,0,32,24
1657226522822,MATH 142A,B04,093558,Chow; Bennett,11,0,32,21
1657226522822,MATH 142A,B05,093559,Chow; Bennett,6,0,32,26
1657226528850,MATH 193A,A01,083224,Rotar; Vladimir,7,0,34,27
1657226528850,MATH 193A,A02,083225,Rotar; Vladimir,6,0,34,28
1657226528850,MATH 193A,A03,083781,Rotar; Vladimir,1,0,34,33
1657226528850,MATH 193A,A04,083782,Rotar; Vladimir,8,0,34,26
1657226528850,MATH 193A,A05,093482,Rotar; Vladimir,6,0,34,28
1657226534873,MATH 197,001,091859,McAuley; Julian John,9999,0,9999,0
1657226534873,MATH 197,002,095566,Kedlaya; Kiran S.,9997,0,9999,2
1657226534873,MATH 197,003,095567,Xiao; Ming,9999,0,9999,0
1657226534873,MATH 197,004,095571,Perols; Johan Lars,9998,0,9999,1
1657226541956,COGS 9,A01,083615,Shannon; Kyle Michael,8,0,75,67
1657226547990,COGS 11,A01,083617,Boyle; Mary E. T.,22,0,48,26
1657226554013,COGS 13,A01,083071,Bastos; Amalia Pinkusfeld,8,0,71,63
1657226560037,COGS 14A,A01,092681,Semenuks; Arturs,1,1,100,99
1657226566102,COGS 14B,A01,083073,Cheng; Tzu-Han,6,0,63,57
1657226572129,COGS 17,A01,092677,Semenuks; Arturs,5,0,81,76
1657226578154,COGS 100,A01,083619,Allen; Michael Gordon,15,0,70,55
1657226584185,COGS 101A,A01,083621,Davis; Joshua Daniel,9,0,68,59
1657226590208,COGS 101B,A01,091572,Allen; Michael Gordon,9,0,65,56
1657226596234,COGS 101C,A01,083625,Delgado; Tania,17,0,35,18
1657226602257,COGS 107A,A01,083627,Boyle; Mary E. T.,13,0,60,47
1657226608289,COGS 118A,A01,083075,Gupta; Anjum,16,0,76,60
1657226614317,CSE 3,A50,083646,Miranda; Gregory Joseph,24,0,50,26
1657226620340,CSE 8A,A50,083650,Miranda; Gregory Joseph,17,1,56,39
1657226626366,CSE 11,A01,083080,Cao; Yingjun,5,15,40,35
1657226632388,CSE 12,A01,083652,Krause-Levy; Sophia Louisa,24,1,120,96
1657226638411,CSE 15L,A01,083654,Morris; Justin Loren,9,0,50,41
1657226638411,CSE 15L,A02,083655,Morris; Justin Loren,9,0,50,41
1657226644433,CSE 20,A01,083657,Tran; Khoa Dang,38,0,80,42
1657226650457,CSE 21,A01,095574,Bach; Quang Tran,22,0,48,26
1657226656482,CSE 30,A01,083084,Eldon; John,4,0,80,76
1657226656482,CSE 30,B01,095061,Bhaskar; Nishant,8,0,50,42
1657226662514,CSE 100,A01,083659,Cao; Yingjun,4,4,70,66
1657226668537,CSE 134B,A01,083661,Powell; Thomas Allan,21,0,100,79
1657226674564,CSE 140,A01,083663,Gungor; Onat,13,0,85,72
1657226680597,CSE 140L,A01,083088,Eldon; John,17,0,100,83
1657226686620,CSE 175,A01,083665,Kumar; Rakesh,3,0,25,22
1657226692646,CSE 190,A00,092507,Dubnov; Shlomo,7,0,20,13
1657226698673,ECE 45,A01,083139,Congero; Spencer William,5,0,75,70
1657226704696,ECE 65,A50,083695,Saad; Andrew S,12,0,30,18
1657226704696,ECE 65,A51,095125,Saad; Andrew S,25,0,26,1
1657226710727,ECE 109,A01,091882,Touri; Behrouz,19,0,70,51
1657226716753,ECE 180,A00,083140,Abi Samra; Nicholas Camill,1,0,30,29
1657226716753,ECE 180,B00,083141,Abi Samra; Nicholas Camill,0,0,30,30
1657226722780,MATH 10A,A01,083735,Patchell; Gregory David,2,0,30,28
1657226722780,MATH 10A,A02,083736,Patchell; Gregory David,20,0,30,10
1657226722780,MATH 10A,A03,083737,Patchell; Gregory David,16,0,30,14
1657226728805,MATH 10B,A01,083207,Lim; Seonhee,7,0,34,27
1657226728805,MATH 10B,A02,083208,Lim; Seonhee,9,0,35,26
1657226728805,MATH 10B,A03,093472,Lim; Seonhee,5,0,34,29
1657226728805,MATH 10B,B01,083739,Sinha; Shubham,10,0,30,20
1657226734834,MATH 18,A01,083743,Cinel; Cameron Alexander,6,0,30,24
1657226734834,MATH 18,A02,083744,Cinel; Cameron Alexander,16,0,30,14
1657226734834,MATH 18,A03,083745,Cinel; Cameron Alexander,8,0,30,22
1657226734834,MATH 18,B01,083748,Rideout; David Porter,4,0,37,33
1657226734834,MATH 18,B02,083749,Rideout; David Porter,4,0,36,32
1657226734834,MATH 18,B03,083750,Rideout; David Porter,2,0,37,35
1657226734834,MATH 18,B04,083751,Rideout; David Porter,5,0,36,31
1657226734834,MATH 18,B05,093473,Rideout; David Porter,5,0,36,31
1657226734834,MATH 18,B06,093474,Rideout; David Porter,5,0,36,31
1657226740860,MATH 20A,A01,083754,Zheng; Zequn,14,0,40,26
1657226746884,MATH 20B,A01,083756,Briones; Jor-el Thomas Caparas,2,0,36,34
1657226746884,MATH 20B,A02,083757,Briones; Jor-el Thomas Caparas,1,0,36,35
1657226746884,MATH 20B,A03,093475,Briones; Jor-el Thomas Caparas,2,0,36,34
1657226752913,MATH 20C,A01,083760,Briones; Jor-el Thomas Caparas,1,0,35,34
1657226752913,MATH 20C,A02,083761,Briones; Jor-el Thomas Caparas,8,0,35,27
1657226752913,MATH 20C,A03,093476,Briones; Jor-el Thomas Caparas,0,1,36,36
1657226752913,MATH 20C,B01,083762,Bach; Quang Tran,1,0,30,29
1657226758940,MATH 20D,A01,083765,Tran; Brian Kha,4,0,30,26
1657226758940,MATH 20D,A02,083766,Tran; Brian Kha,5,0,30,25
1657226758940,MATH 20D,A03,083767,Tran; Brian Kha,4,0,30,26
1657226764962,MATH 20E,A01,083771,Ganguly; Soumya,7,0,32,25
1657226764962,MATH 20E,A02,083772,Ganguly; Soumya,7,0,32,25
1657226764962,MATH 20E,B01,083773,Ciotti; Benjamin,19,0,35,16
1657226764962,MATH 20E,B02,083774,Ciotti; Benjamin,17,0,35,18
1657226770989,MATH 103A,A01,083777,Greenfeld; Be'Eri,2,0,36,34
1657226770989,MATH 103A,A02,083778,Greenfeld; Be'Eri,5,0,36,31
1657226770989,MATH 103A,A03,093561,Greenfeld; Be'Eri,4,0,36,32
1657226770989,MATH 103A,B01,083779,Greenfeld; Be'Eri,6,0,36,30
1657226770989,MATH 103A,B02,083780,Greenfeld; Be'Eri,3,0,36,33
1657226770989,MATH 103A,B03,093562,Greenfeld; Be'Eri,3,0,36,33
1657226777012,MATH 105,A01,085443,Carter; Anne Toulson,15,0,35,20
1657226777012,MATH 105,A02,093477,Carter; Anne Toulson,20,0,35,15
1657226783037,MATH 109,A01,083213,Ganzberger; Geoffrey Michael,2,0,34,32
1657226783037,MATH 109,A02,083214,Ganzberger; Geoffrey Michael,4,0,34,30
1657226783037,MATH 109,A03,093478,Ganzberger; Geoffrey Michael,2,0,34,32
1657226783037,MATH 109,B01,083215,Ganzberger; Geoffrey Michael,1,0,32,31
1657226783037,MATH 109,B02,083216,Ganzberger; Geoffrey Michael,1,0,32,31
1657226783037,MATH 109,B03,093479,Ganzberger; Geoffrey Michael,7,0,32,25
1657226789074,MATH 142A,A01,083219,Chow; Bennett,6,0,32,26
1657226789074,MATH 142A,A02,083220,Chow; Bennett,10,0,32,22
1657226789074,MATH 142A,A03,093480,Chow; Bennett,7,0,32,25
1657226789074,MATH 142A,B03,093481,Chow; Bennett,8,0,32,24
1657226789074,MATH 142A,B04,093558,Chow; Bennett,11,0,32,21
1657226789074,MATH 142A,B05,093559,Chow; Bennett,6,0,32,26
1657226795105,MATH 193A,A01,083224,Rotar; Vladimir,7,0,34,27
1657226795105,MATH 193A,A02,083225,Rotar; Vladimir,6,0,34,28
1657226795105,MATH 193A,A03,083781,Rotar; Vladimir,1,0,34,33
1657226795105,MATH 193A,A04,083782,Rotar; Vladimir,8,0,34,26
1657226795105,MATH 193A,A05,093482,Rotar; Vladimir,6,0,34,28
1657226801130,MATH 197,001,091859,McAuley; Julian John,9999,0,9999,0
1657226801130,MATH 197,002,095566,Kedlaya; Kiran S.,9997,0,9999,2
1657226801130,MATH 197,003,095567,Xiao; Ming,9999,0,9999,0
1657226801130,MATH 197,004,095571,Perols; Johan Lars,9998,0,9999,1
1657226808182,COGS 9,A01,083615,Shannon; Kyle Michael,8,0,75,67
1657226814207,COGS 11,A01,083617,Boyle; Mary E. T.,22,0,48,26
1657226820237,COGS 13,A01,083071,Bastos; Amalia Pinkusfeld,8,0,71,63
1657226826261,COGS 14A,A01,092681,Semenuks; Arturs,1,1,100,99
1657226832290,COGS 14B,A01,083073,Cheng; Tzu-Han,6,0,63,57
1657226838315,COGS 17,A01,092677,Semenuks; Arturs,5,0,81,76
1657226844349,COGS 100,A01,083619,Allen; Michael Gordon,15,0,70,55
1657226850373,COGS 101A,A01,083621,Davis; Joshua Daniel,9,0,68,59
1657226856396,COGS 101B,A01,091572,Allen; Michael Gordon,9,0,65,56
1657226862421,COGS 101C,A01,083625,Delgado; Tania,17,0,35,18
1657226868446,COGS 107A,A01,083627,Boyle; Mary E. T.,13,0,60,47
1657226874471,COGS 118A,A01,083075,Gupta; Anjum,16,0,76,60
1657226880498,CSE 3,A50,083646,Miranda; Gregory Joseph,24,0,50,26
1657226886526,CSE 8A,A50,083650,Miranda; Gregory Joseph,17,1,56,39
1657226892548,CSE 11,A01,083080,Cao; Yingjun,5,15,40,35
1657226898573,CSE 12,A01,083652,Krause-Levy; Sophia Louisa,24,1,120,96
1657226904601,CSE 15L,A01,083654,Morris; Justin Loren,9,0,50,41
1657226904601,CSE 15L,A02,083655,Morris; Justin Loren,9,0,50,41
1657226910626,CSE 20,A01,083657,Tran; Khoa Dang,38,0,80,42
1657226916652,CSE 21,A01,095574,Bach; Quang Tran,22,0,48,26
1657226922674,CSE 30,A01,083084,Eldon; John,4,0,80,76
1657226922674,CSE 30,B01,095061,Bhaskar; Nishant,8,0,50,42
1657226928696,CSE 100,A01,083659,Cao; Yingjun,4,4,70,66
1657226934730,CSE 134B,A01,083661,Powell; Thomas Allan,21,0,100,79
1657226940753,CSE 140,A01,083663,Gungor; Onat,13,0,85,72
1657226946791,CSE 140L,A01,083088,Eldon; John,17,0,100,83
1657226952813,CSE 175,A01,083665,Kumar; Rakesh,3,0,25,22
1657226958847,CSE 190,A00,092507,Dubnov; Shlomo,7,0,20,13
1657226964874,ECE 45,A01,083139,Congero; Spencer William,5,0,75,70
1657226970914,ECE 65,A50,083695,Saad; Andrew S,12,0,30,18
1657226970914,ECE 65,A51,095125,Saad; Andrew S,25,0,26,1
1657226976943,ECE 109,A01,091882,Touri; Behrouz,19,0,70,51
1657226982977,ECE 180,A00,083140,Abi Samra; Nicholas Camill,1,0,30,29
1657226982977,ECE 180,B00,083141,Abi Samra; Nicholas Camill,0,0,30,30
1657226989000,MATH 10A,A01,083735,Patchell; Gregory David,2,0,30,28
1657226989000,MATH 10A,A02,083736,Patchell; Gregory David,20,0,30,10
1657226989000,MATH 10A,A03,083737,Patchell; Gregory David,16,0,30,14
1657226995036,MATH 10B,A01,083207,Lim; Seonhee,7,0,34,27
1657226995036,MATH 10B,A02,083208,Lim; Seonhee,9,0,35,26
1657226995036,MATH 10B,A03,093472,Lim; Seonhee,5,0,34,29
1657226995036,MATH 10B,B01,083739,Sinha; Shubham,10,0,30,20
1657227001076,MATH 18,A01,083743,Cinel; Cameron Alexander,6,0,30,24
1657227001076,MATH 18,A02,083744,Cinel; Cameron Alexander,16,0,30,14
1657227001076,MATH 18,A03,083745,Cinel; Cameron Alexander,8,0,30,22
1657227001076,MATH 18,B01,083748,Rideout; David Porter,4,0,37,33
1657227001076,MATH 18,B02,083749,Rideout; David Porter,4,0,36,32
1657227001076,MATH 18,B03,083750,Rideout; David Porter,2,0,37,35
1657227001076,MATH 18,B04,083751,Rideout; David Porter,5,0,36,31
1657227001076,MATH 18,B05,093473,Rideout; David Porter,5,0,36,31
1657227001076,MATH 18,B06,093474,Rideout; David Porter,5,0,36,31
1657227007098,MATH 20A,A01,083754,Zheng; Zequn,14,0,40,26
1657227013128,MATH 20B,A01,083756,Briones; Jor-el Thomas Caparas,2,0,36,34
1657227013128,MATH 20B,A02,083757,Briones; Jor-el Thomas Caparas,1,0,36,35
1657227013128,MATH 20B,A03,093475,Briones; Jor-el Thomas Caparas,2,0,36,34
1657227019154,MATH 20C,A01,083760,Briones; Jor-el Thomas Caparas,1,0,35,34
1657227019154,MATH 20C,A02,083761,Briones; Jor-el Thomas Caparas,8,0,35,27
1657227019154,MATH 20C,A03,093476,Briones; Jor-el Thomas Caparas,0,1,36,36
1657227019154,MATH 20C,B01,083762,Bach; Quang Tran,1,0,30,29
1657227025190,MATH 20D,A01,083765,Tran; Brian Kha,4,0,30,26
1657227025190,MATH 20D,A02,083766,Tran; Brian Kha,5,0,30,25
1657227025190,MATH 20D,A03,083767,Tran; Brian Kha,4,0,30,26
1657227031230,MATH 20E,A01,083771,Ganguly; Soumya,7,0,32,25
1657227031230,MATH 20E,A02,083772,Ganguly; Soumya,7,0,32,25
1657227031230,MATH 20E,B01,083773,Ciotti; Benjamin,19,0,35,16
1657227031230,MATH 20E,B02,083774,Ciotti; Benjamin,17,0,35,18
1657227037334,MATH 103A,A01,083777,Greenfeld; Be'Eri,2,0,36,34
1657227037334,MATH 103A,A02,083778,Greenfeld; Be'Eri,5,0,36,31
1657227037334,MATH 103A,A03,093561,Greenfeld; Be'Eri,4,0,36,32
1657227037334,MATH 103A,B01,083779,Greenfeld; Be'Eri,6,0,36,30
1657227037334,MATH 103A,B02,083780,Greenfeld; Be'Eri,3,0,36,33
1657227037334,MATH 103A,B03,093562,Greenfeld; Be'Eri,3,0,36,33
1657227043362,MATH 105,A01,085443,Carter; Anne Toulson,15,0,35,20
1657227043362,MATH 105,A02,093477,Carter; Anne Toulson,20,0,35,15
1657227049384,MATH 109,A01,083213,Ganzberger; Geoffrey Michael,2,0,34,32
1657227049384,MATH 109,A02,083214,Ganzberger; Geoffrey Michael,4,0,34,30
1657227049384,MATH 109,A03,093478,Ganzberger; Geoffrey Michael,2,0,34,32
1657227049384,MATH 109,B01,083215,Ganzberger; Geoffrey Michael,1,0,32,31
1657227049384,MATH 109,B02,083216,Ganzberger; Geoffrey Michael,1,0,32,31
1657227049384,MATH 109,B03,093479,Ganzberger; Geoffrey Michael,7,0,32,25
1657227055416,MATH 142A,A01,083219,Chow; Bennett,6,0,32,26
1657227055416,MATH 142A,A02,083220,Chow; Bennett,10,0,32,22
1657227055416,MATH 142A,A03,093480,Chow; Bennett,7,0,32,25
1657227055416,MATH 142A,B03,093481,Chow; Bennett,8,0,32,24
1657227055416,MATH 142A,B04,093558,Chow; Bennett,11,0,32,21
1657227055416,MATH 142A,B05,093559,Chow; Bennett,6,0,32,26
1657227061446,MATH 193A,A01,083224,Rotar; Vladimir,7,0,34,27
1657227061446,MATH 193A,A02,083225,Rotar; Vladimir,6,0,34,28
1657227061446,MATH 193A,A03,083781,Rotar; Vladimir,1,0,34,33
1657227061446,MATH 193A,A04,083782,Rotar; Vladimir,8,0,34,26
1657227061446,MATH 193A,A05,093482,Rotar; Vladimir,6,0,34,28
1657227067471,MATH 197,001,091859,McAuley; Julian John,9999,0,9999,0
1657227067471,MATH 197,002,095566,Kedlaya; Kiran S.,9997,0,9999,2
1657227067471,MATH 197,003,095567,Xiao; Ming,9999,0,9999,0
1657227067471,MATH 197,004,095571,Perols; Johan Lars,9998,0,9999,1
1657227074542,COGS 9,A01,083615,Shannon; Kyle Michael,8,0,75,67
1657227080570,COGS 11,A01,083617,Boyle; Mary E. T.,22,0,48,26
1657227086597,COGS 13,A01,083071,Bastos; Amalia Pinkusfeld,8,0,71,63
1657227092623,COGS 14A,A01,092681,Semenuks; Arturs,2,1,100,98
1657227098647,COGS 14B,A01,083073,Cheng; Tzu-Han,6,0,63,57
1657227104670,COGS 17,A01,092677,Semenuks; Arturs,5,0,81,76
1657227110694,COGS 100,A01,083619,Allen; Michael Gordon,15,0,70,55
1657227116725,COGS 101A,A01,083621,Davis; Joshua Daniel,9,0,68,59
1657227122751,COGS 101B,A01,091572,Allen; Michael Gordon,9,0,65,56
1657227128774,COGS 101C,A01,083625,Delgado; Tania,17,0,35,18
1657227134798,COGS 107A,A01,083627,Boyle; Mary E. T.,13,0,60,47
1657227140821,COGS 118A,A01,083075,Gupta; Anjum,16,0,76,60
1657227146850,CSE 3,A50,083646,Miranda; Gregory Joseph,24,0,50,26
1657227152872,CSE 8A,A50,083650,Miranda; Gregory Joseph,17,1,56,39
1657227158895,CSE 11,A01,083080,Cao; Yingjun,5,15,40,35
1657227164919,CSE 12,A01,083652,Krause-Levy; Sophia Louisa,24,1,120,96
1657227170941,CSE 15L,A01,083654,Morris; Justin Loren,9,0,50,41
1657227170941,CSE 15L,A02,083655,Morris; Justin Loren,9,0,50,41
1657227176964,CSE 20,A01,083657,Tran; Khoa Dang,38,0,80,42
1657227183002,CSE 21,A01,095574,Bach; Quang Tran,22,0,48,26
1657227189028,CSE 30,A01,083084,Eldon; John,4,0,80,76
1657227189028,CSE 30,B01,095061,Bhaskar; Nishant,8,0,50,42
1657227195051,CSE 100,A01,083659,Cao; Yingjun,4,4,70,66
1657227201074,CSE 134B,A01,083661,Powell; Thomas Allan,21,0,100,79
1657227207112,CSE 140,A01,083663,Gungor; Onat,13,0,85,72
1657227213133,CSE 140L,A01,083088,Eldon; John,17,0,100,83
1657227219164,CSE 175,A01,083665,Kumar; Rakesh,3,0,25,22
1657227225190,CSE 190,A00,092507,Dubnov; Shlomo,7,0,20,13
1657227231222,ECE 45,A01,083139,Congero; Spencer William,5,0,75,70
1657227237250,ECE 65,A50,083695,Saad; Andrew S,12,0,30,18
1657227237250,ECE 65,A51,095125,Saad; Andrew S,25,0,26,1
1657227243272,ECE 109,A01,091882,Touri; Behrouz,19,0,70,51
1657227249308,ECE 180,A00,083140,Abi Samra; Nicholas Camill,1,0,30,29
1657227249308,ECE 180,B00,083141,Abi Samra; Nicholas Camill,0,0,30,30
1657227255338,MATH 10A,A01,083735,Patchell; Gregory David,2,0,30,28
1657227255338,MATH 10A,A02,083736,Patchell; Gregory David,20,0,30,10
1657227255338,MATH 10A,A03,083737,Patchell; Gregory David,16,0,30,14
1657227261374,MATH 10B,A01,083207,Lim; Seonhee,7,0,34,27
1657227261374,MATH 10B,A02,083208,Lim; Seonhee,9,0,35,26
1657227261374,MATH 10B,A03,093472,Lim; Seonhee,5,0,34,29
1657227261374,MATH 10B,B01,083739,Sinha; Shubham,10,0,30,20
1657227267401,MATH 18,A01,083743,Cinel; Cameron Alexander,6,0,30,24
1657227267401,MATH 18,A02,083744,Cinel; Cameron Alexander,16,0,30,14
1657227267401,MATH 18,A03,083745,Cinel; Cameron Alexander,8,0,30,22
1657227267401,MATH 18,B01,083748,Rideout; David Porter,4,0,37,33
1657227267401,MATH 18,B02,083749,Rideout; David Porter,4,0,36,32
1657227267401,MATH 18,B03,083750,Rideout; David Porter,2,0,37,35
1657227267401,MATH 18,B04,083751,Rideout; David Porter,6,0,36,30
1657227267401,MATH 18,B05,093473,Rideout; David Porter,5,0,36,31
1657227267401,MATH 18,B06,093474,Rideout; David Porter,5,0,36,31
1657227273440,MATH 20A,A01,083754,Zheng; Zequn,14,0,40,26
1657227279469,MATH 20B,A01,083756,Briones; Jor-el Thomas Caparas,2,0,36,34
1657227279469,MATH 20B,A02,083757,Briones; Jor-el Thomas Caparas,1,0,36,35
1657227279469,MATH 20B,A03,093475,Briones; Jor-el Thomas Caparas,2,0,36,34
1657227285502,MATH 20C,A01,083760,Briones; Jor-el Thomas Caparas,1,0,35,34
1657227285502,MATH 20C,A02,083761,Briones; Jor-el Thomas Caparas,8,0,35,27
1657227285502,MATH 20C,A03,093476,Briones; Jor-el Thomas Caparas,0,1,36,36
1657227285502,MATH 20C,B01,083762,Bach; Quang Tran,1,0,30,29
1657227291530,MATH 20D,A01,083765,Tran; Brian Kha,4,0,30,26
1657227291530,MATH 20D,A02,083766,Tran; Brian Kha,5,0,30,25
1657227291530,MATH 20D,A03,083767,Tran; Brian Kha,4,0,30,26
1657227297555,MATH 20E,A01,083771,Ganguly; Soumya,7,0,32,25
1657227297555,MATH 20E,A02,083772,Ganguly; Soumya,7,0,32,25
1657227297555,MATH 20E,B01,083773,Ciotti; Benjamin,19,0,35,16
1657227297555,MATH 20E,B02,083774,Ciotti; Benjamin,17,0,35,18
1657227303585,MATH 103A,A01,083777,Greenfeld; Be'Eri,2,0,36,34
1657227303585,MATH 103A,A02,083778,Greenfeld; Be'Eri,5,0,36,31
1657227303585,MATH 103A,A03,093561,Greenfeld; Be'Eri,4,0,36,32
1657227303585,MATH 103A,B01,083779,Greenfeld; Be'Eri,6,0,36,30
1657227303585,MATH 103A,B02,083780,Greenfeld; Be'Eri,3,0,36,33
1657227303585,MATH 103A,B03,093562,Greenfeld; Be'Eri,3,0,36,33
1657227309608,MATH 105,A01,085443,Carter; Anne Toulson,15,0,35,20
1657227309608,MATH 105,A02,093477,Carter; Anne Toulson,20,0,35,15
1657227315633,MATH 109,A01,083213,Ganzberger; Geoffrey Michael,2,0,34,32
1657227315633,MATH 109,A02,083214,Ganzberger; Geoffrey Michael,4,0,34,30
1657227315633,MATH 109,A03,093478,Ganzberger; Geoffrey Michael,2,0,34,32
1657227315633,MATH 109,B01,083215,Ganzberger; Geoffrey Michael,1,0,32,31
1657227315633,MATH 109,B02,083216,Ganzberger; Geoffrey Michael,1,0,32,31
1657227315633,MATH 109,B03,093479,Ganzberger; Geoffrey Michael,7,0,32,25
1657227321668,MATH 142A,A01,083219,Chow; Bennett,6,0,32,26
1657227321668,MATH 142A,A02,083220,Chow; Bennett,10,0,32,22
1657227321668,MATH 142A,A03,093480,Chow; Bennett,7,0,32,25
1657227321668,MATH 142A,B03,093481,Chow; Bennett,8,0,32,24
1657227321668,MATH 142A,B04,093558,Chow; Bennett,11,0,32,21
1657227321668,MATH 142A,B05,093559,Chow; Bennett,6,0,32,26
1657227327701,MATH 193A,A01,083224,Rotar; Vladimir,7,0,34,27
1657227327701,MATH 193A,A02,083225,Rotar; Vladimir,6,0,34,28
1657227327701,MATH 193A,A03,083781,Rotar; Vladimir,1,0,34,33
1657227327701,MATH 193A,A04,083782,Rotar; Vladimir,8,0,34,26
1657227327701,MATH 193A,A05,093482,Rotar; Vladimir,6,0,34,28
1657227333725,MATH 197,001,091859,McAuley; Julian John,9999,0,9999,0
1657227333725,MATH 197,002,095566,Kedlaya; Kiran S.,9997,0,9999,2
1657227333725,MATH 197,003,095567,Xiao; Ming,9999,0,9999,0
1657227333725,MATH 197,004,095571,Perols; Johan Lars,9998,0,9999,1
1657227340779,COGS 9,A01,083615,Shannon; Kyle Michael,8,0,75,67
1657227346818,COGS 11,A01,083617,Boyle; Mary E. T.,22,0,48,26
1657227352841,COGS 13,A01,083071,Bastos; Amalia Pinkusfeld,8,0,71,63
1657227358875,COGS 14A,A01,092681,Semenuks; Arturs,2,1,100,98
1657227364920,COGS 14B,A01,083073,Cheng; Tzu-Han,6,0,63,57
1657227370958,COGS 17,A01,092677,Semenuks; Arturs,5,0,81,76
1657227376981,COGS 100,A01,083619,Allen; Michael Gordon,15,0,70,55
1657227383007,COGS 101A,A01,083621,Davis; Joshua Daniel,9,0,68,59
1657227389039,COGS 101B,A01,091572,Allen; Michael Gordon,9,0,65,56
1657227395073,COGS 101C,A01,083625,Delgado; Tania,17,0,35,18
1657227401096,COGS 107A,A01,083627,Boyle; Mary E. T.,13,0,60,47
1657227407119,COGS 118A,A01,083075,Gupta; Anjum,16,0,76,60
1657227413146,CSE 3,A50,083646,Miranda; Gregory Joseph,24,0,50,26
1657227419180,CSE 8A,A50,083650,Miranda; Gregory Joseph,17,1,56,39
1657227425207,CSE 11,A01,083080,Cao; Yingjun,5,15,40,35
1657227431234,CSE 12,A01,083652,Krause-Levy; Sophia Louisa,24,1,120,96
1657227437256,CSE 15L,A01,083654,Morris; Justin Loren,9,0,50,41
1657227437256,CSE 15L,A02,083655,Morris; Justin Loren,9,0,50,41
1657227443300,CSE 20,A01,083657,Tran; Khoa Dang,38,0,80,42
1657227449335,CSE 21,A01,095574,Bach; Quang Tran,22,0,48,26
1657227455368,CSE 30,A01,083084,Eldon; John,4,0,80,76
1657227455368,CSE 30,B01,095061,Bhaskar; Nishant,8,0,50,42
1657227461391,CSE 100,A01,083659,Cao; Yingjun,4,4,70,66
1657227467422,CSE 134B,A01,083661,Powell; Thomas Allan,21,0,100,79
1657227473445,CSE 140,A01,083663,Gungor; Onat,13,0,85,72
1657227479469,CSE 140L,A01,083088,Eldon; John,17,0,100,83
1657227485505,CSE 175,A01,083665,Kumar; Rakesh,3,0,25,22
1657227491534,CSE 190,A00,092507,Dubnov; Shlomo,7,0,20,13
1657227497558,ECE 45,A01,083139,Congero; Spencer William,5,0,75,70
1657227503580,ECE 65,A50,083695,Saad; Andrew S,12,0,30,18
1657227503580,ECE 65,A51,095125,Saad; Andrew S,25,0,26,1
1657227509606,ECE 109,A01,091882,Touri; Behrouz,19,0,70,51
1657227515634,ECE 180,A00,083140,Abi Samra; Nicholas Camill,1,0,30,29
1657227515634,ECE 180,B00,083141,Abi Samra; Nicholas Camill,0,0,30,30
1657227521663,MATH 10A,A01,083735,Patchell; Gregory David,2,0,30,28
1657227521663,MATH 10A,A02,083736,Patchell; Gregory David,20,0,30,10
1657227521663,MATH 10A,A03,083737,Patchell; Gregory David,16,0,30,14
1657227527688,MATH 10B,A01,083207,Lim; Seonhee,7,0,34,27
1657227527688,MATH 10B,A02,083208,Lim; Seonhee,9,0,35,26
1657227527688,MATH 10B,A03,093472,Lim; Seonhee,5,0,34,29
1657227527688,MATH 10B,B01,083739,Sinha; Shubham,10,0,30,20
1657227533734,MATH 18,A01,083743,Cinel; Cameron Alexander,6,0,30,24
1657227533734,MATH 18,A02,083744,Cinel; Cameron Alexander,16,0,30,14
1657227533734,MATH 18,A03,083745,Cinel; Cameron Alexander,8,0,30,22
1657227533734,MATH 18,B01,083748,Rideout; David Porter,4,0,37,33
1657227533734,MATH 18,B02,083749,Rideout; David Porter,4,0,36,32
1657227533734,MATH 18,B03,083750,Rideout; David Porter,2,0,37,35
1657227533734,MATH 18,B04,083751,Rideout; David Porter,6,0,36,30
1657227533734,MATH 18,B05,093473,Rideout; David Porter,5,0,36,31
1657227533734,MATH 18,B06,093474,Rideout; David Porter,5,0,36,31
1657227539767,MATH 20A,A01,083754,Zheng; Zequn,14,0,40,26
1657227545803,MATH 20B,A01,083756,Briones; Jor-el Thomas Caparas,2,0,36,34
1657227545803,MATH 20B,A02,083757,Briones; Jor-el Thomas Caparas,1,0,36,35
1657227545803,MATH 20B,A03,093475,Briones; Jor-el Thomas Caparas,2,0,36,34
1657227551826,MATH 20C,A01,083760,Briones; Jor-el Thomas Caparas,1,0,35,34
1657227551826,MATH 20C,A02,083761,Briones; Jor-el Thomas Caparas,8,0,35,27
1657227551826,MATH 20C,A03,093476,Briones; Jor-el Thomas Caparas,0,1,36,36
1657227551826,MATH 20C,B01,083762,Bach; Quang Tran,1,0,30,29
1657227557861,MATH 20D,A01,083765,Tran; Brian Kha,4,0,30,26
1657227557861,MATH 20D,A02,083766,Tran; Brian Kha,5,0,30,25
1657227557861,MATH 20D,A03,083767,Tran; Brian Kha,4,0,30,26
1657227563892,MATH 20E,A01,083771,Ganguly; Soumya,7,0,32,25
1657227563892,MATH 20E,A02,083772,Ganguly; Soumya,7,0,32,25
1657227563892,MATH 20E,B01,083773,Ciotti; Benjamin,19,0,35,16
1657227563892,MATH 20E,B02,083774,Ciotti; Benjamin,17,0,35,18
1657227569927,MATH 103A,A01,083777,Greenfeld; Be'Eri,2,0,36,34
1657227569927,MATH 103A,A02,083778,Greenfeld; Be'Eri,5,0,36,31
1657227569927,MATH 103A,A03,093561,Greenfeld; Be'Eri,4,0,36,32
1657227569927,MATH 103A,B01,083779,Greenfeld; Be'Eri,6,0,36,30
1657227569927,MATH 103A,B02,083780,Greenfeld; Be'Eri,3,0,36,33
1657227569927,MATH 103A,B03,093562,Greenfeld; Be'Eri,3,0,36,33
1657227575953,MATH 105,A01,085443,Carter; Anne Toulson,15,0,35,20
1657227575953,MATH 105,A02,093477,Carter; Anne Toulson,20,0,35,15
1657227581981,MATH 109,A01,083213,Ganzberger; Geoffrey Michael,2,0,34,32
1657227581981,MATH 109,A02,083214,Ganzberger; Geoffrey Michael,4,0,34,30
1657227581981,MATH 109,A03,093478,Ganzberger; Geoffrey Michael,2,0,34,32
1657227581981,MATH 109,B01,083215,Ganzberger; Geoffrey Michael,1,0,32,31
1657227581981,MATH 109,B02,083216,Ganzberger; Geoffrey Michael,1,0,32,31
1657227581981,MATH 109,B03,093479,Ganzberger; Geoffrey Michael,7,0,32,25
1657227588004,MATH 142A,A01,083219,Chow; Bennett,6,0,32,26
1657227588004,MATH 142A,A02,083220,Chow; Bennett,10,0,32,22
1657227588004,MATH 142A,A03,093480,Chow; Bennett,7,0,32,25
1657227588004,MATH 142A,B03,093481,Chow; Bennett,8,0,32,24
1657227588004,MATH 142A,B04,093558,Chow; Bennett,11,0,32,21
1657227588004,MATH 142A,B05,093559,Chow; Bennett,6,0,32,26
1657227594028,MATH 193A,A01,083224,Rotar; Vladimir,7,0,34,27
1657227594028,MATH 193A,A02,083225,Rotar; Vladimir,6,0,34,28
1657227594028,MATH 193A,A03,083781,Rotar; Vladimir,1,0,34,33
1657227594028,MATH 193A,A04,083782,Rotar; Vladimir,8,0,34,26
1657227594028,MATH 193A,A05,093482,Rotar; Vladimir,6,0,34,28
1657227600064,MATH 197,001,091859,McAuley; Julian John,9999,0,9999,0
1657227600064,MATH 197,002,095566,Kedlaya; Kiran S.,9997,0,9999,2
1657227600064,MATH 197,003,095567,Xiao; Ming,9999,0,9999,0
1657227600064,MATH 197,004,095571,Perols; Johan Lars,9998,0,9999,1
1657227607131,COGS 9,A01,083615,Shannon; Kyle Michael,8,0,75,67
1657227613155,COGS 11,A01,083617,Boyle; Mary E. T.,22,0,48,26
1657227619183,COGS 13,A01,083071,Bastos; Amalia Pinkusfeld,8,0,71,63
1657227625206,COGS 14A,A01,092681,Semenuks; Arturs,2,1,100,98
1657227631323,COGS 14B,A01,083073,Cheng; Tzu-Han,6,0,63,57
1657227637350,COGS 17,A01,092677,Semenuks; Arturs,5,0,81,76
1657227643376,COGS 100,A01,083619,Allen; Michael Gordon,15,0,70,55
1657227649399,COGS 101A,A01,083621,Davis; Joshua Daniel,9,0,68,59
1657227655423,COGS 101B,A01,091572,Allen; Michael Gordon,9,0,65,56
1657227661445,COGS 101C,A01,083625,Delgado; Tania,17,0,35,18
1657227667468,COGS 107A,A01,083627,Boyle; Mary E. T.,13,0,60,47
1657227673500,COGS 118A,A01,083075,Gupta; Anjum,16,0,76,60
1657227679527,CSE 3,A50,083646,Miranda; Gregory Joseph,24,0,50,26
1657227685550,CSE 8A,A50,083650,Miranda; Gregory Joseph,17,1,56,39
1657227691593,CSE 11,A01,083080,Cao; Yingjun,5,15,40,35
1657227697620,CSE 12,A01,083652,Krause-Levy; Sophia Louisa,24,1,120,96
1657227703647,CSE 15L,A01,083654,Morris; Justin Loren,9,0,50,41
1657227703647,CSE 15L,A02,083655,Morris; Justin Loren,9,0,50,41
1657227709669,CSE 20,A01,083657,Tran; Khoa Dang,38,0,80,42
1657227715692,CSE 21,A01,095574,Bach; Quang Tran,22,0,48,26
1657227721732,CSE 30,A01,083084,Eldon; John,4,0,80,76
1657227721732,CSE 30,B01,095061,Bhaskar; Nishant,8,0,50,42
1657227727754,CSE 100,A01,083659,Cao; Yingjun,4,4,70,66
1657227733778,CSE 134B,A01,083661,Powell; Thomas Allan,21,0,100,79
1657227739809,CSE 140,A01,083663,Gungor; Onat,13,0,85,72
1657227745841,CSE 140L,A01,083088,Eldon; John,17,0,100,83
1657227751882,CSE 175,A01,083665,Kumar; Rakesh,3,0,25,22
1657227757907,CSE 190,A00,092507,Dubnov; Shlomo,7,0,20,13
1657227763933,ECE 45,A01,083139,Congero; Spencer William,5,0,75,70
1657227769957,ECE 65,A50,083695,Saad; Andrew S,12,0,30,18
1657227769957,ECE 65,A51,095125,Saad; Andrew S,25,0,26,1
1657227775980,ECE 109,A01,091882,Touri; Behrouz,19,0,70,51
1657227782007,ECE 180,A00,083140,Abi Samra; Nicholas Camill,1,0,30,29
1657227782007,ECE 180,B00,083141,Abi Samra; Nicholas Camill,0,0,30,30
1657227788042,MATH 10A,A01,083735,Patchell; Gregory David,2,0,30,28
1657227788042,MATH 10A,A02,083736,Patchell; Gregory David,20,0,30,10
1657227788042,MATH 10A,A03,083737,Patchell; Gregory David,16,0,30,14
1657227794071,MATH 10B,A01,083207,Lim; Seonhee,7,0,34,27
1657227794071,MATH 10B,A02,083208,Lim; Seonhee,9,0,35,26
1657227794071,MATH 10B,A03,093472,Lim; Seonhee,5,0,34,29
1657227794071,MATH 10B,B01,083739,Sinha; Shubham,10,0,30,20
1657227800109,MATH 18,A01,083743,Cinel; Cameron Alexander,6,0,30,24
1657227800109,MATH 18,A02,083744,Cinel; Cameron Alexander,16,0,30,14
1657227800109,MATH 18,A03,083745,Cinel; Cameron Alexander,8,0,30,22
1657227800109,MATH 18,B01,083748,Rideout; David Porter,4,0,37,33
1657227800109,MATH 18,B02,083749,Rideout; David Porter,4,0,36,32
1657227800109,MATH 18,B03,083750,Rideout; David Porter,2,0,37,35
1657227800109,MATH 18,B04,083751,Rideout; David Porter,6,0,36,30
1657227800109,MATH 18,B05,093473,Rideout; David Porter,5,0,36,31
1657227800109,MATH 18,B06,093474,Rideout; David Porter,5,0,36,31
1657227806136,MATH 20A,A01,083754,Zheng; Zequn,14,0,40,26
1657227812164,MATH 20B,A01,083756,Briones; Jor-el Thomas Caparas,2,0,36,34
1657227812164,MATH 20B,A02,083757,Briones; Jor-el Thomas Caparas,1,0,36,35
1657227812164,MATH 20B,A03,093475,Briones; Jor-el Thomas Caparas,2,0,36,34
1657227818190,MATH 20C,A01,083760,Briones; Jor-el Thomas Caparas,1,0,35,34
1657227818190,MATH 20C,A02,083761,Briones; Jor-el Thomas Caparas,8,0,35,27
1657227818190,MATH 20C,A03,093476,Briones; Jor-el Thomas Caparas,0,1,36,36
1657227818190,MATH 20C,B01,083762,Bach; Quang Tran,1,0,30,29
1657227824229,MATH 20D,A01,083765,Tran; Brian Kha,4,0,30,26
1657227824229,MATH 20D,A02,083766,Tran; Brian Kha,5,0,30,25
1657227824229,MATH 20D,A03,083767,Tran; Brian Kha,4,0,30,26
1657227830254,MATH 20E,A01,083771,Ganguly; Soumya,7,0,32,25
1657227830254,MATH 20E,A02,083772,Ganguly; Soumya,7,0,32,25
1657227830254,MATH 20E,B01,083773,Ciotti; Benjamin,19,0,35,16
1657227830254,MATH 20E,B02,083774,Ciotti; Benjamin,17,0,35,18
1657227836285,MATH 103A,A01,083777,Greenfeld; Be'Eri,2,0,36,34
1657227836285,MATH 103A,A02,083778,Greenfeld; Be'Eri,5,0,36,31
1657227836285,MATH 103A,A03,093561,Greenfeld; Be'Eri,4,0,36,32
1657227836285,MATH 103A,B01,083779,Greenfeld; Be'Eri,6,0,36,30
1657227836285,MATH 103A,B02,083780,Greenfeld; Be'Eri,3,0,36,33
1657227836285,MATH 103A,B03,093562,Greenfeld; Be'Eri,3,0,36,33
1657227842311,MATH 105,A01,085443,Carter; Anne Toulson,15,0,35,20
1657227842311,MATH 105,A02,093477,Carter; Anne Toulson,20,0,35,15
1657227848341,MATH 109,A01,083213,Ganzberger; Geoffrey Michael,2,0,34,32
1657227848341,MATH 109,A02,083214,Ganzberger; Geoffrey Michael,4,0,34,30
1657227848341,MATH 109,A03,093478,Ganzberger; Geoffrey Michael,2,0,34,32
1657227848341,MATH 109,B01,083215,Ganzberger; Geoffrey Michael,1,0,32,31
1657227848341,MATH 109,B02,083216,Ganzberger; Geoffrey Michael,1,0,32,31
1657227848341,MATH 109,B03,093479,Ganzberger; Geoffrey Michael,7,0,32,25
1657227854367,MATH 142A,A01,083219,Chow; Bennett,6,0,32,26
1657227854367,MATH 142A,A02,083220,Chow; Bennett,10,0,32,22
1657227854367,MATH 142A,A03,093480,Chow; Bennett,7,0,32,25
1657227854367,MATH 142A,B03,093481,Chow; Bennett,8,0,32,24
1657227854367,MATH 142A,B04,093558,Chow; Bennett,11,0,32,21
1657227854367,MATH 142A,B05,093559,Chow; Bennett,6,0,32,26
1657227860398,MATH 193A,A01,083224,Rotar; Vladimir,7,0,34,27
1657227860398,MATH 193A,A02,083225,Rotar; Vladimir,6,0,34,28
1657227860398,MATH 193A,A03,083781,Rotar; Vladimir,1,0,34,33
1657227860398,MATH 193A,A04,083782,Rotar; Vladimir,8,0,34,26
1657227860398,MATH 193A,A05,093482,Rotar; Vladimir,6,0,34,28
1657227866421,MATH 197,001,091859,McAuley; Julian John,9999,0,9999,0
1657227866421,MATH 197,002,095566,Kedlaya; Kiran S.,9997,0,9999,2
1657227866421,MATH 197,003,095567,Xiao; Ming,9999,0,9999,0
1657227866421,MATH 197,004,095571,Perols; Johan Lars,9998,0,9999,1
1657227873490,COGS 9,A01,083615,Shannon; Kyle Michael,8,0,75,67
1657227879525,COGS 11,A01,083617,Boyle; Mary E. T.,22,0,48,26
1657227885547,COGS 13,A01,083071,Bastos; Amalia Pinkusfeld,8,0,71,63
1657227891573,COGS 14A,A01,092681,Semenuks; Arturs,2,1,100,98
1657227897603,COGS 14B,A01,083073,Cheng; Tzu-Han,6,0,63,57
1657227903626,COGS 17,A01,092677,Semenuks; Arturs,5,0,81,76
1657227909654,COGS 100,A01,083619,Allen; Michael Gordon,16,0,70,54
1657227915682,COGS 101A,A01,083621,Davis; Joshua Daniel,9,0,68,59
1657227921717,COGS 101B,A01,091572,Allen; Michael Gordon,9,0,65,56
1657227927743,COGS 101C,A01,083625,Delgado; Tania,17,0,35,18
1657227933766,COGS 107A,A01,083627,Boyle; Mary E. T.,13,0,60,47
1657227939791,COGS 118A,A01,083075,Gupta; Anjum,16,0,76,60
1657227945814,CSE 3,A50,083646,Miranda; Gregory Joseph,24,0,50,26
1657227951846,CSE 8A,A50,083650,Miranda; Gregory Joseph,17,1,56,39
1657227957873,CSE 11,A01,083080,Cao; Yingjun,5,15,40,35
1657227963896,CSE 12,A01,083652,Krause-Levy; Sophia Louisa,24,1,120,96
1657227969932,CSE 15L,A01,083654,Morris; Justin Loren,9,0,50,41
1657227969932,CSE 15L,A02,083655,Morris; Justin Loren,9,0,50,41
1657227975959,CSE 20,A01,083657,Tran; Khoa Dang,38,0,80,42
1657227981981,CSE 21,A01,095574,Bach; Quang Tran,22,0,48,26
1657227988006,CSE 30,A01,083084,Eldon; John,4,0,80,76
1657227988006,CSE 30,B01,095061,Bhaskar; Nishant,8,0,50,42
1657227994035,CSE 100,A01,083659,Cao; Yingjun,4,4,70,66
1657228000062,CSE 134B,A01,083661,Powell; Thomas Allan,21,0,100,79
1657228006087,CSE 140,A01,083663,Gungor; Onat,13,0,85,72
1657228012114,CSE 140L,A01,083088,Eldon; John,17,0,100,83
1657228018138,CSE 175,A01,083665,Kumar; Rakesh,3,0,25,22
1657228024165,CSE 190,A00,092507,Dubnov; Shlomo,7,0,20,13
1657228030188,ECE 45,A01,083139,Congero; Spencer William,5,0,75,70
1657228036223,ECE 65,A50,083695,Saad; Andrew S,12,0,30,18
1657228036223,ECE 65,A51,095125,Saad; Andrew S,25,0,26,1
1657228042246,ECE 109,A01,091882,Touri; Behrouz,19,0,70,51
1657228048273,ECE 180,A00,083140,Abi Samra; Nicholas Camill,1,0,30,29
1657228048273,ECE 180,B00,083141,Abi Samra; Nicholas Camill,0,0,30,30
1657228054297,MATH 10A,A01,083735,Patchell; Gregory David,2,0,30,28
1657228054297,MATH 10A,A02,083736,Patchell; Gregory David,20,0,30,10
1657228054297,MATH 10A,A03,083737,Patchell; Gregory David,16,0,30,14
1657228060330,MATH 10B,A01,083207,Lim; Seonhee,7,0,34,27
1657228060330,MATH 10B,A02,083208,Lim; Seonhee,9,0,35,26
1657228060330,MATH 10B,A03,093472,Lim; Seonhee,5,0,34,29
1657228060330,MATH 10B,B01,083739,Sinha; Shubham,10,0,30,20
1657228066356,MATH 18,A01,083743,Cinel; Cameron Alexander,6,0,30,24
1657228066356,MATH 18,A02,083744,Cinel; Cameron Alexander,16,0,30,14
1657228066356,MATH 18,A03,083745,Cinel; Cameron Alexander,8,0,30,22
1657228066356,MATH 18,B01,083748,Rideout; David Porter,4,0,37,33
1657228066356,MATH 18,B02,083749,Rideout; David Porter,4,0,36,32
1657228066356,MATH 18,B03,083750,Rideout; David Porter,2,0,37,35
1657228066356,MATH 18,B04,083751,Rideout; David Porter,6,0,36,30
1657228066356,MATH 18,B05,093473,Rideout; David Porter,5,0,36,31
1657228066356,MATH 18,B06,093474,Rideout; David Porter,5,0,36,31
1657228072379,MATH 20A,A01,083754,Zheng; Zequn,14,0,40,26
1657228078403,MATH 20B,A01,083756,Briones; Jor-el Thomas Caparas,2,0,36,34
1657228078403,MATH 20B,A02,083757,Briones; Jor-el Thomas Caparas,1,0,36,35
1657228078403,MATH 20B,A03,093475,Briones; Jor-el Thomas Caparas,2,0,36,34
1657228084431,MATH 20C,A01,083760,Briones; Jor-el Thomas Caparas,1,0,35,34
1657228084431,MATH 20C,A02,083761,Briones; Jor-el Thomas Caparas,8,0,35,27
1657228084431,MATH 20C,A03,093476,Briones; Jor-el Thomas Caparas,0,1,36,36
1657228084431,MATH 20C,B01,083762,Bach; Quang Tran,1,0,30,29
1657228090455,MATH 20D,A01,083765,Tran; Brian Kha,4,0,30,26
1657228090455,MATH 20D,A02,083766,Tran; Brian Kha,5,0,30,25
1657228090455,MATH 20D,A03,083767,Tran; Brian Kha,4,0,30,26
1657228096482,MATH 20E,A01,083771,Ganguly; Soumya,7,0,32,25
1657228096482,MATH 20E,A02,083772,Ganguly; Soumya,7,0,32,25
1657228096482,MATH 20E,B01,083773,Ciotti; Benjamin,19,0,35,16
1657228096482,MATH 20E,B02,083774,Ciotti; Benjamin,17,0,35,18
1657228102505,MATH 103A,A01,083777,Greenfeld; Be'Eri,3,0,36,33
1657228102505,MATH 103A,A02,083778,Greenfeld; Be'Eri,5,0,36,31
1657228102505,MATH 103A,A03,093561,Greenfeld; Be'Eri,4,0,36,32
1657228102505,MATH 103A,B01,083779,Greenfeld; Be'Eri,6,0,36,30
1657228102505,MATH 103A,B02,083780,Greenfeld; Be'Eri,3,0,36,33
1657228102505,MATH 103A,B03,093562,Greenfeld; Be'Eri,3,0,36,33
1657228108528,MATH 105,A01,085443,Carter; Anne Toulson,15,0,35,20
1657228108528,MATH 105,A02,093477,Carter; Anne Toulson,20,0,35,15
1657228114562,MATH 109,A01,083213,Ganzberger; Geoffrey Michael,2,0,34,32
1657228114562,MATH 109,A02,083214,Ganzberger; Geoffrey Michael,4,0,34,30
1657228114562,MATH 109,A03,093478,Ganzberger; Geoffrey Michael,2,0,34,32
1657228114562,MATH 109,B01,083215,Ganzberger; Geoffrey Michael,1,0,32,31
1657228114562,MATH 109,B02,083216,Ganzberger; Geoffrey Michael,1,0,32,31
1657228114562,MATH 109,B03,093479,Ganzberger; Geoffrey Michael,7,0,32,25
1657228120590,MATH 142A,A01,083219,Chow; Bennett,6,0,32,26
1657228120590,MATH 142A,A02,083220,Chow; Bennett,10,0,32,22
1657228120590,MATH 142A,A03,093480,Chow; Bennett,7,0,32,25
1657228120590,MATH 142A,B03,093481,Chow; Bennett,8,0,32,24
1657228120590,MATH 142A,B04,093558,Chow; Bennett,12,0,32,20
1657228120590,MATH 142A,B05,093559,Chow; Bennett,6,0,32,26
1657228126625,MATH 193A,A01,083224,Rotar; Vladimir,7,0,34,27
1657228126625,MATH 193A,A02,083225,Rotar; Vladimir,6,0,34,28
1657228126625,MATH 193A,A03,083781,Rotar; Vladimir,2,0,34,32
1657228126625,MATH 193A,A04,083782,Rotar; Vladimir,8,0,34,26
1657228126625,MATH 193A,A05,093482,Rotar; Vladimir,6,0,34,28
1657228132646,MATH 197,001,091859,McAuley; Julian John,9999,0,9999,0
1657228132646,MATH 197,002,095566,Kedlaya; Kiran S.,9997,0,9999,2
1657228132646,MATH 197,003,095567,Xiao; Ming,9999,0,9999,0
1657228132646,MATH 197,004,095571,Perols; Johan Lars,9998,0,9999,1
1657228139747,COGS 9,A01,083615,Shannon; Kyle Michael,8,0,75,67
1657228145769,COGS 11,A01,083617,Boyle; Mary E. T.,22,0,48,26
1657228151792,COGS 13,A01,083071,Bastos; Amalia Pinkusfeld,8,0,71,63
1657228157819,COGS 14A,A01,092681,Semenuks; Arturs,2,1,100,98
1657228163841,COGS 14B,A01,083073,Cheng; Tzu-Han,6,0,63,57
1657228169867,COGS 17,A01,092677,Semenuks; Arturs,5,0,81,76
1657228175890,COGS 100,A01,083619,Allen; Michael Gordon,16,0,70,54
1657228181915,COGS 101A,A01,083621,Davis; Joshua Daniel,9,0,68,59
1657228187939,COGS 101B,A01,091572,Allen; Michael Gordon,9,0,65,56
1657228193965,COGS 101C,A01,083625,Delgado; Tania,17,0,35,18
1657228199987,COGS 107A,A01,083627,Boyle; Mary E. T.,13,0,60,47
1657228206012,COGS 118A,A01,083075,Gupta; Anjum,16,0,76,60
1657228212045,CSE 3,A50,083646,Miranda; Gregory Joseph,24,0,50,26
1657228218072,CSE 8A,A50,083650,Miranda; Gregory Joseph,17,1,56,39
1657228224096,CSE 11,A01,083080,Cao; Yingjun,5,15,40,35
1657228230194,CSE 12,A01,083652,Krause-Levy; Sophia Louisa,24,1,120,96
1657228236220,CSE 15L,A01,083654,Morris; Justin Loren,9,0,50,41
1657228236220,CSE 15L,A02,083655,Morris; Justin Loren,9,0,50,41
1657228242248,CSE 20,A01,083657,Tran; Khoa Dang,38,0,80,42
1657228248274,CSE 21,A01,095574,Bach; Quang Tran,22,0,48,26
1657228254300,CSE 30,A01,083084,Eldon; John,4,0,80,76
1657228254300,CSE 30,B01,095061,Bhaskar; Nishant,8,0,50,42
1657228260329,CSE 100,A01,083659,Cao; Yingjun,4,4,70,66
1657228266352,CSE 134B,A01,083661,Powell; Thomas Allan,21,0,100,79
1657228272375,CSE 140,A01,083663,Gungor; Onat,13,0,85,72
1657228278397,CSE 140L,A01,083088,Eldon; John,17,0,100,83
1657228284419,CSE 175,A01,083665,Kumar; Rakesh,3,0,25,22
1657228290441,CSE 190,A00,092507,Dubnov; Shlomo,7,0,20,13
1657228296469,ECE 45,A01,083139,Congero; Spencer William,5,0,75,70
1657228302500,ECE 65,A50,083695,Saad; Andrew S,12,0,30,18
1657228302500,ECE 65,A51,095125,Saad; Andrew S,25,0,26,1
1657228308533,ECE 109,A01,091882,Touri; Behrouz,19,0,70,51
1657228314556,ECE 180,A00,083140,Abi Samra; Nicholas Camill,1,0,30,29
1657228314556,ECE 180,B00,083141,Abi Samra; Nicholas Camill,0,0,30,30
1657228320584,MATH 10A,A01,083735,Patchell; Gregory David,2,0,30,28
1657228320584,MATH 10A,A02,083736,Patchell; Gregory David,20,0,30,10
1657228320584,MATH 10A,A03,083737,Patchell; Gregory David,16,0,30,14
1657228326613,MATH 10B,A01,083207,Lim; Seonhee,7,0,34,27
1657228326613,MATH 10B,A02,083208,Lim; Seonhee,9,0,35,26
1657228326613,MATH 10B,A03,093472,Lim; Seonhee,5,0,34,29
1657228326613,MATH 10B,B01,083739,Sinha; Shubham,10,0,30,20
1657228332637,MATH 18,A01,083743,Cinel; Cameron Alexander,6,0,30,24
1657228332637,MATH 18,A02,083744,Cinel; Cameron Alexander,16,0,30,14
1657228332637,MATH 18,A03,083745,Cinel; Cameron Alexander,8,0,30,22
1657228332637,MATH 18,B01,083748,Rideout; David Porter,4,0,37,33
1657228332637,MATH 18,B02,083749,Rideout; David Porter,4,0,36,32
1657228332637,MATH 18,B03,083750,Rideout; David Porter,2,0,37,35
1657228332637,MATH 18,B04,083751,Rideout; David Porter,6,0,36,30
1657228332637,MATH 18,B05,093473,Rideout; David Porter,5,0,36,31
1657228332637,MATH 18,B06,093474,Rideout; David Porter,5,0,36,31
1657228338670,MATH 20A,A01,083754,Zheng; Zequn,14,0,40,26
1657228344697,MATH 20B,A01,083756,Briones; Jor-el Thomas Caparas,2,0,36,34
1657228344697,MATH 20B,A02,083757,Briones; Jor-el Thomas Caparas,1,0,36,35
1657228344697,MATH 20B,A03,093475,Briones; Jor-el Thomas Caparas,2,0,36,34
1657228350720,MATH 20C,A01,083760,Briones; Jor-el Thomas Caparas,1,0,35,34
1657228350720,MATH 20C,A02,083761,Briones; Jor-el Thomas Caparas,8,0,35,27
1657228350720,MATH 20C,A03,093476,Briones; Jor-el Thomas Caparas,0,1,36,36
1657228350720,MATH 20C,B01,083762,Bach; Quang Tran,1,0,30,29
1657228356748,MATH 20D,A01,083765,Tran; Brian Kha,4,0,30,26
1657228356748,MATH 20D,A02,083766,Tran; Brian Kha,5,0,30,25
1657228356748,MATH 20D,A03,083767,Tran; Brian Kha,4,0,30,26
1657228362773,MATH 20E,A01,083771,Ganguly; Soumya,7,0,32,25
1657228362773,MATH 20E,A02,083772,Ganguly; Soumya,7,0,32,25
1657228362773,MATH 20E,B01,083773,Ciotti; Benjamin,19,0,35,16
1657228362773,MATH 20E,B02,083774,Ciotti; Benjamin,17,0,35,18
1657228368797,MATH 103A,A01,083777,Greenfeld; Be'Eri,3,0,36,33
1657228368797,MATH 103A,A02,083778,Greenfeld; Be'Eri,5,0,36,31
1657228368797,MATH 103A,A03,093561,Greenfeld; Be'Eri,4,0,36,32
1657228368797,MATH 103A,B01,083779,Greenfeld; Be'Eri,6,0,36,30
1657228368797,MATH 103A,B02,083780,Greenfeld; Be'Eri,3,0,36,33
1657228368797,MATH 103A,B03,093562,Greenfeld; Be'Eri,3,0,36,33
1657228374823,MATH 105,A01,085443,Carter; Anne Toulson,15,0,35,20
1657228374823,MATH 105,A02,093477,Carter; Anne Toulson,20,0,35,15
1657228380860,MATH 109,A01,083213,Ganzberger; Geoffrey Michael,2,0,34,32
1657228380860,MATH 109,A02,083214,Ganzberger; Geoffrey Michael,4,0,34,30
1657228380860,MATH 109,A03,093478,Ganzberger; Geoffrey Michael,2,0,34,32
1657228380860,MATH 109,B01,083215,Ganzberger; Geoffrey Michael,1,0,32,31
1657228380860,MATH 109,B02,083216,Ganzberger; Geoffrey Michael,1,0,32,31
1657228380860,MATH 109,B03,093479,Ganzberger; Geoffrey Michael,7,0,32,25
1657228386883,MATH 142A,A01,083219,Chow; Bennett,6,0,32,26
1657228386883,MATH 142A,A02,083220,Chow; Bennett,10,0,32,22
1657228386883,MATH 142A,A03,093480,Chow; Bennett,7,0,32,25
1657228386883,MATH 142A,B03,093481,Chow; Bennett,8,0,32,24
1657228386883,MATH 142A,B04,093558,Chow; Bennett,12,0,32,20
1657228386883,MATH 142A,B05,093559,Chow; Bennett,6,0,32,26
1657228392912,MATH 193A,A01,083224,Rotar; Vladimir,7,0,34,27
1657228392912,MATH 193A,A02,083225,Rotar; Vladimir,6,0,34,28
1657228392912,MATH 193A,A03,083781,Rotar; Vladimir,2,0,34,32
1657228392912,MATH 193A,A04,083782,Rotar; Vladimir,8,0,34,26
1657228392912,MATH 193A,A05,093482,Rotar; Vladimir,6,0,34,28
1657228398947,MATH 197,001,091859,McAuley; Julian John,9999,0,9999,0
1657228398947,MATH 197,002,095566,Kedlaya; Kiran S.,9997,0,9999,2
1657228398947,MATH 197,003,095567,Xiao; Ming,9999,0,9999,0
1657228398947,MATH 197,004,095571,Perols; Johan Lars,9998,0,9999,1
1657228405996,COGS 9,A01,083615,Shannon; Kyle Michael,8,0,75,67
1657228412017,COGS 11,A01,083617,Boyle; Mary E. T.,22,0,48,26
1657228418040,COGS 13,A01,083071,Bastos; Amalia Pinkusfeld,8,0,71,63
1657228424062,COGS 14A,A01,092681,Semenuks; Arturs,2,1,100,98
1657228430088,COGS 14B,A01,083073,Cheng; Tzu-Han,6,0,63,57
1657228436110,COGS 17,A01,092677,Semenuks; Arturs,5,0,81,76
1657228442134,COGS 100,A01,083619,Allen; Michael Gordon,16,0,70,54
1657228448157,COGS 101A,A01,083621,Davis; Joshua Daniel,9,0,68,59
1657228454185,COGS 101B,A01,091572,Allen; Michael Gordon,9,0,65,56
1657228460209,COGS 101C,A01,083625,Delgado; Tania,17,0,35,18
1657228466236,COGS 107A,A01,083627,Boyle; Mary E. T.,13,0,60,47
1657228472268,COGS 118A,A01,083075,Gupta; Anjum,16,0,76,60
1657228478293,CSE 3,A50,083646,Miranda; Gregory Joseph,24,0,50,26
1657228484322,CSE 8A,A50,083650,Miranda; Gregory Joseph,17,1,56,39
1657228490346,CSE 11,A01,083080,Cao; Yingjun,5,15,40,35
1657228496370,CSE 12,A01,083652,Krause-Levy; Sophia Louisa,24,1,120,96
1657228502391,CSE 15L,A01,083654,Morris; Justin Loren,9,0,50,41
1657228502391,CSE 15L,A02,083655,Morris; Justin Loren,9,0,50,41
1657228508413,CSE 20,A01,083657,Tran; Khoa Dang,38,0,80,42
1657228514454,CSE 21,A01,095574,Bach; Quang Tran,22,0,48,26
1657228520477,CSE 30,A01,083084,Eldon; John,4,0,80,76
1657228520477,CSE 30,B01,095061,Bhaskar; Nishant,8,0,50,42
1657228526510,CSE 100,A01,083659,Cao; Yingjun,4,4,70,66
1657228532536,CSE 134B,A01,083661,Powell; Thomas Allan,21,0,100,79
1657228538561,CSE 140,A01,083663,Gungor; Onat,13,0,85,72
1657228544593,CSE 140L,A01,083088,Eldon; John,17,0,100,83
1657228550617,CSE 175,A01,083665,Kumar; Rakesh,3,0,25,22
1657228556652,CSE 190,A00,092507,Dubnov; Shlomo,7,0,20,13
1657228562682,ECE 45,A01,083139,Congero; Spencer William,5,0,75,70
1657228568710,ECE 65,A50,083695,Saad; Andrew S,12,0,30,18
1657228568710,ECE 65,A51,095125,Saad; Andrew S,25,0,26,1
1657228574733,ECE 109,A01,091882,Touri; Behrouz,19,0,70,51
1657228580760,ECE 180,A00,083140,Abi Samra; Nicholas Camill,1,0,30,29
1657228580760,ECE 180,B00,083141,Abi Samra; Nicholas Camill,0,0,30,30
1657228586788,MATH 10A,A01,083735,Patchell; Gregory David,2,0,30,28
1657228586788,MATH 10A,A02,083736,Patchell; Gregory David,20,0,30,10
1657228586788,MATH 10A,A03,083737,Patchell; Gregory David,16,0,30,14
1657228592823,MATH 10B,A01,083207,Lim; Seonhee,7,0,34,27
1657228592823,MATH 10B,A02,083208,Lim; Seonhee,9,0,35,26
1657228592823,MATH 10B,A03,093472,Lim; Seonhee,5,0,34,29
1657228592823,MATH 10B,B01,083739,Sinha; Shubham,10,0,30,20
1657228598856,MATH 18,A01,083743,Cinel; Cameron Alexander,6,0,30,24
1657228598856,MATH 18,A02,083744,Cinel; Cameron Alexander,16,0,30,14
1657228598856,MATH 18,A03,083745,Cinel; Cameron Alexander,8,0,30,22
1657228598856,MATH 18,B01,083748,Rideout; David Porter,4,0,37,33
1657228598856,MATH 18,B02,083749,Rideout; David Porter,4,0,36,32
1657228598856,MATH 18,B03,083750,Rideout; David Porter,2,0,37,35
1657228598856,MATH 18,B04,083751,Rideout; David Porter,6,0,36,30
1657228598856,MATH 18,B05,093473,Rideout; David Porter,5,0,36,31
1657228598856,MATH 18,B06,093474,Rideout; David Porter,5,0,36,31
1657228604879,MATH 20A,A01,083754,Zheng; Zequn,14,0,40,26
1657228610902,MATH 20B,A01,083756,Briones; Jor-el Thomas Caparas,2,0,36,34
1657228610902,MATH 20B,A02,083757,Briones; Jor-el Thomas Caparas,1,0,36,35
1657228610902,MATH 20B,A03,093475,Briones; Jor-el Thomas Caparas,2,0,36,34
1657228616931,MATH 20C,A01,083760,Briones; Jor-el Thomas Caparas,1,0,35,34
1657228616931,MATH 20C,A02,083761,Briones; Jor-el Thomas Caparas,8,0,35,27
1657228616931,MATH 20C,A03,093476,Briones; Jor-el Thomas Caparas,0,1,36,36
1657228616931,MATH 20C,B01,083762,Bach; Quang Tran,1,0,30,29
1657228622960,MATH 20D,A01,083765,Tran; Brian Kha,4,0,30,26
1657228622960,MATH 20D,A02,083766,Tran; Brian Kha,5,0,30,25
1657228622960,MATH 20D,A03,083767,Tran; Brian Kha,4,0,30,26
1657228628986,MATH 20E,A01,083771,Ganguly; Soumya,7,0,32,25
1657228628986,MATH 20E,A02,083772,Ganguly; Soumya,7,0,32,25
1657228628986,MATH 20E,B01,083773,Ciotti; Benjamin,19,0,35,16
1657228628986,MATH 20E,B02,083774,Ciotti; Benjamin,17,0,35,18
1657228635014,MATH 103A,A01,083777,Greenfeld; Be'Eri,3,0,36,33
1657228635014,MATH 103A,A02,083778,Greenfeld; Be'Eri,5,0,36,31
1657228635014,MATH 103A,A03,093561,Greenfeld; Be'Eri,4,0,36,32
1657228635014,MATH 103A,B01,083779,Greenfeld; Be'Eri,6,0,36,30
1657228635014,MATH 103A,B02,083780,Greenfeld; Be'Eri,3,0,36,33
1657228635014,MATH 103A,B03,093562,Greenfeld; Be'Eri,3,0,36,33
1657228641037,MATH 105,A01,085443,Carter; Anne Toulson,15,0,35,20
1657228641037,MATH 105,A02,093477,Carter; Anne Toulson,20,0,35,15
1657228647066,MATH 109,A01,083213,Ganzberger; Geoffrey Michael,2,0,34,32
1657228647066,MATH 109,A02,083214,Ganzberger; Geoffrey Michael,4,0,34,30
1657228647066,MATH 109,A03,093478,Ganzberger; Geoffrey Michael,2,0,34,32
1657228647066,MATH 109,B01,083215,Ganzberger; Geoffrey Michael,1,0,32,31
1657228647066,MATH 109,B02,083216,Ganzberger; Geoffrey Michael,1,0,32,31
1657228647066,MATH 109,B03,093479,Ganzberger; Geoffrey Michael,7,0,32,25
1657228653091,MATH 142A,A01,083219,Chow; Bennett,6,0,32,26
1657228653091,MATH 142A,A02,083220,Chow; Bennett,10,0,32,22
1657228653091,MATH 142A,A03,093480,Chow; Bennett,7,0,32,25
1657228653091,MATH 142A,B03,093481,Chow; Bennett,8,0,32,24
1657228653091,MATH 142A,B04,093558,Chow; Bennett,12,0,32,20
1657228653091,MATH 142A,B05,093559,Chow; Bennett,6,0,32,26
1657228659116,MATH 193A,A01,083224,Rotar; Vladimir,7,0,34,27
1657228659116,MATH 193A,A02,083225,Rotar; Vladimir,6,0,34,28
1657228659116,MATH 193A,A03,083781,Rotar; Vladimir,2,0,34,32
1657228659116,MATH 193A,A04,083782,Rotar; Vladimir,8,0,34,26
1657228659116,MATH 193A,A05,093482,Rotar; Vladimir,6,0,34,28
1657228665138,MATH 197,001,091859,McAuley; Julian John,9999,0,9999,0
1657228665138,MATH 197,002,095566,Kedlaya; Kiran S.,9997,0,9999,2
1657228665138,MATH 197,003,095567,Xiao; Ming,9999,0,9999,0
1657228665138,MATH 197,004,095571,Perols; Johan Lars,9998,0,9999,1
1657228672198,COGS 9,A01,083615,Shannon; Kyle Michael,8,0,75,67
1657228678224,COGS 11,A01,083617,Boyle; Mary E. T.,22,0,48,26
1657228684251,COGS 13,A01,083071,Bastos; Amalia Pinkusfeld,8,0,71,63
1657228690274,COGS 14A,A01,092681,Semenuks; Arturs,2,1,100,98
1657228696298,COGS 14B,A01,083073,Cheng; Tzu-Han,6,0,63,57
1657228702321,COGS 17,A01,092677,Semenuks; Arturs,5,0,81,76
1657228708345,COGS 100,A01,083619,Allen; Michael Gordon,16,0,70,54
1657228714377,COGS 101A,A01,083621,Davis; Joshua Daniel,9,0,68,59
1657228720403,COGS 101B,A01,091572,Allen; Michael Gordon,9,0,65,56
1657228726431,COGS 101C,A01,083625,Delgado; Tania,17,0,35,18
1657228732456,COGS 107A,A01,083627,Boyle; Mary E. T.,13,0,60,47
1657228738479,COGS 118A,A01,083075,Gupta; Anjum,16,0,76,60
1657228744509,CSE 3,A50,083646,Miranda; Gregory Joseph,24,0,50,26
1657228750532,CSE 8A,A50,083650,Miranda; Gregory Joseph,17,1,56,39
1657228756569,CSE 11,A01,083080,Cao; Yingjun,5,15,40,35
1657228762599,CSE 12,A01,083652,Krause-Levy; Sophia Louisa,24,1,120,96
1657228768626,CSE 15L,A01,083654,Morris; Justin Loren,9,0,50,41
1657228768626,CSE 15L,A02,083655,Morris; Justin Loren,9,0,50,41
1657228774648,CSE 20,A01,083657,Tran; Khoa Dang,38,0,80,42
1657228780670,CSE 21,A01,095574,Bach; Quang Tran,22,0,48,26
1657228786693,CSE 30,A01,083084,Eldon; John,4,0,80,76
1657228786693,CSE 30,B01,095061,Bhaskar; Nishant,8,0,50,42
1657228792720,CSE 100,A01,083659,Cao; Yingjun,4,4,70,66
1657228798742,CSE 134B,A01,083661,Powell; Thomas Allan,21,0,100,79
1657228804765,CSE 140,A01,083663,Gungor; Onat,13,0,85,72
1657228810788,CSE 140L,A01,083088,Eldon; John,17,0,100,83
1657228816809,CSE 175,A01,083665,Kumar; Rakesh,3,0,25,22
1657228822849,CSE 190,A00,092507,Dubnov; Shlomo,7,0,20,13
1657228828949,ECE 45,A01,083139,Congero; Spencer William,5,0,75,70
1657228834971,ECE 65,A50,083695,Saad; Andrew S,12,0,30,18
1657228834971,ECE 65,A51,095125,Saad; Andrew S,25,0,26,1
1657228840996,ECE 109,A01,091882,Touri; Behrouz,19,0,70,51
1657228847032,ECE 180,A00,083140,Abi Samra; Nicholas Camill,1,0,30,29
1657228847032,ECE 180,B00,083141,Abi Samra; Nicholas Camill,0,0,30,30
1657228853059,MATH 10A,A01,083735,Patchell; Gregory David,2,0,30,28
1657228853059,MATH 10A,A02,083736,Patchell; Gregory David,20,0,30,10
1657228853059,MATH 10A,A03,083737,Patchell; Gregory David,16,0,30,14
1657228859084,MATH 10B,A01,083207,Lim; Seonhee,7,0,34,27
1657228859084,MATH 10B,A02,083208,Lim; Seonhee,9,0,35,26
1657228859084,MATH 10B,A03,093472,Lim; Seonhee,5,0,34,29
1657228859084,MATH 10B,B01,083739,Sinha; Shubham,10,0,30,20
1657228865118,MATH 18,A01,083743,Cinel; Cameron Alexander,6,0,30,24
1657228865118,MATH 18,A02,083744,Cinel; Cameron Alexander,16,0,30,14
1657228865118,MATH 18,A03,083745,Cinel; Cameron Alexander,8,0,30,22
1657228865118,MATH 18,B01,083748,Rideout; David Porter,4,0,37,33
1657228865118,MATH 18,B02,083749,Rideout; David Porter,4,0,36,32
1657228865118,MATH 18,B03,083750,Rideout; David Porter,2,0,37,35
1657228865118,MATH 18,B04,083751,Rideout; David Porter,6,0,36,30
1657228865118,MATH 18,B05,093473,Rideout; David Porter,5,0,36,31
1657228865118,MATH 18,B06,093474,Rideout; David Porter,5,0,36,31
1657228871143,MATH 20A,A01,083754,Zheng; Zequn,14,0,40,26
1657228877170,MATH 20B,A01,083756,Briones; Jor-el Thomas Caparas,2,0,36,34
1657228877170,MATH 20B,A02,083757,Briones; Jor-el Thomas Caparas,1,0,36,35
1657228877170,MATH 20B,A03,093475,Briones; Jor-el Thomas Caparas,2,0,36,34
1657228883192,MATH 20C,A01,083760,Briones; Jor-el Thomas Caparas,1,0,35,34
1657228883192,MATH 20C,A02,083761,Briones; Jor-el Thomas Caparas,8,0,35,27
1657228883192,MATH 20C,A03,093476,Briones; Jor-el Thomas Caparas,0,1,36,36
1657228883192,MATH 20C,B01,083762,Bach; Quang Tran,1,0,30,29
1657228889231,MATH 20D,A01,083765,Tran; Brian Kha,4,0,30,26
1657228889231,MATH 20D,A02,083766,Tran; Brian Kha,5,0,30,25
1657228889231,MATH 20D,A03,083767,Tran; Brian Kha,4,0,30,26
1657228895257,MATH 20E,A01,083771,Ganguly; Soumya,7,0,32,25
1657228895257,MATH 20E,A02,083772,Ganguly; Soumya,7,0,32,25
1657228895257,MATH 20E,B01,083773,Ciotti; Benjamin,19,0,35,16
1657228895257,MATH 20E,B02,083774,Ciotti; Benjamin,17,0,35,18
1657228901283,MATH 103A,A01,083777,Greenfeld; Be'Eri,3,0,36,33
1657228901283,MATH 103A,A02,083778,Greenfeld; Be'Eri,5,0,36,31
1657228901283,MATH 103A,A03,093561,Greenfeld; Be'Eri,4,0,36,32
1657228901283,MATH 103A,B01,083779,Greenfeld; Be'Eri,6,0,36,30
1657228901283,MATH 103A,B02,083780,Greenfeld; Be'Eri,3,0,36,33
1657228901283,MATH 103A,B03,093562,Greenfeld; Be'Eri,3,0,36,33
1657228907316,MATH 105,A01,085443,Carter; Anne Toulson,15,0,35,20
1657228907316,MATH 105,A02,093477,Carter; Anne Toulson,20,0,35,15
1657228913339,MATH 109,A01,083213,Ganzberger; Geoffrey Michael,2,0,34,32
1657228913339,MATH 109,A02,083214,Ganzberger; Geoffrey Michael,4,0,34,30
1657228913339,MATH 109,A03,093478,Ganzberger; Geoffrey Michael,2,0,34,32
1657228913339,MATH 109,B01,083215,Ganzberger; Geoffrey Michael,1,0,32,31
1657228913339,MATH 109,B02,083216,Ganzberger; Geoffrey Michael,1,0,32,31
1657228913339,MATH 109,B03,093479,Ganzberger; Geoffrey Michael,8,0,32,24
1657228919369,MATH 142A,A01,083219,Chow; Bennett,6,0,32,26
1657228919369,MATH 142A,A02,083220,Chow; Bennett,10,0,32,22
1657228919369,MATH 142A,A03,093480,Chow; Bennett,7,0,32,25
1657228919369,MATH 142A,B03,093481,Chow; Bennett,8,0,32,24
1657228919369,MATH 142A,B04,093558,Chow; Bennett,12,0,32,20
1657228919369,MATH 142A,B05,093559,Chow; Bennett,6,0,32,26
1657228925393,MATH 193A,A01,083224,Rotar; Vladimir,7,0,34,27
1657228925393,MATH 193A,A02,083225,Rotar; Vladimir,6,0,34,28
1657228925393,MATH 193A,A03,083781,Rotar; Vladimir,2,0,34,32
1657228925393,MATH 193A,A04,083782,Rotar; Vladimir,8,0,34,26
1657228925393,MATH 193A,A05,093482,Rotar; Vladimir,6,0,34,28
1657228931421,MATH 197,001,091859,McAuley; Julian John,9999,0,9999,0
1657228931421,MATH 197,002,095566,Kedlaya; Kiran S.,9997,0,9999,2
1657228931421,MATH 197,003,095567,Xiao; Ming,9999,0,9999,0
1657228931421,MATH 197,004,095571,Perols; Johan Lars,9998,0,9999,1
1657228938477,COGS 9,A01,083615,Shannon; Kyle Michael,8,0,75,67
1657228944507,COGS 11,A01,083617,Boyle; Mary E. T.,22,0,48,26
1657228950547,COGS 13,A01,083071,Bastos; Amalia Pinkusfeld,8,0,71,63
1657228956571,COGS 14A,A01,092681,Semenuks; Arturs,2,1,100,98
1657228962593,COGS 14B,A01,083073,Cheng; Tzu-Han,6,0,63,57
1657228968617,COGS 17,A01,092677,Semenuks; Arturs,5,0,81,76
1657228974641,COGS 100,A01,083619,Allen; Michael Gordon,16,0,70,54
1657228980663,COGS 101A,A01,083621,Davis; Joshua Daniel,9,0,68,59
1657228986695,COGS 101B,A01,091572,Allen; Michael Gordon,9,0,65,56
1657228992718,COGS 101C,A01,083625,Delgado; Tania,17,0,35,18
1657228998740,COGS 107A,A01,083627,Boyle; Mary E. T.,13,0,60,47
1657229004763,COGS 118A,A01,083075,Gupta; Anjum,16,0,76,60
1657229010792,CSE 3,A50,083646,Miranda; Gregory Joseph,24,0,50,26
1657229016818,CSE 8A,A50,083650,Miranda; Gregory Joseph,17,1,56,39
1657229022845,CSE 11,A01,083080,Cao; Yingjun,5,15,40,35
1657229028868,CSE 12,A01,083652,Krause-Levy; Sophia Louisa,24,1,120,96
1657229034901,CSE 15L,A01,083654,Morris; Justin Loren,9,0,50,41
1657229034901,CSE 15L,A02,083655,Morris; Justin Loren,9,0,50,41
1657229040924,CSE 20,A01,083657,Tran; Khoa Dang,38,0,80,42
1657229046951,CSE 21,A01,095574,Bach; Quang Tran,22,0,48,26
1657229052973,CSE 30,A01,083084,Eldon; John,4,0,80,76
1657229052973,CSE 30,B01,095061,Bhaskar; Nishant,8,0,50,42
1657229059004,CSE 100,A01,083659,Cao; Yingjun,4,4,70,66
1657229065025,CSE 134B,A01,083661,Powell; Thomas Allan,21,0,100,79
1657229071061,CSE 140,A01,083663,Gungor; Onat,13,0,85,72
1657229077092,CSE 140L,A01,083088,Eldon; John,17,0,100,83
1657229083116,CSE 175,A01,083665,Kumar; Rakesh,3,0,25,22
1657229089154,CSE 190,A00,092507,Dubnov; Shlomo,7,0,20,13
1657229095176,ECE 45,A01,083139,Congero; Spencer William,5,0,75,70
1657229101197,ECE 65,A50,083695,Saad; Andrew S,12,0,30,18
1657229101197,ECE 65,A51,095125,Saad; Andrew S,25,0,26,1
1657229107219,ECE 109,A01,091882,Touri; Behrouz,19,0,70,51
1657229113246,ECE 180,A00,083140,Abi Samra; Nicholas Camill,1,0,30,29
1657229113246,ECE 180,B00,083141,Abi Samra; Nicholas Camill,0,0,30,30
1657229119270,MATH 10A,A01,083735,Patchell; Gregory David,2,0,30,28
1657229119270,MATH 10A,A02,083736,Patchell; Gregory David,20,0,30,10
1657229119270,MATH 10A,A03,083737,Patchell; Gregory David,16,0,30,14
1657229125293,MATH 10B,A01,083207,Lim; Seonhee,7,0,34,27
1657229125293,MATH 10B,A02,083208,Lim; Seonhee,9,0,35,26
1657229125293,MATH 10B,A03,093472,Lim; Seonhee,5,0,34,29
1657229125293,MATH 10B,B01,083739,Sinha; Shubham,11,0,30,19
1657229131317,MATH 18,A01,083743,Cinel; Cameron Alexander,6,0,30,24
1657229131317,MATH 18,A02,083744,Cinel; Cameron Alexander,16,0,30,14
1657229131317,MATH 18,A03,083745,Cinel; Cameron Alexander,8,0,30,22
1657229131317,MATH 18,B01,083748,Rideout; David Porter,4,0,37,33
1657229131317,MATH 18,B02,083749,Rideout; David Porter,4,0,36,32
1657229131317,MATH 18,B03,083750,Rideout; David Porter,2,0,37,35
1657229131317,MATH 18,B04,083751,Rideout; David Porter,6,0,36,30
1657229131317,MATH 18,B05,093473,Rideout; David Porter,5,0,36,31
1657229131317,MATH 18,B06,093474,Rideout; David Porter,5,0,36,31
1657229137343,MATH 20A,A01,083754,Zheng; Zequn,14,0,40,26
1657229143369,MATH 20B,A01,083756,Briones; Jor-el Thomas Caparas,2,0,36,34
1657229143369,MATH 20B,A02,083757,Briones; Jor-el Thomas Caparas,1,0,36,35
1657229143369,MATH 20B,A03,093475,Briones; Jor-el Thomas Caparas,2,0,36,34
1657229149392,MATH 20C,A01,083760,Briones; Jor-el Thomas Caparas,1,0,35,34
1657229149392,MATH 20C,A02,083761,Briones; Jor-el Thomas Caparas,8,0,35,27
1657229149392,MATH 20C,A03,093476,Briones; Jor-el Thomas Caparas,0,1,36,36
1657229149392,MATH 20C,B01,083762,Bach; Quang Tran,1,0,30,29
1657229155425,MATH 20D,A01,083765,Tran; Brian Kha,4,0,30,26
1657229155425,MATH 20D,A02,083766,Tran; Brian Kha,5,0,30,25
1657229155425,MATH 20D,A03,083767,Tran; Brian Kha,4,0,30,26
1657229161448,MATH 20E,A01,083771,Ganguly; Soumya,7,0,32,25
1657229161448,MATH 20E,A02,083772,Ganguly; Soumya,7,0,32,25
1657229161448,MATH 20E,B01,083773,Ciotti; Benjamin,19,0,35,16
1657229161448,MATH 20E,B02,083774,Ciotti; Benjamin,17,0,35,18
1657229167474,MATH 103A,A01,083777,Greenfeld; Be'Eri,3,0,36,33
1657229167474,MATH 103A,A02,083778,Greenfeld; Be'Eri,5,0,36,31
1657229167474,MATH 103A,A03,093561,Greenfeld; Be'Eri,4,0,36,32
1657229167474,MATH 103A,B01,083779,Greenfeld; Be'Eri,6,0,36,30
1657229167474,MATH 103A,B02,083780,Greenfeld; Be'Eri,3,0,36,33
1657229167474,MATH 103A,B03,093562,Greenfeld; Be'Eri,3,0,36,33
1657229173523,MATH 105,A01,085443,Carter; Anne Toulson,15,0,35,20
1657229173523,MATH 105,A02,093477,Carter; Anne Toulson,20,0,35,15
1657229179559,MATH 109,A01,083213,Ganzberger; Geoffrey Michael,2,0,34,32
1657229179559,MATH 109,A02,083214,Ganzberger; Geoffrey Michael,4,0,34,30
1657229179559,MATH 109,A03,093478,Ganzberger; Geoffrey Michael,2,0,34,32
1657229179559,MATH 109,B01,083215,Ganzberger; Geoffrey Michael,1,0,32,31
1657229179559,MATH 109,B02,083216,Ganzberger; Geoffrey Michael,1,0,32,31
1657229179559,MATH 109,B03,093479,Ganzberger; Geoffrey Michael,8,0,32,24
1657229185588,MATH 142A,A01,083219,Chow; Bennett,6,0,32,26
1657229185588,MATH 142A,A02,083220,Chow; Bennett,10,0,32,22
1657229185588,MATH 142A,A03,093480,Chow; Bennett,7,0,32,25
1657229185588,MATH 142A,B03,093481,Chow; Bennett,8,0,32,24
1657229185588,MATH 142A,B04,093558,Chow; Bennett,12,0,32,20
1657229185588,MATH 142A,B05,093559,Chow; Bennett,6,0,32,26
1657229191616,MATH 193A,A01,083224,Rotar; Vladimir,7,0,34,27
1657229191616,MATH 193A,A02,083225,Rotar; Vladimir,6,0,34,28
1657229191616,MATH 193A,A03,083781,Rotar; Vladimir,2,0,34,32
1657229191616,MATH 193A,A04,083782,Rotar; Vladimir,8,0,34,26
1657229191616,MATH 193A,A05,093482,Rotar; Vladimir,6,0,34,28
1657229197651,MATH 197,001,091859,McAuley; Julian John,9999,0,9999,0
1657229197651,MATH 197,002,095566,Kedlaya; Kiran S.,9997,0,9999,2
1657229197651,MATH 197,003,095567,Xiao; Ming,9999,0,9999,0
1657229197651,MATH 197,004,095571,Perols; Johan Lars,9998,0,9999,1
1657229204714,COGS 9,A01,083615,Shannon; Kyle Michael,8,0,75,67
1657229210739,COGS 11,A01,083617,Boyle; Mary E. T.,22,0,48,26
1657229216761,COGS 13,A01,083071,Bastos; Amalia Pinkusfeld,8,0,71,63
1657229222794,COGS 14A,A01,092681,Semenuks; Arturs,2,1,100,98
1657229228824,COGS 14B,A01,083073,Cheng; Tzu-Han,6,0,63,57
1657229234876,COGS 17,A01,092677,Semenuks; Arturs,5,0,81,76
1657229240906,COGS 100,A01,083619,Allen; Michael Gordon,16,0,70,54
1657229246930,COGS 101A,A01,083621,Davis; Joshua Daniel,9,0,68,59
1657229252953,COGS 101B,A01,091572,Allen; Michael Gordon,10,0,65,55
1657229258989,COGS 101C,A01,083625,Delgado; Tania,17,0,35,18
1657229265011,COGS 107A,A01,083627,Boyle; Mary E. T.,13,0,60,47
1657229271035,COGS 118A,A01,083075,Gupta; Anjum,16,0,76,60
1657229277064,CSE 3,A50,083646,Miranda; Gregory Joseph,24,0,50,26
1657229283088,CSE 8A,A50,083650,Miranda; Gregory Joseph,17,1,56,39
1657229289113,CSE 11,A01,083080,Cao; Yingjun,5,15,40,35
1657229295140,CSE 12,A01,083652,Krause-Levy; Sophia Louisa,24,1,120,96
1657229301163,CSE 15L,A01,083654,Morris; Justin Loren,9,0,50,41
1657229301163,CSE 15L,A02,083655,Morris; Justin Loren,9,0,50,41
1657229307189,CSE 20,A01,083657,Tran; Khoa Dang,38,0,80,42
1657229313216,CSE 21,A01,095574,Bach; Quang Tran,22,0,48,26
1657229319237,CSE 30,A01,083084,Eldon; John,4,0,80,76
1657229319237,CSE 30,B01,095061,Bhaskar; Nishant,8,0,50,42
1657229325262,CSE 100,A01,083659,Cao; Yingjun,4,4,70,66
1657229331293,CSE 134B,A01,083661,Powell; Thomas Allan,21,0,100,79
1657229337321,CSE 140,A01,083663,Gungor; Onat,13,0,85,72
1657229343344,CSE 140L,A01,083088,Eldon; John,17,0,100,83
1657229349381,CSE 175,A01,083665,Kumar; Rakesh,3,0,25,22
1657229355402,CSE 190,A00,092507,Dubnov; Shlomo,7,0,20,13
1657229361425,ECE 45,A01,083139,Congero; Spencer William,5,0,75,70
1657229367450,ECE 65,A50,083695,Saad; Andrew S,12,0,30,18
1657229367450,ECE 65,A51,095125,Saad; Andrew S,25,0,26,1
1657229373477,ECE 109,A01,091882,Touri; Behrouz,19,0,70,51
1657229379504,ECE 180,A00,083140,Abi Samra; Nicholas Camill,1,0,30,29
1657229379504,ECE 180,B00,083141,Abi Samra; Nicholas Camill,0,0,30,30
1657229385535,MATH 10A,A01,083735,Patchell; Gregory David,2,0,30,28
1657229385535,MATH 10A,A02,083736,Patchell; Gregory David,20,0,30,10
1657229385535,MATH 10A,A03,083737,Patchell; Gregory David,16,0,30,14
1657229391563,MATH 10B,A01,083207,Lim; Seonhee,7,0,34,27
1657229391563,MATH 10B,A02,083208,Lim; Seonhee,9,0,35,26
1657229391563,MATH 10B,A03,093472,Lim; Seonhee,5,0,34,29
1657229391563,MATH 10B,B01,083739,Sinha; Shubham,11,0,30,19
1657229397594,MATH 18,A01,083743,Cinel; Cameron Alexander,6,0,30,24
1657229397594,MATH 18,A02,083744,Cinel; Cameron Alexander,16,0,30,14
1657229397594,MATH 18,A03,083745,Cinel; Cameron Alexander,8,0,30,22
1657229397594,MATH 18,B01,083748,Rideout; David Porter,4,0,37,33
1657229397594,MATH 18,B02,083749,Rideout; David Porter,4,0,36,32
1657229397594,MATH 18,B03,083750,Rideout; David Porter,2,0,37,35
1657229397594,MATH 18,B04,083751,Rideout; David Porter,6,0,36,30
1657229397594,MATH 18,B05,093473,Rideout; David Porter,5,0,36,31
1657229397594,MATH 18,B06,093474,Rideout; David Porter,5,0,36,31
1657229403621,MATH 20A,A01,083754,Zheng; Zequn,14,0,40,26
1657229409644,MATH 20B,A01,083756,Briones; Jor-el Thomas Caparas,3,0,36,33
1657229409644,MATH 20B,A02,083757,Briones; Jor-el Thomas Caparas,1,0,36,35
1657229409644,MATH 20B,A03,093475,Briones; Jor-el Thomas Caparas,2,0,36,34
1657229415668,MATH 20C,A01,083760,Briones; Jor-el Thomas Caparas,1,0,35,34
1657229415668,MATH 20C,A02,083761,Briones; Jor-el Thomas Caparas,8,0,35,27
1657229415668,MATH 20C,A03,093476,Briones; Jor-el Thomas Caparas,0,1,36,36
1657229415668,MATH 20C,B01,083762,Bach; Quang Tran,1,0,30,29
1657229421691,MATH 20D,A01,083765,Tran; Brian Kha,4,0,30,26
1657229421691,MATH 20D,A02,083766,Tran; Brian Kha,5,0,30,25
1657229421691,MATH 20D,A03,083767,Tran; Brian Kha,4,0,30,26
1657229427791,MATH 20E,A01,083771,Ganguly; Soumya,7,0,32,25
1657229427791,MATH 20E,A02,083772,Ganguly; Soumya,7,0,32,25
1657229427791,MATH 20E,B01,083773,Ciotti; Benjamin,19,0,35,16
1657229427791,MATH 20E,B02,083774,Ciotti; Benjamin,17,0,35,18
1657229433819,MATH 103A,A01,083777,Greenfeld; Be'Eri,3,0,36,33
1657229433819,MATH 103A,A02,083778,Greenfeld; Be'Eri,5,0,36,31
1657229433819,MATH 103A,A03,093561,Greenfeld; Be'Eri,4,0,36,32
1657229433819,MATH 103A,B01,083779,Greenfeld; Be'Eri,6,0,36,30
1657229433819,MATH 103A,B02,083780,Greenfeld; Be'Eri,3,0,36,33
1657229433819,MATH 103A,B03,093562,Greenfeld; Be'Eri,3,0,36,33
1657229439843,MATH 105,A01,085443,Carter; Anne Toulson,15,0,35,20
1657229439843,MATH 105,A02,093477,Carter; Anne Toulson,20,0,35,15
1657229445867,MATH 109,A01,083213,Ganzberger; Geoffrey Michael,2,0,34,32
1657229445867,MATH 109,A02,083214,Ganzberger; Geoffrey Michael,4,0,34,30
1657229445867,MATH 109,A03,093478,Ganzberger; Geoffrey Michael,2,0,34,32
1657229445867,MATH 109,B01,083215,Ganzberger; Geoffrey Michael,1,0,32,31
1657229445867,MATH 109,B02,083216,Ganzberger; Geoffrey Michael,1,0,32,31
1657229445867,MATH 109,B03,093479,Ganzberger; Geoffrey Michael,8,0,32,24
1657229451890,MATH 142A,A01,083219,Chow; Bennett,6,0,32,26
1657229451890,MATH 142A,A02,083220,Chow; Bennett,10,0,32,22
1657229451890,MATH 142A,A03,093480,Chow; Bennett,7,0,32,25
1657229451890,MATH 142A,B03,093481,Chow; Bennett,8,0,32,24
1657229451890,MATH 142A,B04,093558,Chow; Bennett,12,0,32,20
1657229451890,MATH 142A,B05,093559,Chow; Bennett,6,0,32,26
1657229457916,MATH 193A,A01,083224,Rotar; Vladimir,7,0,34,27
1657229457916,MATH 193A,A02,083225,Rotar; Vladimir,6,0,34,28
1657229457916,MATH 193A,A03,083781,Rotar; Vladimir,2,0,34,32
1657229457916,MATH 193A,A04,083782,Rotar; Vladimir,8,0,34,26
1657229457916,MATH 193A,A05,093482,Rotar; Vladimir,6,0,34,28
1657229463938,MATH 197,001,091859,McAuley; Julian John,9999,0,9999,0
1657229463938,MATH 197,002,095566,Kedlaya; Kiran S.,9997,0,9999,2
1657229463938,MATH 197,003,095567,Xiao; Ming,9999,0,9999,0
1657229463938,MATH 197,004,095571,Perols; Johan Lars,9998,0,9999,1
1657229471009,COGS 9,A01,083615,Shannon; Kyle Michael,8,0,75,67
1657229477057,COGS 11,A01,083617,Boyle; Mary E. T.,22,0,48,26
1657229483090,COGS 13,A01,083071,Bastos; Amalia Pinkusfeld,8,0,71,63
1657229489115,COGS 14A,A01,092681,Semenuks; Arturs,2,1,100,98
1657229495136,COGS 14B,A01,083073,Cheng; Tzu-Han,6,0,63,57
1657229501160,COGS 17,A01,092677,Semenuks; Arturs,5,0,81,76
1657229507188,COGS 100,A01,083619,Allen; Michael Gordon,16,0,70,54
1657229513210,COGS 101A,A01,083621,Davis; Joshua Daniel,9,0,68,59
1657229519235,COGS 101B,A01,091572,Allen; Michael Gordon,10,0,65,55
1657229525269,COGS 101C,A01,083625,Delgado; Tania,17,0,35,18
1657229531305,COGS 107A,A01,083627,Boyle; Mary E. T.,13,0,60,47
1657229537345,COGS 118A,A01,083075,Gupta; Anjum,16,0,76,60
1657229543373,CSE 3,A50,083646,Miranda; Gregory Joseph,24,0,50,26
1657229549403,CSE 8A,A50,083650,Miranda; Gregory Joseph,17,1,56,39
1657229555426,CSE 11,A01,083080,Cao; Yingjun,5,15,40,35
1657229561450,CSE 12,A01,083652,Krause-Levy; Sophia Louisa,24,1,120,96
1657229567473,CSE 15L,A01,083654,Morris; Justin Loren,9,0,50,41
1657229567473,CSE 15L,A02,083655,Morris; Justin Loren,9,0,50,41
1657229573497,CSE 20,A01,083657,Tran; Khoa Dang,38,0,80,42
1657229579525,CSE 21,A01,095574,Bach; Quang Tran,22,0,48,26
1657229585548,CSE 30,A01,083084,Eldon; John,4,0,80,76
1657229585548,CSE 30,B01,095061,Bhaskar; Nishant,8,0,50,42
1657229591574,CSE 100,A01,083659,Cao; Yingjun,4,4,70,66
1657229597598,CSE 134B,A01,083661,Powell; Thomas Allan,21,0,100,79
1657229603620,CSE 140,A01,083663,Gungor; Onat,13,0,85,72
1657229609644,CSE 140L,A01,083088,Eldon; John,17,0,100,83
1657229615668,CSE 175,A01,083665,Kumar; Rakesh,3,0,25,22
1657229621700,CSE 190,A00,092507,Dubnov; Shlomo,7,0,20,13
1657229627722,ECE 45,A01,083139,Congero; Spencer William,5,0,75,70
1657229633754,ECE 65,A50,083695,Saad; Andrew S,12,0,30,18
1657229633754,ECE 65,A51,095125,Saad; Andrew S,25,0,26,1
1657229639778,ECE 109,A01,091882,Touri; Behrouz,19,0,70,51
1657229645805,ECE 180,A00,083140,Abi Samra; Nicholas Camill,1,0,30,29
1657229645805,ECE 180,B00,083141,Abi Samra; Nicholas Camill,0,0,30,30
1657229651839,MATH 10A,A01,083735,Patchell; Gregory David,2,0,30,28
1657229651839,MATH 10A,A02,083736,Patchell; Gregory David,20,0,30,10
1657229651839,MATH 10A,A03,083737,Patchell; Gregory David,16,0,30,14
1657229657868,MATH 10B,A01,083207,Lim; Seonhee,7,0,34,27
1657229657868,MATH 10B,A02,083208,Lim; Seonhee,9,0,35,26
1657229657868,MATH 10B,A03,093472,Lim; Seonhee,5,0,34,29
1657229657868,MATH 10B,B01,083739,Sinha; Shubham,11,0,30,19
1657229663893,MATH 18,A01,083743,Cinel; Cameron Alexander,6,0,30,24
1657229663893,MATH 18,A02,083744,Cinel; Cameron Alexander,16,0,30,14
1657229663893,MATH 18,A03,083745,Cinel; Cameron Alexander,8,0,30,22
1657229663893,MATH 18,B01,083748,Rideout; David Porter,4,0,37,33
1657229663893,MATH 18,B02,083749,Rideout; David Porter,4,0,36,32
1657229663893,MATH 18,B03,083750,Rideout; David Porter,2,0,37,35
1657229663893,MATH 18,B04,083751,Rideout; David Porter,6,0,36,30
1657229663893,MATH 18,B05,093473,Rideout; David Porter,5,0,36,31
1657229663893,MATH 18,B06,093474,Rideout; David Porter,5,0,36,31
1657229669924,MATH 20A,A01,083754,Zheng; Zequn,14,0,40,26
1657229675946,MATH 20B,A01,083756,Briones; Jor-el Thomas Caparas,3,0,36,33
1657229675946,MATH 20B,A02,083757,Briones; Jor-el Thomas Caparas,1,0,36,35
1657229675946,MATH 20B,A03,093475,Briones; Jor-el Thomas Caparas,2,0,36,34
1657229681971,MATH 20C,A01,083760,Briones; Jor-el Thomas Caparas,1,0,35,34
1657229681971,MATH 20C,A02,083761,Briones; Jor-el Thomas Caparas,8,0,35,27
1657229681971,MATH 20C,A03,093476,Briones; Jor-el Thomas Caparas,0,1,36,36
1657229681971,MATH 20C,B01,083762,Bach; Quang Tran,1,0,30,29
1657229687997,MATH 20D,A01,083765,Tran; Brian Kha,4,0,30,26
1657229687997,MATH 20D,A02,083766,Tran; Brian Kha,5,0,30,25
1657229687997,MATH 20D,A03,083767,Tran; Brian Kha,4,0,30,26
1657229694027,MATH 20E,A01,083771,Ganguly; Soumya,7,0,32,25
1657229694027,MATH 20E,A02,083772,Ganguly; Soumya,7,0,32,25
1657229694027,MATH 20E,B01,083773,Ciotti; Benjamin,19,0,35,16
1657229694027,MATH 20E,B02,083774,Ciotti; Benjamin,17,0,35,18
1657229700057,MATH 103A,A01,083777,Greenfeld; Be'Eri,3,0,36,33
1657229700057,MATH 103A,A02,083778,Greenfeld; Be'Eri,5,0,36,31
1657229700057,MATH 103A,A03,093561,Greenfeld; Be'Eri,4,0,36,32
1657229700057,MATH 103A,B01,083779,Greenfeld; Be'Eri,6,0,36,30
1657229700057,MATH 103A,B02,083780,Greenfeld; Be'Eri,3,0,36,33
1657229700057,MATH 103A,B03,093562,Greenfeld; Be'Eri,3,0,36,33
1657229706092,MATH 105,A01,085443,Carter; Anne Toulson,15,0,35,20
1657229706092,MATH 105,A02,093477,Carter; Anne Toulson,20,0,35,15
1657229712133,MATH 109,A01,083213,Ganzberger; Geoffrey Michael,2,0,34,32
1657229712133,MATH 109,A02,083214,Ganzberger; Geoffrey Michael,4,0,34,30
1657229712133,MATH 109,A03,093478,Ganzberger; Geoffrey Michael,2,0,34,32
1657229712133,MATH 109,B01,083215,Ganzberger; Geoffrey Michael,1,0,32,31
1657229712133,MATH 109,B02,083216,Ganzberger; Geoffrey Michael,1,0,32,31
1657229712133,MATH 109,B03,093479,Ganzberger; Geoffrey Michael,8,0,32,24
1657229718161,MATH 142A,A01,083219,Chow; Bennett,6,0,32,26
1657229718161,MATH 142A,A02,083220,Chow; Bennett,10,0,32,22
1657229718161,MATH 142A,A03,093480,Chow; Bennett,7,0,32,25
1657229718161,MATH 142A,B03,093481,Chow; Bennett,8,0,32,24
1657229718161,MATH 142A,B04,093558,Chow; Bennett,12,0,32,20
1657229718161,MATH 142A,B05,093559,Chow; Bennett,6,0,32,26
1657229724186,MATH 193A,A01,083224,Rotar; Vladimir,7,0,34,27
1657229724186,MATH 193A,A02,083225,Rotar; Vladimir,6,0,34,28
1657229724186,MATH 193A,A03,083781,Rotar; Vladimir,2,0,34,32
1657229724186,MATH 193A,A04,083782,Rotar; Vladimir,8,0,34,26
1657229724186,MATH 193A,A05,093482,Rotar; Vladimir,6,0,34,28
1657229730212,MATH 197,001,091859,McAuley; Julian John,9999,0,9999,0
1657229730212,MATH 197,002,095566,Kedlaya; Kiran S.,9997,0,9999,2
1657229730212,MATH 197,003,095567,Xiao; Ming,9999,0,9999,0
1657229730212,MATH 197,004,095571,Perols; Johan Lars,9998,0,9999,1
1657229737264,COGS 9,A01,083615,Shannon; Kyle Michael,8,0,75,67
1657229743291,COGS 11,A01,083617,Boyle; Mary E. T.,22,0,48,26
1657229749320,COGS 13,A01,083071,Bastos; Amalia Pinkusfeld,8,0,71,63
1657229755346,COGS 14A,A01,092681,Semenuks; Arturs,2,1,100,98
1657229761368,COGS 14B,A01,083073,Cheng; Tzu-Han,6,0,63,57
1657229767391,COGS 17,A01,092677,Semenuks; Arturs,5,0,81,76
1657229773424,COGS 100,A01,083619,Allen; Michael Gordon,16,0,70,54
1657229779453,COGS 101A,A01,083621,Davis; Joshua Daniel,9,0,68,59
1657229785476,COGS 101B,A01,091572,Allen; Michael Gordon,10,0,65,55
1657229791503,COGS 101C,A01,083625,Delgado; Tania,17,0,35,18
1657229797530,COGS 107A,A01,083627,Boyle; Mary E. T.,13,0,60,47
1657229803552,COGS 118A,A01,083075,Gupta; Anjum,16,0,76,60
1657229809576,CSE 3,A50,083646,Miranda; Gregory Joseph,24,0,50,26
1657229815598,CSE 8A,A50,083650,Miranda; Gregory Joseph,17,1,56,39
1657229821625,CSE 11,A01,083080,Cao; Yingjun,5,15,40,35
1657229827648,CSE 12,A01,083652,Krause-Levy; Sophia Louisa,24,1,120,96
1657229833674,CSE 15L,A01,083654,Morris; Justin Loren,9,0,50,41
1657229833674,CSE 15L,A02,083655,Morris; Justin Loren,9,0,50,41
1657229839699,CSE 20,A01,083657,Tran; Khoa Dang,38,0,80,42
1657229845723,CSE 21,A01,095574,Bach; Quang Tran,22,0,48,26
1657229851752,CSE 30,A01,083084,Eldon; John,4,0,80,76
1657229851752,CSE 30,B01,095061,Bhaskar; Nishant,8,0,50,42
1657229857775,CSE 100,A01,083659,Cao; Yingjun,4,4,70,66
1657229863798,CSE 134B,A01,083661,Powell; Thomas Allan,21,0,100,79
1657229869823,CSE 140,A01,083663,Gungor; Onat,13,0,85,72
1657229875848,CSE 140L,A01,083088,Eldon; John,17,0,100,83
1657229881878,CSE 175,A01,083665,Kumar; Rakesh,3,0,25,22
1657229887909,CSE 190,A00,092507,Dubnov; Shlomo,7,0,20,13
1657229893940,ECE 45,A01,083139,Congero; Spencer William,5,0,75,70
1657229899964,ECE 65,A50,083695,Saad; Andrew S,12,0,30,18
1657229899964,ECE 65,A51,095125,Saad; Andrew S,25,0,26,1
1657229905994,ECE 109,A01,091882,Touri; Behrouz,19,0,70,51
1657229912021,ECE 180,A00,083140,Abi Samra; Nicholas Camill,1,0,30,29
1657229912021,ECE 180,B00,083141,Abi Samra; Nicholas Camill,0,0,30,30
1657229918044,MATH 10A,A01,083735,Patchell; Gregory David,2,0,30,28
1657229918044,MATH 10A,A02,083736,Patchell; Gregory David,20,0,30,10
1657229918044,MATH 10A,A03,083737,Patchell; Gregory David,16,0,30,14
1657229924082,MATH 10B,A01,083207,Lim; Seonhee,7,0,34,27
1657229924082,MATH 10B,A02,083208,Lim; Seonhee,9,0,35,26
1657229924082,MATH 10B,A03,093472,Lim; Seonhee,5,0,34,29
1657229924082,MATH 10B,B01,083739,Sinha; Shubham,11,0,30,19
1657229930112,MATH 18,A01,083743,Cinel; Cameron Alexander,6,0,30,24
1657229930112,MATH 18,A02,083744,Cinel; Cameron Alexander,16,0,30,14
1657229930112,MATH 18,A03,083745,Cinel; Cameron Alexander,8,0,30,22
1657229930112,MATH 18,B01,083748,Rideout; David Porter,4,0,37,33
1657229930112,MATH 18,B02,083749,Rideout; David Porter,4,0,36,32
1657229930112,MATH 18,B03,083750,Rideout; David Porter,2,0,37,35
1657229930112,MATH 18,B04,083751,Rideout; David Porter,6,0,36,30
1657229930112,MATH 18,B05,093473,Rideout; David Porter,5,0,36,31
1657229930112,MATH 18,B06,093474,Rideout; David Porter,5,0,36,31
1657229936135,MATH 20A,A01,083754,Zheng; Zequn,14,0,40,26
1657229942160,MATH 20B,A01,083756,Briones; Jor-el Thomas Caparas,3,0,36,33
1657229942160,MATH 20B,A02,083757,Briones; Jor-el Thomas Caparas,1,0,36,35
1657229942160,MATH 20B,A03,093475,Briones; Jor-el Thomas Caparas,2,0,36,34
1657229948183,MATH 20C,A01,083760,Briones; Jor-el Thomas Caparas,1,0,35,34
1657229948183,MATH 20C,A02,083761,Briones; Jor-el Thomas Caparas,8,0,35,27
1657229948183,MATH 20C,A03,093476,Briones; Jor-el Thomas Caparas,0,1,36,36
1657229948183,MATH 20C,B01,083762,Bach; Quang Tran,1,0,30,29
1657229954212,MATH 20D,A01,083765,Tran; Brian Kha,4,0,30,26
1657229954212,MATH 20D,A02,083766,Tran; Brian Kha,5,0,30,25
1657229954212,MATH 20D,A03,083767,Tran; Brian Kha,4,0,30,26
1657229960237,MATH 20E,A01,083771,Ganguly; Soumya,7,0,32,25
1657229960237,MATH 20E,A02,083772,Ganguly; Soumya,7,0,32,25
1657229960237,MATH 20E,B01,083773,Ciotti; Benjamin,19,0,35,16
1657229960237,MATH 20E,B02,083774,Ciotti; Benjamin,17,0,35,18
1657229966269,MATH 103A,A01,083777,Greenfeld; Be'Eri,3,0,36,33
1657229966269,MATH 103A,A02,083778,Greenfeld; Be'Eri,5,0,36,31
1657229966269,MATH 103A,A03,093561,Greenfeld; Be'Eri,4,0,36,32
1657229966269,MATH 103A,B01,083779,Greenfeld; Be'Eri,6,0,36,30
1657229966269,MATH 103A,B02,083780,Greenfeld; Be'Eri,3,0,36,33
1657229966269,MATH 103A,B03,093562,Greenfeld; Be'Eri,3,0,36,33
1657229972293,MATH 105,A01,085443,Carter; Anne Toulson,15,0,35,20
1657229972293,MATH 105,A02,093477,Carter; Anne Toulson,20,0,35,15
1657229978321,MATH 109,A01,083213,Ganzberger; Geoffrey Michael,2,0,34,32
1657229978321,MATH 109,A02,083214,Ganzberger; Geoffrey Michael,4,0,34,30
1657229978321,MATH 109,A03,093478,Ganzberger; Geoffrey Michael,2,0,34,32
1657229978321,MATH 109,B01,083215,Ganzberger; Geoffrey Michael,1,0,32,31
1657229978321,MATH 109,B02,083216,Ganzberger; Geoffrey Michael,1,0,32,31
1657229978321,MATH 109,B03,093479,Ganzberger; Geoffrey Michael,8,0,32,24
1657229984364,MATH 142A,A01,083219,Chow; Bennett,6,0,32,26
1657229984364,MATH 142A,A02,083220,Chow; Bennett,10,0,32,22
1657229984364,MATH 142A,A03,093480,Chow; Bennett,7,0,32,25
1657229984364,MATH 142A,B03,093481,Chow; Bennett,8,0,32,24
1657229984364,MATH 142A,B04,093558,Chow; Bennett,12,0,32,20
1657229984364,MATH 142A,B05,093559,Chow; Bennett,6,0,32,26
1657229990392,MATH 193A,A01,083224,Rotar; Vladimir,7,0,34,27
1657229990392,MATH 193A,A02,083225,Rotar; Vladimir,6,0,34,28
1657229990392,MATH 193A,A03,083781,Rotar; Vladimir,2,0,34,32
1657229990392,MATH 193A,A04,083782,Rotar; Vladimir,8,0,34,26
1657229990392,MATH 193A,A05,093482,Rotar; Vladimir,6,0,34,28
1657229996417,MATH 197,001,091859,McAuley; Julian John,9999,0,9999,0
1657229996417,MATH 197,002,095566,Kedlaya; Kiran S.,9997,0,9999,2
1657229996417,MATH 197,003,095567,Xiao; Ming,9999,0,9999,0
1657229996417,MATH 197,004,095571,Perols; Johan Lars,9998,0,9999,1
1657230003482,COGS 9,A01,083615,Shannon; Kyle Michael,8,0,75,67
1657230009516,COGS 11,A01,083617,Boyle; Mary E. T.,22,0,48,26
1657230015539,COGS 13,A01,083071,Bastos; Amalia Pinkusfeld,8,0,71,63
1657230021638,COGS 14A,A01,092681,Semenuks; Arturs,2,1,100,98
1657230027666,COGS 14B,A01,083073,Cheng; Tzu-Han,6,0,63,57
1657230033688,COGS 17,A01,092677,Semenuks; Arturs,5,0,81,76
1657230039715,COGS 100,A01,083619,Allen; Michael Gordon,16,0,70,54
1657230045751,COGS 101A,A01,083621,Davis; Joshua Daniel,9,0,68,59
1657230051777,COGS 101B,A01,091572,Allen; Michael Gordon,10,0,65,55
1657230057801,COGS 101C,A01,083625,Delgado; Tania,17,0,35,18
1657230063827,COGS 107A,A01,083627,Boyle; Mary E. T.,13,0,60,47
1657230069854,COGS 118A,A01,083075,Gupta; Anjum,16,0,76,60
1657230075881,CSE 3,A50,083646,Miranda; Gregory Joseph,24,0,50,26
1657230081910,CSE 8A,A50,083650,Miranda; Gregory Joseph,17,1,56,39
1657230087934,CSE 11,A01,083080,Cao; Yingjun,5,15,40,35
1657230093961,CSE 12,A01,083652,Krause-Levy; Sophia Louisa,24,1,120,96
1657230099986,CSE 15L,A01,083654,Morris; Justin Loren,9,0,50,41
1657230099986,CSE 15L,A02,083655,Morris; Justin Loren,9,0,50,41
1657230106015,CSE 20,A01,083657,Tran; Khoa Dang,38,0,80,42
1657230112040,CSE 21,A01,095574,Bach; Quang Tran,22,0,48,26
1657230118067,CSE 30,A01,083084,Eldon; John,4,0,80,76
1657230118067,CSE 30,B01,095061,Bhaskar; Nishant,8,0,50,42
1657230124104,CSE 100,A01,083659,Cao; Yingjun,4,4,70,66
1657230130132,CSE 134B,A01,083661,Powell; Thomas Allan,21,0,100,79
1657230136156,CSE 140,A01,083663,Gungor; Onat,13,0,85,72
1657230142177,CSE 140L,A01,083088,Eldon; John,17,0,100,83
1657230148202,CSE 175,A01,083665,Kumar; Rakesh,3,0,25,22
1657230154226,CSE 190,A00,092507,Dubnov; Shlomo,7,0,20,13
1657230160249,ECE 45,A01,083139,Congero; Spencer William,5,0,75,70
1657230166271,ECE 65,A50,083695,Saad; Andrew S,12,0,30,18
1657230166271,ECE 65,A51,095125,Saad; Andrew S,25,0,26,1
1657230172294,ECE 109,A01,091882,Touri; Behrouz,19,0,70,51
1657230178320,ECE 180,A00,083140,Abi Samra; Nicholas Camill,1,0,30,29
1657230178320,ECE 180,B00,083141,Abi Samra; Nicholas Camill,0,0,30,30
1657230184347,MATH 10A,A01,083735,Patchell; Gregory David,2,0,30,28
1657230184347,MATH 10A,A02,083736,Patchell; Gregory David,20,0,30,10
1657230184347,MATH 10A,A03,083737,Patchell; Gregory David,16,0,30,14
1657230190376,MATH 10B,A01,083207,Lim; Seonhee,7,0,34,27
1657230190376,MATH 10B,A02,083208,Lim; Seonhee,9,0,35,26
1657230190376,MATH 10B,A03,093472,Lim; Seonhee,5,0,34,29
1657230190376,MATH 10B,B01,083739,Sinha; Shubham,11,0,30,19
1657230196402,MATH 18,A01,083743,Cinel; Cameron Alexander,6,0,30,24
1657230196402,MATH 18,A02,083744,Cinel; Cameron Alexander,16,0,30,14
1657230196402,MATH 18,A03,083745,Cinel; Cameron Alexander,8,0,30,22
1657230196402,MATH 18,B01,083748,Rideout; David Porter,4,0,37,33
1657230196402,MATH 18,B02,083749,Rideout; David Porter,4,0,36,32
1657230196402,MATH 18,B03,083750,Rideout; David Porter,2,0,37,35
1657230196402,MATH 18,B04,083751,Rideout; David Porter,6,0,36,30
1657230196402,MATH 18,B05,093473,Rideout; David Porter,5,0,36,31
1657230196402,MATH 18,B06,093474,Rideout; David Porter,5,0,36,31
1657230202430,MATH 20A,A01,083754,Zheng; Zequn,14,0,40,26
1657230208453,MATH 20B,A01,083756,Briones; Jor-el Thomas Caparas,3,0,36,33
1657230208453,MATH 20B,A02,083757,Briones; Jor-el Thomas Caparas,1,0,36,35
1657230208453,MATH 20B,A03,093475,Briones; Jor-el Thomas Caparas,2,0,36,34
1657230214476,MATH 20C,A01,083760,Briones; Jor-el Thomas Caparas,1,0,35,34
1657230214476,MATH 20C,A02,083761,Briones; Jor-el Thomas Caparas,8,0,35,27
1657230214476,MATH 20C,A03,093476,Briones; Jor-el Thomas Caparas,0,1,36,36
1657230214476,MATH 20C,B01,083762,Bach; Quang Tran,1,0,30,29
1657230220499,MATH 20D,A01,083765,Tran; Brian Kha,4,0,30,26
1657230220499,MATH 20D,A02,083766,Tran; Brian Kha,5,0,30,25
1657230220499,MATH 20D,A03,083767,Tran; Brian Kha,4,0,30,26
1657230226523,MATH 20E,A01,083771,Ganguly; Soumya,7,0,32,25
1657230226523,MATH 20E,A02,083772,Ganguly; Soumya,7,0,32,25
1657230226523,MATH 20E,B01,083773,Ciotti; Benjamin,19,0,35,16
1657230226523,MATH 20E,B02,083774,Ciotti; Benjamin,17,0,35,18
1657230232547,MATH 103A,A01,083777,Greenfeld; Be'Eri,3,0,36,33
1657230232547,MATH 103A,A02,083778,Greenfeld; Be'Eri,5,0,36,31
1657230232547,MATH 103A,A03,093561,Greenfeld; Be'Eri,4,0,36,32
1657230232547,MATH 103A,B01,083779,Greenfeld; Be'Eri,6,0,36,30
1657230232547,MATH 103A,B02,083780,Greenfeld; Be'Eri,3,0,36,33
1657230232547,MATH 103A,B03,093562,Greenfeld; Be'Eri,3,0,36,33
1657230238569,MATH 105,A01,085443,Carter; Anne Toulson,15,0,35,20
1657230238569,MATH 105,A02,093477,Carter; Anne Toulson,20,0,35,15
1657230244593,MATH 109,A01,083213,Ganzberger; Geoffrey Michael,2,0,34,32
1657230244593,MATH 109,A02,083214,Ganzberger; Geoffrey Michael,4,0,34,30
1657230244593,MATH 109,A03,093478,Ganzberger; Geoffrey Michael,2,0,34,32
1657230244593,MATH 109,B01,083215,Ganzberger; Geoffrey Michael,1,0,32,31
1657230244593,MATH 109,B02,083216,Ganzberger; Geoffrey Michael,1,0,32,31
1657230244593,MATH 109,B03,093479,Ganzberger; Geoffrey Michael,8,0,32,24
1657230250623,MATH 142A,A01,083219,Chow; Bennett,6,0,32,26
1657230250623,MATH 142A,A02,083220,Chow; Bennett,10,0,32,22
1657230250623,MATH 142A,A03,093480,Chow; Bennett,7,0,32,25
1657230250623,MATH 142A,B03,093481,Chow; Bennett,8,0,32,24
1657230250623,MATH 142A,B04,093558,Chow; Bennett,12,0,32,20
1657230250623,MATH 142A,B05,093559,Chow; Bennett,6,0,32,26
1657230256653,MATH 193A,A01,083224,Rotar; Vladimir,7,0,34,27
1657230256653,MATH 193A,A02,083225,Rotar; Vladimir,6,0,34,28
1657230256653,MATH 193A,A03,083781,Rotar; Vladimir,2,0,34,32
1657230256653,MATH 193A,A04,083782,Rotar; Vladimir,8,0,34,26
1657230256653,MATH 193A,A05,093482,Rotar; Vladimir,6,0,34,28
1657230262676,MATH 197,001,091859,McAuley; Julian John,9999,0,9999,0
1657230262676,MATH 197,002,095566,Kedlaya; Kiran S.,9997,0,9999,2
1657230262676,MATH 197,003,095567,Xiao; Ming,9999,0,9999,0
1657230262676,MATH 197,004,095571,Perols; Johan Lars,9998,0,9999,1
1657230269733,COGS 9,A01,083615,Shannon; Kyle Michael,8,0,75,67
1657230275764,COGS 11,A01,083617,Boyle; Mary E. T.,22,0,48,26
1657230281787,COGS 13,A01,083071,Bastos; Amalia Pinkusfeld,8,0,71,63
1657230287813,COGS 14A,A01,092681,Semenuks; Arturs,2,1,100,98
1657230293838,COGS 14B,A01,083073,Cheng; Tzu-Han,6,0,63,57
1657230299865,COGS 17,A01,092677,Semenuks; Arturs,5,0,81,76
1657230305887,COGS 100,A01,083619,Allen; Michael Gordon,16,0,70,54
1657230311911,COGS 101A,A01,083621,Davis; Joshua Daniel,9,0,68,59
1657230317935,COGS 101B,A01,091572,Allen; Michael Gordon,10,0,65,55
1657230323961,COGS 101C,A01,083625,Delgado; Tania,17,0,35,18
1657230329984,COGS 107A,A01,083627,Boyle; Mary E. T.,13,0,60,47
1657230336007,COGS 118A,A01,083075,Gupta; Anjum,16,0,76,60
1657230342031,CSE 3,A50,083646,Miranda; Gregory Joseph,24,0,50,26
1657230348053,CSE 8A,A50,083650,Miranda; Gregory Joseph,17,1,56,39
1657230354079,CSE 11,A01,083080,Cao; Yingjun,5,15,40,35
1657230360102,CSE 12,A01,083652,Krause-Levy; Sophia Louisa,24,1,120,96
1657230366138,CSE 15L,A01,083654,Morris; Justin Loren,9,0,50,41
1657230366138,CSE 15L,A02,083655,Morris; Justin Loren,9,0,50,41
1657230372169,CSE 20,A01,083657,Tran; Khoa Dang,38,0,80,42
1657230378197,CSE 21,A01,095574,Bach; Quang Tran,22,0,48,26
1657230384230,CSE 30,A01,083084,Eldon; John,4,0,80,76
1657230384230,CSE 30,B01,095061,Bhaskar; Nishant,8,0,50,42
1657230390256,CSE 100,A01,083659,Cao; Yingjun,4,4,70,66
1657230396279,CSE 134B,A01,083661,Powell; Thomas Allan,21,0,100,79
1657230402301,CSE 140,A01,083663,Gungor; Onat,13,0,85,72
1657230408324,CSE 140L,A01,083088,Eldon; John,17,0,100,83
1657230414347,CSE 175,A01,083665,Kumar; Rakesh,3,0,25,22
1657230420372,CSE 190,A00,092507,Dubnov; Shlomo,7,0,20,13
1657230426394,ECE 45,A01,083139,Congero; Spencer William,5,0,75,70
1657230432417,ECE 65,A50,083695,Saad; Andrew S,12,0,30,18
1657230432417,ECE 65,A51,095125,Saad; Andrew S,25,0,26,1
1657230438453,ECE 109,A01,091882,Touri; Behrouz,19,0,70,51
1657230444479,ECE 180,A00,083140,Abi Samra; Nicholas Camill,1,0,30,29
1657230444479,ECE 180,B00,083141,Abi Samra; Nicholas Camill,0,0,30,30
1657230450511,MATH 10A,A01,083735,Patchell; Gregory David,2,0,30,28
1657230450511,MATH 10A,A02,083736,Patchell; Gregory David,20,0,30,10
1657230450511,MATH 10A,A03,083737,Patchell; Gregory David,16,0,30,14
1657230456536,MATH 10B,A01,083207,Lim; Seonhee,7,0,34,27
1657230456536,MATH 10B,A02,083208,Lim; Seonhee,9,0,35,26
1657230456536,MATH 10B,A03,093472,Lim; Seonhee,5,0,34,29
1657230456536,MATH 10B,B01,083739,Sinha; Shubham,11,0,30,19
1657230462567,MATH 18,A01,083743,Cinel; Cameron Alexander,6,0,30,24
1657230462567,MATH 18,A02,083744,Cinel; Cameron Alexander,16,0,30,14
1657230462567,MATH 18,A03,083745,Cinel; Cameron Alexander,8,0,30,22
1657230462567,MATH 18,B01,083748,Rideout; David Porter,4,0,37,33
1657230462567,MATH 18,B02,083749,Rideout; David Porter,4,0,36,32
1657230462567,MATH 18,B03,083750,Rideout; David Porter,2,0,37,35
1657230462567,MATH 18,B04,083751,Rideout; David Porter,6,0,36,30
1657230462567,MATH 18,B05,093473,Rideout; David Porter,5,0,36,31
1657230462567,MATH 18,B06,093474,Rideout; David Porter,5,0,36,31
1657230468594,MATH 20A,A01,083754,Zheng; Zequn,14,0,40,26
1657230474622,MATH 20B,A01,083756,Briones; Jor-el Thomas Caparas,3,0,36,33
1657230474622,MATH 20B,A02,083757,Briones; Jor-el Thomas Caparas,1,0,36,35
1657230474622,MATH 20B,A03,093475,Briones; Jor-el Thomas Caparas,2,0,36,34
1657230480656,MATH 20C,A01,083760,Briones; Jor-el Thomas Caparas,1,0,35,34
1657230480656,MATH 20C,A02,083761,Briones; Jor-el Thomas Caparas,8,0,35,27
1657230480656,MATH 20C,A03,093476,Briones; Jor-el Thomas Caparas,0,1,36,36
1657230480656,MATH 20C,B01,083762,Bach; Quang Tran,1,0,30,29
1657230486683,MATH 20D,A01,083765,Tran; Brian Kha,4,0,30,26
1657230486683,MATH 20D,A02,083766,Tran; Brian Kha,5,0,30,25
1657230486683,MATH 20D,A03,083767,Tran; Brian Kha,4,0,30,26
1657230492710,MATH 20E,A01,083771,Ganguly; Soumya,7,0,32,25
1657230492710,MATH 20E,A02,083772,Ganguly; Soumya,7,0,32,25
1657230492710,MATH 20E,B01,083773,Ciotti; Benjamin,19,0,35,16
1657230492710,MATH 20E,B02,083774,Ciotti; Benjamin,17,0,35,18
1657230498739,MATH 103A,A01,083777,Greenfeld; Be'Eri,3,0,36,33
1657230498739,MATH 103A,A02,083778,Greenfeld; Be'Eri,5,0,36,31
1657230498739,MATH 103A,A03,093561,Greenfeld; Be'Eri,4,0,36,32
1657230498739,MATH 103A,B01,083779,Greenfeld; Be'Eri,6,0,36,30
1657230498739,MATH 103A,B02,083780,Greenfeld; Be'Eri,3,0,36,33
1657230498739,MATH 103A,B03,093562,Greenfeld; Be'Eri,3,0,36,33
1657230504763,MATH 105,A01,085443,Carter; Anne Toulson,15,0,35,20
1657230504763,MATH 105,A02,093477,Carter; Anne Toulson,20,0,35,15
1657230510796,MATH 109,A01,083213,Ganzberger; Geoffrey Michael,2,0,34,32
1657230510796,MATH 109,A02,083214,Ganzberger; Geoffrey Michael,4,0,34,30
1657230510796,MATH 109,A03,093478,Ganzberger; Geoffrey Michael,2,0,34,32
1657230510796,MATH 109,B01,083215,Ganzberger; Geoffrey Michael,1,0,32,31
1657230510796,MATH 109,B02,083216,Ganzberger; Geoffrey Michael,1,0,32,31
1657230510796,MATH 109,B03,093479,Ganzberger; Geoffrey Michael,8,0,32,24
1657230516835,MATH 142A,A01,083219,Chow; Bennett,6,0,32,26
1657230516835,MATH 142A,A02,083220,Chow; Bennett,10,0,32,22
1657230516835,MATH 142A,A03,093480,Chow; Bennett,7,0,32,25
1657230516835,MATH 142A,B03,093481,Chow; Bennett,8,0,32,24
1657230516835,MATH 142A,B04,093558,Chow; Bennett,12,0,32,20
1657230516835,MATH 142A,B05,093559,Chow; Bennett,6,0,32,26
1657230522862,MATH 193A,A01,083224,Rotar; Vladimir,7,0,34,27
1657230522862,MATH 193A,A02,083225,Rotar; Vladimir,6,0,34,28
1657230522862,MATH 193A,A03,083781,Rotar; Vladimir,2,0,34,32
1657230522862,MATH 193A,A04,083782,Rotar; Vladimir,8,0,34,26
1657230522862,MATH 193A,A05,093482,Rotar; Vladimir,6,0,34,28
1657230528888,MATH 197,001,091859,McAuley; Julian John,9999,0,9999,0
1657230528888,MATH 197,002,095566,Kedlaya; Kiran S.,9997,0,9999,2
1657230528888,MATH 197,003,095567,Xiao; Ming,9999,0,9999,0
1657230528888,MATH 197,004,095571,Perols; Johan Lars,9998,0,9999,1
1657230535948,COGS 9,A01,083615,Shannon; Kyle Michael,8,0,75,67
1657230541971,COGS 11,A01,083617,Boyle; Mary E. T.,22,0,48,26
1657230547996,COGS 13,A01,083071,Bastos; Amalia Pinkusfeld,8,0,71,63
1657230554025,COGS 14A,A01,092681,Semenuks; Arturs,2,1,100,98
1657230560053,COGS 14B,A01,083073,Cheng; Tzu-Han,6,0,63,57
1657230566076,COGS 17,A01,092677,Semenuks; Arturs,5,0,81,76
1657230572108,COGS 100,A01,083619,Allen; Michael Gordon,16,0,70,54
1657230578132,COGS 101A,A01,083621,Davis; Joshua Daniel,9,0,68,59
1657230584160,COGS 101B,A01,091572,Allen; Michael Gordon,10,0,65,55
1657230590197,COGS 101C,A01,083625,Delgado; Tania,17,0,35,18
1657230596226,COGS 107A,A01,083627,Boyle; Mary E. T.,13,0,60,47
1657230602251,COGS 118A,A01,083075,Gupta; Anjum,16,0,76,60
1657230608274,CSE 3,A50,083646,Miranda; Gregory Joseph,24,0,50,26
1657230614298,CSE 8A,A50,083650,Miranda; Gregory Joseph,17,1,56,39
1657230620411,CSE 11,A01,083080,Cao; Yingjun,5,15,40,35
1657230626448,CSE 12,A01,083652,Krause-Levy; Sophia Louisa,24,1,120,96
1657230632483,CSE 15L,A01,083654,Morris; Justin Loren,9,0,50,41
1657230632483,CSE 15L,A02,083655,Morris; Justin Loren,9,0,50,41
1657230638510,CSE 20,A01,083657,Tran; Khoa Dang,38,0,80,42
1657230644536,CSE 21,A01,095574,Bach; Quang Tran,22,0,48,26
1657230650561,CSE 30,A01,083084,Eldon; John,4,0,80,76
1657230650561,CSE 30,B01,095061,Bhaskar; Nishant,8,0,50,42
1657230656584,CSE 100,A01,083659,Cao; Yingjun,4,4,70,66
1657230662612,CSE 134B,A01,083661,Powell; Thomas Allan,21,0,100,79
1657230668638,CSE 140,A01,083663,Gungor; Onat,13,0,85,72
1657230674664,CSE 140L,A01,083088,Eldon; John,17,0,100,83
1657230680687,CSE 175,A01,083665,Kumar; Rakesh,3,0,25,22
1657230686711,CSE 190,A00,092507,Dubnov; Shlomo,7,0,20,13
1657230692737,ECE 45,A01,083139,Congero; Spencer William,5,0,75,70
1657230698766,ECE 65,A50,083695,Saad; Andrew S,12,0,30,18
1657230698766,ECE 65,A51,095125,Saad; Andrew S,25,0,26,1
1657230704788,ECE 109,A01,091882,Touri; Behrouz,19,0,70,51
1657230710815,ECE 180,A00,083140,Abi Samra; Nicholas Camill,1,0,30,29
1657230710815,ECE 180,B00,083141,Abi Samra; Nicholas Camill,0,0,30,30
1657230716840,MATH 10A,A01,083735,Patchell; Gregory David,2,0,30,28
1657230716840,MATH 10A,A02,083736,Patchell; Gregory David,20,0,30,10
1657230716840,MATH 10A,A03,083737,Patchell; Gregory David,16,0,30,14
1657230722865,MATH 10B,A01,083207,Lim; Seonhee,7,0,34,27
1657230722865,MATH 10B,A02,083208,Lim; Seonhee,9,0,35,26
1657230722865,MATH 10B,A03,093472,Lim; Seonhee,5,0,34,29
1657230722865,MATH 10B,B01,083739,Sinha; Shubham,11,0,30,19
1657230728902,MATH 18,A01,083743,Cinel; Cameron Alexander,6,0,30,24
1657230728902,MATH 18,A02,083744,Cinel; Cameron Alexander,16,0,30,14
1657230728902,MATH 18,A03,083745,Cinel; Cameron Alexander,8,0,30,22
1657230728902,MATH 18,B01,083748,Rideout; David Porter,4,0,37,33
1657230728902,MATH 18,B02,083749,Rideout; David Porter,4,0,36,32
1657230728902,MATH 18,B03,083750,Rideout; David Porter,2,0,37,35
1657230728902,MATH 18,B04,083751,Rideout; David Porter,6,0,36,30
1657230728902,MATH 18,B05,093473,Rideout; David Porter,5,0,36,31
1657230728902,MATH 18,B06,093474,Rideout; David Porter,5,0,36,31
1657230734926,MATH 20A,A01,083754,Zheng; Zequn,14,0,40,26
1657230740953,MATH 20B,A01,083756,Briones; Jor-el Thomas Caparas,3,0,36,33
1657230740953,MATH 20B,A02,083757,Briones; Jor-el Thomas Caparas,1,0,36,35
1657230740953,MATH 20B,A03,093475,Briones; Jor-el Thomas Caparas,2,0,36,34
1657230746977,MATH 20C,A01,083760,Briones; Jor-el Thomas Caparas,1,0,35,34
1657230746977,MATH 20C,A02,083761,Briones; Jor-el Thomas Caparas,8,0,35,27
1657230746977,MATH 20C,A03,093476,Briones; Jor-el Thomas Caparas,0,1,36,36
1657230746977,MATH 20C,B01,083762,Bach; Quang Tran,1,0,30,29
1657230753001,MATH 20D,A01,083765,Tran; Brian Kha,4,0,30,26
1657230753001,MATH 20D,A02,083766,Tran; Brian Kha,5,0,30,25
1657230753001,MATH 20D,A03,083767,Tran; Brian Kha,4,0,30,26
1657230759025,MATH 20E,A01,083771,Ganguly; Soumya,7,0,32,25
1657230759025,MATH 20E,A02,083772,Ganguly; Soumya,7,0,32,25
1657230759025,MATH 20E,B01,083773,Ciotti; Benjamin,19,0,35,16
1657230759025,MATH 20E,B02,083774,Ciotti; Benjamin,17,0,35,18
1657230765047,MATH 103A,A01,083777,Greenfeld; Be'Eri,3,0,36,33
1657230765047,MATH 103A,A02,083778,Greenfeld; Be'Eri,5,0,36,31
1657230765047,MATH 103A,A03,093561,Greenfeld; Be'Eri,4,0,36,32
1657230765047,MATH 103A,B01,083779,Greenfeld; Be'Eri,6,0,36,30
1657230765047,MATH 103A,B02,083780,Greenfeld; Be'Eri,3,0,36,33
1657230765047,MATH 103A,B03,093562,Greenfeld; Be'Eri,3,0,36,33
1657230771077,MATH 105,A01,085443,Carter; Anne Toulson,15,0,35,20
1657230771077,MATH 105,A02,093477,Carter; Anne Toulson,20,0,35,15
1657230777138,MATH 109,A01,083213,Ganzberger; Geoffrey Michael,2,0,34,32
1657230777138,MATH 109,A02,083214,Ganzberger; Geoffrey Michael,4,0,34,30
1657230777138,MATH 109,A03,093478,Ganzberger; Geoffrey Michael,2,0,34,32
1657230777138,MATH 109,B01,083215,Ganzberger; Geoffrey Michael,1,0,32,31
1657230777138,MATH 109,B02,083216,Ganzberger; Geoffrey Michael,1,0,32,31
1657230777138,MATH 109,B03,093479,Ganzberger; Geoffrey Michael,8,0,32,24
1657230783167,MATH 142A,A01,083219,Chow; Bennett,6,0,32,26
1657230783167,MATH 142A,A02,083220,Chow; Bennett,10,0,32,22
1657230783167,MATH 142A,A03,093480,Chow; Bennett,7,0,32,25
1657230783167,MATH 142A,B03,093481,Chow; Bennett,8,0,32,24
1657230783167,MATH 142A,B04,093558,Chow; Bennett,12,0,32,20
1657230783167,MATH 142A,B05,093559,Chow; Bennett,6,0,32,26
1657230789199,MATH 193A,A01,083224,Rotar; Vladimir,7,0,34,27
1657230789199,MATH 193A,A02,083225,Rotar; Vladimir,6,0,34,28
1657230789199,MATH 193A,A03,083781,Rotar; Vladimir,2,0,34,32
1657230789199,MATH 193A,A04,083782,Rotar; Vladimir,8,0,34,26
1657230789199,MATH 193A,A05,093482,Rotar; Vladimir,6,0,34,28
1657230795224,MATH 197,001,091859,McAuley; Julian John,9999,0,9999,0
1657230795224,MATH 197,002,095566,Kedlaya; Kiran S.,9997,0,9999,2
1657230795224,MATH 197,003,095567,Xiao; Ming,9999,0,9999,0
1657230795224,MATH 197,004,095571,Perols; Johan Lars,9998,0,9999,1
1657230802278,COGS 9,A01,083615,Shannon; Kyle Michael,8,0,75,67
1657230808307,COGS 11,A01,083617,Boyle; Mary E. T.,22,0,48,26
1657230814329,COGS 13,A01,083071,Bastos; Amalia Pinkusfeld,8,0,71,63
1657230820357,COGS 14A,A01,092681,Semenuks; Arturs,2,1,100,98
1657230826384,COGS 14B,A01,083073,Cheng; Tzu-Han,6,0,63,57
1657230832407,COGS 17,A01,092677,Semenuks; Arturs,5,0,81,76
1657230838437,COGS 100,A01,083619,Allen; Michael Gordon,16,0,70,54
1657230844459,COGS 101A,A01,083621,Davis; Joshua Daniel,9,0,68,59
1657230850481,COGS 101B,A01,091572,Allen; Michael Gordon,10,0,65,55
1657230856524,COGS 101C,A01,083625,Delgado; Tania,17,0,35,18
1657230862547,COGS 107A,A01,083627,Boyle; Mary E. T.,13,0,60,47
1657230868571,COGS 118A,A01,083075,Gupta; Anjum,16,0,76,60
1657230874609,CSE 3,A50,083646,Miranda; Gregory Joseph,24,0,50,26
1657230880633,CSE 8A,A50,083650,Miranda; Gregory Joseph,17,1,56,39
1657230886662,CSE 11,A01,083080,Cao; Yingjun,5,15,40,35
1657230892687,CSE 12,A01,083652,Krause-Levy; Sophia Louisa,24,1,120,96
1657230898713,CSE 15L,A01,083654,Morris; Justin Loren,9,0,50,41
1657230898713,CSE 15L,A02,083655,Morris; Justin Loren,9,0,50,41
1657230904741,CSE 20,A01,083657,Tran; Khoa Dang,38,0,80,42
1657230910768,CSE 21,A01,095574,Bach; Quang Tran,22,0,48,26
1657230916790,CSE 30,A01,083084,Eldon; John,4,0,80,76
1657230916790,CSE 30,B01,095061,Bhaskar; Nishant,8,0,50,42
1657230922816,CSE 100,A01,083659,Cao; Yingjun,4,4,70,66
1657230928840,CSE 134B,A01,083661,Powell; Thomas Allan,21,0,100,79
1657230934871,CSE 140,A01,083663,Gungor; Onat,13,0,85,72
1657230940894,CSE 140L,A01,083088,Eldon; John,17,0,100,83
1657230946920,CSE 175,A01,083665,Kumar; Rakesh,3,0,25,22
1657230952943,CSE 190,A00,092507,Dubnov; Shlomo,7,0,20,13
1657230958967,ECE 45,A01,083139,Congero; Spencer William,5,0,75,70
1657230964997,ECE 65,A50,083695,Saad; Andrew S,12,0,30,18
1657230964997,ECE 65,A51,095125,Saad; Andrew S,25,0,26,1
1657230971021,ECE 109,A01,091882,Touri; Behrouz,19,0,70,51
1657230977047,ECE 180,A00,083140,Abi Samra; Nicholas Camill,1,0,30,29
1657230977047,ECE 180,B00,083141,Abi Samra; Nicholas Camill,0,0,30,30
1657230983073,MATH 10A,A01,083735,Patchell; Gregory David,2,0,30,28
1657230983073,MATH 10A,A02,083736,Patchell; Gregory David,20,0,30,10
1657230983073,MATH 10A,A03,083737,Patchell; Gregory David,16,0,30,14
1657230989098,MATH 10B,A01,083207,Lim; Seonhee,7,0,34,27
1657230989098,MATH 10B,A02,083208,Lim; Seonhee,9,0,35,26
1657230989098,MATH 10B,A03,093472,Lim; Seonhee,5,0,34,29
1657230989098,MATH 10B,B01,083739,Sinha; Shubham,11,0,30,19
1657230995121,MATH 18,A01,083743,Cinel; Cameron Alexander,6,0,30,24
1657230995121,MATH 18,A02,083744,Cinel; Cameron Alexander,16,0,30,14
1657230995121,MATH 18,A03,083745,Cinel; Cameron Alexander,8,0,30,22
1657230995121,MATH 18,B01,083748,Rideout; David Porter,4,0,37,33
1657230995121,MATH 18,B02,083749,Rideout; David Porter,4,0,36,32
1657230995121,MATH 18,B03,083750,Rideout; David Porter,2,0,37,35
1657230995121,MATH 18,B04,083751,Rideout; David Porter,6,0,36,30
1657230995121,MATH 18,B05,093473,Rideout; David Porter,5,0,36,31
1657230995121,MATH 18,B06,093474,Rideout; David Porter,5,0,36,31
1657231001145,MATH 20A,A01,083754,Zheng; Zequn,14,0,40,26
1657231007169,MATH 20B,A01,083756,Briones; Jor-el Thomas Caparas,3,0,36,33
1657231007169,MATH 20B,A02,083757,Briones; Jor-el Thomas Caparas,1,0,36,35
1657231007169,MATH 20B,A03,093475,Briones; Jor-el Thomas Caparas,2,0,36,34
1657231013199,MATH 20C,A01,083760,Briones; Jor-el Thomas Caparas,1,0,35,34
1657231013199,MATH 20C,A02,083761,Briones; Jor-el Thomas Caparas,8,0,35,27
1657231013199,MATH 20C,A03,093476,Briones; Jor-el Thomas Caparas,0,1,36,36
1657231013199,MATH 20C,B01,083762,Bach; Quang Tran,1,0,30,29
1657231019223,MATH 20D,A01,083765,Tran; Brian Kha,4,0,30,26
1657231019223,MATH 20D,A02,083766,Tran; Brian Kha,5,0,30,25
1657231019223,MATH 20D,A03,083767,Tran; Brian Kha,4,0,30,26
1657231025252,MATH 20E,A01,083771,Ganguly; Soumya,7,0,32,25
1657231025252,MATH 20E,A02,083772,Ganguly; Soumya,7,0,32,25
1657231025252,MATH 20E,B01,083773,Ciotti; Benjamin,19,0,35,16
1657231025252,MATH 20E,B02,083774,Ciotti; Benjamin,17,0,35,18
1657231031273,MATH 103A,A01,083777,Greenfeld; Be'Eri,3,0,36,33
1657231031273,MATH 103A,A02,083778,Greenfeld; Be'Eri,5,0,36,31
1657231031273,MATH 103A,A03,093561,Greenfeld; Be'Eri,4,0,36,32
1657231031273,MATH 103A,B01,083779,Greenfeld; Be'Eri,6,0,36,30
1657231031273,MATH 103A,B02,083780,Greenfeld; Be'Eri,3,0,36,33
1657231031273,MATH 103A,B03,093562,Greenfeld; Be'Eri,3,0,36,33
1657231037298,MATH 105,A01,085443,Carter; Anne Toulson,15,0,35,20
1657231037298,MATH 105,A02,093477,Carter; Anne Toulson,20,0,35,15
1657231043321,MATH 109,A01,083213,Ganzberger; Geoffrey Michael,2,0,34,32
1657231043321,MATH 109,A02,083214,Ganzberger; Geoffrey Michael,4,0,34,30
1657231043321,MATH 109,A03,093478,Ganzberger; Geoffrey Michael,2,0,34,32
1657231043321,MATH 109,B01,083215,Ganzberger; Geoffrey Michael,1,0,32,31
1657231043321,MATH 109,B02,083216,Ganzberger; Geoffrey Michael,1,0,32,31
1657231043321,MATH 109,B03,093479,Ganzberger; Geoffrey Michael,8,0,32,24
1657231049349,MATH 142A,A01,083219,Chow; Bennett,6,0,32,26
1657231049349,MATH 142A,A02,083220,Chow; Bennett,10,0,32,22
1657231049349,MATH 142A,A03,093480,Chow; Bennett,7,0,32,25
1657231049349,MATH 142A,B03,093481,Chow; Bennett,8,0,32,24
1657231049349,MATH 142A,B04,093558,Chow; Bennett,12,0,32,20
1657231049349,MATH 142A,B05,093559,Chow; Bennett,6,0,32,26
1657231055373,MATH 193A,A01,083224,Rotar; Vladimir,7,0,34,27
1657231055373,MATH 193A,A02,083225,Rotar; Vladimir,6,0,34,28
1657231055373,MATH 193A,A03,083781,Rotar; Vladimir,2,0,34,32
1657231055373,MATH 193A,A04,083782,Rotar; Vladimir,8,0,34,26
1657231055373,MATH 193A,A05,093482,Rotar; Vladimir,6,0,34,28
1657231061399,MATH 197,001,091859,McAuley; Julian John,9999,0,9999,0
1657231061399,MATH 197,002,095566,Kedlaya; Kiran S.,9997,0,9999,2
1657231061399,MATH 197,003,095567,Xiao; Ming,9999,0,9999,0
1657231061399,MATH 197,004,095571,Perols; Johan Lars,9998,0,9999,1
1657231068452,COGS 9,A01,083615,Shannon; Kyle Michael,8,0,75,67
1657231074478,COGS 11,A01,083617,Boyle; Mary E. T.,22,0,48,26
1657231080514,COGS 13,A01,083071,Bastos; Amalia Pinkusfeld,8,0,71,63
1657231086545,COGS 14A,A01,092681,Semenuks; Arturs,2,1,100,98
1657231092567,COGS 14B,A01,083073,Cheng; Tzu-Han,6,0,63,57
1657231098590,COGS 17,A01,092677,Semenuks; Arturs,5,0,81,76
1657231104616,COGS 100,A01,083619,Allen; Michael Gordon,16,0,70,54
1657231110643,COGS 101A,A01,083621,Davis; Joshua Daniel,9,0,68,59
1657231116666,COGS 101B,A01,091572,Allen; Michael Gordon,10,0,65,55
1657231122695,COGS 101C,A01,083625,Delgado; Tania,17,0,35,18
1657231128718,COGS 107A,A01,083627,Boyle; Mary E. T.,13,0,60,47
1657231134745,COGS 118A,A01,083075,Gupta; Anjum,16,0,76,60
1657231140768,CSE 3,A50,083646,Miranda; Gregory Joseph,24,0,50,26
1657231146810,CSE 8A,A50,083650,Miranda; Gregory Joseph,17,1,56,39
1657231152842,CSE 11,A01,083080,Cao; Yingjun,5,15,40,35
1657231158874,CSE 12,A01,083652,Krause-Levy; Sophia Louisa,24,1,120,96
1657231164898,CSE 15L,A01,083654,Morris; Justin Loren,9,0,50,41
1657231164898,CSE 15L,A02,083655,Morris; Justin Loren,9,0,50,41
1657231170923,CSE 20,A01,083657,Tran; Khoa Dang,38,0,80,42
1657231176946,CSE 21,A01,095574,Bach; Quang Tran,22,0,48,26
1657231182972,CSE 30,A01,083084,Eldon; John,4,0,80,76
1657231182972,CSE 30,B01,095061,Bhaskar; Nishant,8,0,50,42
1657231188994,CSE 100,A01,083659,Cao; Yingjun,4,4,70,66
1657231195016,CSE 134B,A01,083661,Powell; Thomas Allan,21,0,100,79
1657231201038,CSE 140,A01,083663,Gungor; Onat,13,0,85,72
1657231207065,CSE 140L,A01,083088,Eldon; John,17,0,100,83
1657231213094,CSE 175,A01,083665,Kumar; Rakesh,3,0,25,22
1657231219215,CSE 190,A00,092507,Dubnov; Shlomo,7,0,20,13
1657231225241,ECE 45,A01,083139,Congero; Spencer William,5,0,75,70
1657231231270,ECE 65,A50,083695,Saad; Andrew S,12,0,30,18
1657231231270,ECE 65,A51,095125,Saad; Andrew S,25,0,26,1
1657231237308,ECE 109,A01,091882,Touri; Behrouz,19,0,70,51
1657231243335,ECE 180,A00,083140,Abi Samra; Nicholas Camill,1,0,30,29
1657231243335,ECE 180,B00,083141,Abi Samra; Nicholas Camill,0,0,30,30
1657231249359,MATH 10A,A01,083735,Patchell; Gregory David,2,0,30,28
1657231249359,MATH 10A,A02,083736,Patchell; Gregory David,20,0,30,10
1657231249359,MATH 10A,A03,083737,Patchell; Gregory David,16,0,30,14
1657231255389,MATH 10B,A01,083207,Lim; Seonhee,7,0,34,27
1657231255389,MATH 10B,A02,083208,Lim; Seonhee,9,0,35,26
1657231255389,MATH 10B,A03,093472,Lim; Seonhee,5,0,34,29
1657231255389,MATH 10B,B01,083739,Sinha; Shubham,11,0,30,19
1657231261420,MATH 18,A01,083743,Cinel; Cameron Alexander,6,0,30,24
1657231261420,MATH 18,A02,083744,Cinel; Cameron Alexander,16,0,30,14
1657231261420,MATH 18,A03,083745,Cinel; Cameron Alexander,8,0,30,22
1657231261420,MATH 18,B01,083748,Rideout; David Porter,4,0,37,33
1657231261420,MATH 18,B02,083749,Rideout; David Porter,4,0,36,32
1657231261420,MATH 18,B03,083750,Rideout; David Porter,2,0,37,35
1657231261420,MATH 18,B04,083751,Rideout; David Porter,6,0,36,30
1657231261420,MATH 18,B05,093473,Rideout; David Porter,5,0,36,31
1657231261420,MATH 18,B06,093474,Rideout; David Porter,5,0,36,31
1657231267453,MATH 20A,A01,083754,Zheng; Zequn,14,0,40,26
1657231273475,MATH 20B,A01,083756,Briones; Jor-el Thomas Caparas,3,0,36,33
1657231273475,MATH 20B,A02,083757,Briones; Jor-el Thomas Caparas,1,0,36,35
1657231273475,MATH 20B,A03,093475,Briones; Jor-el Thomas Caparas,2,0,36,34
1657231279505,MATH 20C,A01,083760,Briones; Jor-el Thomas Caparas,1,0,35,34
1657231279505,MATH 20C,A02,083761,Briones; Jor-el Thomas Caparas,8,0,35,27
1657231279505,MATH 20C,A03,093476,Briones; Jor-el Thomas Caparas,0,1,36,36
1657231279505,MATH 20C,B01,083762,Bach; Quang Tran,1,0,30,29
1657231285529,MATH 20D,A01,083765,Tran; Brian Kha,4,0,30,26
1657231285529,MATH 20D,A02,083766,Tran; Brian Kha,5,0,30,25
1657231285529,MATH 20D,A03,083767,Tran; Brian Kha,4,0,30,26
1657231291552,MATH 20E,A01,083771,Ganguly; Soumya,7,0,32,25
1657231291552,MATH 20E,A02,083772,Ganguly; Soumya,7,0,32,25
1657231291552,MATH 20E,B01,083773,Ciotti; Benjamin,19,0,35,16
1657231291552,MATH 20E,B02,083774,Ciotti; Benjamin,17,0,35,18
1657231297576,MATH 103A,A01,083777,Greenfeld; Be'Eri,3,0,36,33
1657231297576,MATH 103A,A02,083778,Greenfeld; Be'Eri,5,0,36,31
1657231297576,MATH 103A,A03,093561,Greenfeld; Be'Eri,4,0,36,32
1657231297576,MATH 103A,B01,083779,Greenfeld; Be'Eri,6,0,36,30
1657231297576,MATH 103A,B02,083780,Greenfeld; Be'Eri,3,0,36,33
1657231297576,MATH 103A,B03,093562,Greenfeld; Be'Eri,3,0,36,33
1657231303603,MATH 105,A01,085443,Carter; Anne Toulson,15,0,35,20
1657231303603,MATH 105,A02,093477,Carter; Anne Toulson,20,0,35,15
1657231309631,MATH 109,A01,083213,Ganzberger; Geoffrey Michael,2,0,34,32
1657231309631,MATH 109,A02,083214,Ganzberger; Geoffrey Michael,4,0,34,30
1657231309631,MATH 109,A03,093478,Ganzberger; Geoffrey Michael,2,0,34,32
1657231309631,MATH 109,B01,083215,Ganzberger; Geoffrey Michael,1,0,32,31
1657231309631,MATH 109,B02,083216,Ganzberger; Geoffrey Michael,1,0,32,31
1657231309631,MATH 109,B03,093479,Ganzberger; Geoffrey Michael,8,0,32,24
1657231315656,MATH 142A,A01,083219,Chow; Bennett,6,0,32,26
1657231315656,MATH 142A,A02,083220,Chow; Bennett,10,0,32,22
1657231315656,MATH 142A,A03,093480,Chow; Bennett,7,0,32,25
1657231315656,MATH 142A,B03,093481,Chow; Bennett,8,0,32,24
1657231315656,MATH 142A,B04,093558,Chow; Bennett,12,0,32,20
1657231315656,MATH 142A,B05,093559,Chow; Bennett,6,0,32,26
1657231321682,MATH 193A,A01,083224,Rotar; Vladimir,7,0,34,27
1657231321682,MATH 193A,A02,083225,Rotar; Vladimir,6,0,34,28
1657231321682,MATH 193A,A03,083781,Rotar; Vladimir,2,0,34,32
1657231321682,MATH 193A,A04,083782,Rotar; Vladimir,8,0,34,26
1657231321682,MATH 193A,A05,093482,Rotar; Vladimir,6,0,34,28
1657231327705,MATH 197,001,091859,McAuley; Julian John,9999,0,9999,0
1657231327705,MATH 197,002,095566,Kedlaya; Kiran S.,9997,0,9999,2
1657231327705,MATH 197,003,095567,Xiao; Ming,9999,0,9999,0
1657231327705,MATH 197,004,095571,Perols; Johan Lars,9998,0,9999,1
1657231334786,COGS 9,A01,083615,Shannon; Kyle Michael,8,0,75,67
1657231340808,COGS 11,A01,083617,Boyle; Mary E. T.,22,0,48,26
1657231346852,COGS 13,A01,083071,Bastos; Amalia Pinkusfeld,8,0,71,63
1657231352878,COGS 14A,A01,092681,Semenuks; Arturs,2,1,100,98
1657231358902,COGS 14B,A01,083073,Cheng; Tzu-Han,6,0,63,57
1657231364928,COGS 17,A01,092677,Semenuks; Arturs,5,0,81,76
1657231370953,COGS 100,A01,083619,Allen; Michael Gordon,16,0,70,54
1657231376980,COGS 101A,A01,083621,Davis; Joshua Daniel,9,0,68,59
1657231383001,COGS 101B,A01,091572,Allen; Michael Gordon,10,0,65,55
1657231389024,COGS 101C,A01,083625,Delgado; Tania,17,0,35,18
1657231395047,COGS 107A,A01,083627,Boyle; Mary E. T.,13,0,60,47
1657231401069,COGS 118A,A01,083075,Gupta; Anjum,16,0,76,60
1657231407091,CSE 3,A50,083646,Miranda; Gregory Joseph,24,0,50,26
1657231413114,CSE 8A,A50,083650,Miranda; Gregory Joseph,17,1,56,39
1657231419147,CSE 11,A01,083080,Cao; Yingjun,5,15,40,35
1657231425173,CSE 12,A01,083652,Krause-Levy; Sophia Louisa,24,1,120,96
1657231431196,CSE 15L,A01,083654,Morris; Justin Loren,9,0,50,41
1657231431196,CSE 15L,A02,083655,Morris; Justin Loren,9,0,50,41
1657231437222,CSE 20,A01,083657,Tran; Khoa Dang,38,0,80,42
1657231443253,CSE 21,A01,095574,Bach; Quang Tran,22,0,48,26
1657231449280,CSE 30,A01,083084,Eldon; John,4,0,80,76
1657231449280,CSE 30,B01,095061,Bhaskar; Nishant,8,0,50,42
1657231455306,CSE 100,A01,083659,Cao; Yingjun,4,4,70,66
1657231461333,CSE 134B,A01,083661,Powell; Thomas Allan,21,0,100,79
1657231467359,CSE 140,A01,083663,Gungor; Onat,13,0,85,72
1657231473382,CSE 140L,A01,083088,Eldon; John,17,0,100,83
1657231479408,CSE 175,A01,083665,Kumar; Rakesh,3,0,25,22
1657231485434,CSE 190,A00,092507,Dubnov; Shlomo,7,0,20,13
1657231491462,ECE 45,A01,083139,Congero; Spencer William,5,0,75,70
1657231497485,ECE 65,A50,083695,Saad; Andrew S,12,0,30,18
1657231497485,ECE 65,A51,095125,Saad; Andrew S,25,0,26,1
1657231503508,ECE 109,A01,091882,Touri; Behrouz,19,0,70,51
1657231509533,ECE 180,A00,083140,Abi Samra; Nicholas Camill,1,0,30,29
1657231509533,ECE 180,B00,083141,Abi Samra; Nicholas Camill,0,0,30,30
1657231515561,MATH 10A,A01,083735,Patchell; Gregory David,2,0,30,28
1657231515561,MATH 10A,A02,083736,Patchell; Gregory David,20,0,30,10
1657231515561,MATH 10A,A03,083737,Patchell; Gregory David,16,0,30,14
1657231521591,MATH 10B,A01,083207,Lim; Seonhee,7,0,34,27
1657231521591,MATH 10B,A02,083208,Lim; Seonhee,9,0,35,26
1657231521591,MATH 10B,A03,093472,Lim; Seonhee,5,0,34,29
1657231521591,MATH 10B,B01,083739,Sinha; Shubham,11,0,30,19
1657231527616,MATH 18,A01,083743,Cinel; Cameron Alexander,6,0,30,24
1657231527616,MATH 18,A02,083744,Cinel; Cameron Alexander,16,0,30,14
1657231527616,MATH 18,A03,083745,Cinel; Cameron Alexander,8,0,30,22
1657231527616,MATH 18,B01,083748,Rideout; David Porter,4,0,37,33
1657231527616,MATH 18,B02,083749,Rideout; David Porter,4,0,36,32
1657231527616,MATH 18,B03,083750,Rideout; David Porter,2,0,37,35
1657231527616,MATH 18,B04,083751,Rideout; David Porter,6,0,36,30
1657231527616,MATH 18,B05,093473,Rideout; David Porter,5,0,36,31
1657231527616,MATH 18,B06,093474,Rideout; David Porter,5,0,36,31
1657231533638,MATH 20A,A01,083754,Zheng; Zequn,14,0,40,26
1657231539666,MATH 20B,A01,083756,Briones; Jor-el Thomas Caparas,3,0,36,33
1657231539666,MATH 20B,A02,083757,Briones; Jor-el Thomas Caparas,1,0,36,35
1657231539666,MATH 20B,A03,093475,Briones; Jor-el Thomas Caparas,2,0,36,34
1657231545691,MATH 20C,A01,083760,Briones; Jor-el Thomas Caparas,1,0,35,34
1657231545691,MATH 20C,A02,083761,Briones; Jor-el Thomas Caparas,8,0,35,27
1657231545691,MATH 20C,A03,093476,Briones; Jor-el Thomas Caparas,0,1,36,36
1657231545691,MATH 20C,B01,083762,Bach; Quang Tran,1,0,30,29
1657231551719,MATH 20D,A01,083765,Tran; Brian Kha,4,0,30,26
1657231551719,MATH 20D,A02,083766,Tran; Brian Kha,5,0,30,25
1657231551719,MATH 20D,A03,083767,Tran; Brian Kha,4,0,30,26
1657231557741,MATH 20E,A01,083771,Ganguly; Soumya,7,0,32,25
1657231557741,MATH 20E,A02,083772,Ganguly; Soumya,7,0,32,25
1657231557741,MATH 20E,B01,083773,Ciotti; Benjamin,19,0,35,16
1657231557741,MATH 20E,B02,083774,Ciotti; Benjamin,17,0,35,18
1657231563771,MATH 103A,A01,083777,Greenfeld; Be'Eri,3,0,36,33
1657231563771,MATH 103A,A02,083778,Greenfeld; Be'Eri,5,0,36,31
1657231563771,MATH 103A,A03,093561,Greenfeld; Be'Eri,4,0,36,32
1657231563771,MATH 103A,B01,083779,Greenfeld; Be'Eri,6,0,36,30
1657231563771,MATH 103A,B02,083780,Greenfeld; Be'Eri,3,0,36,33
1657231563771,MATH 103A,B03,093562,Greenfeld; Be'Eri,3,0,36,33
1657231569800,MATH 105,A01,085443,Carter; Anne Toulson,15,0,35,20
1657231569800,MATH 105,A02,093477,Carter; Anne Toulson,20,0,35,15
1657231575823,MATH 109,A01,083213,Ganzberger; Geoffrey Michael,2,0,34,32
1657231575823,MATH 109,A02,083214,Ganzberger; Geoffrey Michael,4,0,34,30
1657231575823,MATH 109,A03,093478,Ganzberger; Geoffrey Michael,2,0,34,32
1657231575823,MATH 109,B01,083215,Ganzberger; Geoffrey Michael,1,0,32,31
1657231575823,MATH 109,B02,083216,Ganzberger; Geoffrey Michael,1,0,32,31
1657231575823,MATH 109,B03,093479,Ganzberger; Geoffrey Michael,8,0,32,24
1657231581848,MATH 142A,A01,083219,Chow; Bennett,6,0,32,26
1657231581848,MATH 142A,A02,083220,Chow; Bennett,10,0,32,22
1657231581848,MATH 142A,A03,093480,Chow; Bennett,7,0,32,25
1657231581848,MATH 142A,B03,093481,Chow; Bennett,8,0,32,24
1657231581848,MATH 142A,B04,093558,Chow; Bennett,12,0,32,20
1657231581848,MATH 142A,B05,093559,Chow; Bennett,6,0,32,26
1657231587876,MATH 193A,A01,083224,Rotar; Vladimir,7,0,34,27
1657231587876,MATH 193A,A02,083225,Rotar; Vladimir,6,0,34,28
1657231587876,MATH 193A,A03,083781,Rotar; Vladimir,2,0,34,32
1657231587876,MATH 193A,A04,083782,Rotar; Vladimir,8,0,34,26
1657231587876,MATH 193A,A05,093482,Rotar; Vladimir,6,0,34,28
1657231593917,MATH 197,001,091859,McAuley; Julian John,9999,0,9999,0
1657231593917,MATH 197,002,095566,Kedlaya; Kiran S.,9997,0,9999,2
1657231593917,MATH 197,003,095567,Xiao; Ming,9999,0,9999,0
1657231593917,MATH 197,004,095571,Perols; Johan Lars,9998,0,9999,1
1657231600971,COGS 9,A01,083615,Shannon; Kyle Michael,8,0,75,67
1657231607003,COGS 11,A01,083617,Boyle; Mary E. T.,22,0,48,26
1657231613026,COGS 13,A01,083071,Bastos; Amalia Pinkusfeld,8,0,71,63
1657231619057,COGS 14A,A01,092681,Semenuks; Arturs,2,1,100,98
1657231625080,COGS 14B,A01,083073,Cheng; Tzu-Han,6,0,63,57
1657231631102,COGS 17,A01,092677,Semenuks; Arturs,5,0,81,76
1657231637125,COGS 100,A01,083619,Allen; Michael Gordon,16,0,70,54
1657231643152,COGS 101A,A01,083621,Davis; Joshua Daniel,9,0,68,59
1657231649184,COGS 101B,A01,091572,Allen; Michael Gordon,10,0,65,55
1657231655217,COGS 101C,A01,083625,Delgado; Tania,17,0,35,18
1657231661240,COGS 107A,A01,083627,Boyle; Mary E. T.,13,0,60,47
1657231667269,COGS 118A,A01,083075,Gupta; Anjum,16,0,76,60
1657231673300,CSE 3,A50,083646,Miranda; Gregory Joseph,24,0,50,26
1657231679325,CSE 8A,A50,083650,Miranda; Gregory Joseph,17,1,56,39
1657231685348,CSE 11,A01,083080,Cao; Yingjun,5,15,40,35
1657231691375,CSE 12,A01,083652,Krause-Levy; Sophia Louisa,24,1,120,96
1657231697400,CSE 15L,A01,083654,Morris; Justin Loren,9,0,50,41
1657231697400,CSE 15L,A02,083655,Morris; Justin Loren,9,0,50,41
1657231703421,CSE 20,A01,083657,Tran; Khoa Dang,38,0,80,42
1657231709451,CSE 21,A01,095574,Bach; Quang Tran,22,0,48,26
1657231715488,CSE 30,A01,083084,Eldon; John,4,0,80,76
1657231715488,CSE 30,B01,095061,Bhaskar; Nishant,8,0,50,42
1657231721511,CSE 100,A01,083659,Cao; Yingjun,4,4,70,66
1657231727538,CSE 134B,A01,083661,Powell; Thomas Allan,21,0,100,79
1657231733560,CSE 140,A01,083663,Gungor; Onat,13,0,85,72
1657231739592,CSE 140L,A01,083088,Eldon; John,17,0,100,83
1657231745614,CSE 175,A01,083665,Kumar; Rakesh,3,0,25,22
1657231751640,CSE 190,A00,092507,Dubnov; Shlomo,7,0,20,13
1657231757664,ECE 45,A01,083139,Congero; Spencer William,5,0,75,70
1657231763686,ECE 65,A50,083695,Saad; Andrew S,12,0,30,18
1657231763686,ECE 65,A51,095125,Saad; Andrew S,25,0,26,1
1657231769713,ECE 109,A01,091882,Touri; Behrouz,19,0,70,51
1657231775736,ECE 180,A00,083140,Abi Samra; Nicholas Camill,1,0,30,29
1657231775736,ECE 180,B00,083141,Abi Samra; Nicholas Camill,0,0,30,30
1657231781764,MATH 10A,A01,083735,Patchell; Gregory David,2,0,30,28
1657231781764,MATH 10A,A02,083736,Patchell; Gregory David,20,0,30,10
1657231781764,MATH 10A,A03,083737,Patchell; Gregory David,16,0,30,14
1657231787787,MATH 10B,A01,083207,Lim; Seonhee,7,0,34,27
1657231787787,MATH 10B,A02,083208,Lim; Seonhee,9,0,35,26
1657231787787,MATH 10B,A03,093472,Lim; Seonhee,5,0,34,29
1657231787787,MATH 10B,B01,083739,Sinha; Shubham,11,0,30,19
1657231793813,MATH 18,A01,083743,Cinel; Cameron Alexander,6,0,30,24
1657231793813,MATH 18,A02,083744,Cinel; Cameron Alexander,16,0,30,14
1657231793813,MATH 18,A03,083745,Cinel; Cameron Alexander,8,0,30,22
1657231793813,MATH 18,B01,083748,Rideout; David Porter,4,0,37,33
1657231793813,MATH 18,B02,083749,Rideout; David Porter,4,0,36,32
1657231793813,MATH 18,B03,083750,Rideout; David Porter,2,0,37,35
1657231793813,MATH 18,B04,083751,Rideout; David Porter,6,0,36,30
1657231793813,MATH 18,B05,093473,Rideout; David Porter,5,0,36,31
1657231793813,MATH 18,B06,093474,Rideout; David Porter,5,0,36,31
1657231799839,MATH 20A,A01,083754,Zheng; Zequn,14,0,40,26
1657231805866,MATH 20B,A01,083756,Briones; Jor-el Thomas Caparas,3,0,36,33
1657231805866,MATH 20B,A02,083757,Briones; Jor-el Thomas Caparas,1,0,36,35
1657231805866,MATH 20B,A03,093475,Briones; Jor-el Thomas Caparas,2,0,36,34
1657231811903,MATH 20C,A01,083760,Briones; Jor-el Thomas Caparas,1,0,35,34
1657231811903,MATH 20C,A02,083761,Briones; Jor-el Thomas Caparas,8,0,35,27
1657231811903,MATH 20C,A03,093476,Briones; Jor-el Thomas Caparas,0,1,36,36
1657231811903,MATH 20C,B01,083762,Bach; Quang Tran,1,0,30,29
1657231818021,MATH 20D,A01,083765,Tran; Brian Kha,4,0,30,26
1657231818021,MATH 20D,A02,083766,Tran; Brian Kha,5,0,30,25
1657231818021,MATH 20D,A03,083767,Tran; Brian Kha,4,0,30,26
1657231824045,MATH 20E,A01,083771,Ganguly; Soumya,7,0,32,25
1657231824045,MATH 20E,A02,083772,Ganguly; Soumya,7,0,32,25
1657231824045,MATH 20E,B01,083773,Ciotti; Benjamin,19,0,35,16
1657231824045,MATH 20E,B02,083774,Ciotti; Benjamin,17,0,35,18
1657231830074,MATH 103A,A01,083777,Greenfeld; Be'Eri,3,0,36,33
1657231830074,MATH 103A,A02,083778,Greenfeld; Be'Eri,5,0,36,31
1657231830074,MATH 103A,A03,093561,Greenfeld; Be'Eri,4,0,36,32
1657231830074,MATH 103A,B01,083779,Greenfeld; Be'Eri,6,0,36,30
1657231830074,MATH 103A,B02,083780,Greenfeld; Be'Eri,3,0,36,33
1657231830074,MATH 103A,B03,093562,Greenfeld; Be'Eri,3,0,36,33
1657231836098,MATH 105,A01,085443,Carter; Anne Toulson,15,0,35,20
1657231836098,MATH 105,A02,093477,Carter; Anne Toulson,20,0,35,15
1657231842125,MATH 109,A01,083213,Ganzberger; Geoffrey Michael,2,0,34,32
1657231842125,MATH 109,A02,083214,Ganzberger; Geoffrey Michael,4,0,34,30
1657231842125,MATH 109,A03,093478,Ganzberger; Geoffrey Michael,2,0,34,32
1657231842125,MATH 109,B01,083215,Ganzberger; Geoffrey Michael,1,0,32,31
1657231842125,MATH 109,B02,083216,Ganzberger; Geoffrey Michael,1,0,32,31
1657231842125,MATH 109,B03,093479,Ganzberger; Geoffrey Michael,8,0,32,24
1657231848171,MATH 142A,A01,083219,Chow; Bennett,6,0,32,26
1657231848171,MATH 142A,A02,083220,Chow; Bennett,10,0,32,22
1657231848171,MATH 142A,A03,093480,Chow; Bennett,7,0,32,25
1657231848171,MATH 142A,B03,093481,Chow; Bennett,8,0,32,24
1657231848171,MATH 142A,B04,093558,Chow; Bennett,12,0,32,20
1657231848171,MATH 142A,B05,093559,Chow; Bennett,6,0,32,26
1657231854197,MATH 193A,A01,083224,Rotar; Vladimir,7,0,34,27
1657231854197,MATH 193A,A02,083225,Rotar; Vladimir,6,0,34,28
1657231854197,MATH 193A,A03,083781,Rotar; Vladimir,2,0,34,32
1657231854197,MATH 193A,A04,083782,Rotar; Vladimir,8,0,34,26
1657231854197,MATH 193A,A05,093482,Rotar; Vladimir,6,0,34,28
1657231860226,MATH 197,001,091859,McAuley; Julian John,9999,0,9999,0
1657231860226,MATH 197,002,095566,Kedlaya; Kiran S.,9997,0,9999,2
1657231860226,MATH 197,003,095567,Xiao; Ming,9999,0,9999,0
1657231860226,MATH 197,004,095571,Perols; Johan Lars,9998,0,9999,1
1657231867303,COGS 9,A01,083615,Shannon; Kyle Michael,8,0,75,67
1657231873326,COGS 11,A01,083617,Boyle; Mary E. T.,22,0,48,26
1657231879349,COGS 13,A01,083071,Bastos; Amalia Pinkusfeld,8,0,71,63
1657231885376,COGS 14A,A01,092681,Semenuks; Arturs,2,1,100,98
1657231891404,COGS 14B,A01,083073,Cheng; Tzu-Han,6,0,63,57
1657231897430,COGS 17,A01,092677,Semenuks; Arturs,5,0,81,76
1657231903456,COGS 100,A01,083619,Allen; Michael Gordon,16,0,70,54
1657231909491,COGS 101A,A01,083621,Davis; Joshua Daniel,9,0,68,59
1657231915521,COGS 101B,A01,091572,Allen; Michael Gordon,10,0,65,55
1657231921542,COGS 101C,A01,083625,Delgado; Tania,17,0,35,18
1657231927579,COGS 107A,A01,083627,Boyle; Mary E. T.,13,0,60,47
1657231933607,COGS 118A,A01,083075,Gupta; Anjum,16,0,76,60
1657231939636,CSE 3,A50,083646,Miranda; Gregory Joseph,24,0,50,26
1657231948398,CSE 8A,A50,083650,Miranda; Gregory Joseph,17,1,56,39
1657231955074,CSE 11,A01,083080,Cao; Yingjun,5,15,40,35
1657231961100,CSE 12,A01,083652,Krause-Levy; Sophia Louisa,24,1,120,96
1657231967126,CSE 15L,A01,083654,Morris; Justin Loren,9,0,50,41
1657231967126,CSE 15L,A02,083655,Morris; Justin Loren,9,0,50,41
1657231973150,CSE 20,A01,083657,Tran; Khoa Dang,38,0,80,42
1657231979182,CSE 21,A01,095574,Bach; Quang Tran,22,0,48,26
1657231985210,CSE 30,A01,083084,Eldon; John,4,0,80,76
1657231985210,CSE 30,B01,095061,Bhaskar; Nishant,8,0,50,42
1657231991234,CSE 100,A01,083659,Cao; Yingjun,4,4,70,66
1657231997260,CSE 134B,A01,083661,Powell; Thomas Allan,21,0,100,79
1657232003290,CSE 140,A01,083663,Gungor; Onat,13,0,85,72
1657232009313,CSE 140L,A01,083088,Eldon; John,17,0,100,83
1657232015339,CSE 175,A01,083665,Kumar; Rakesh,3,0,25,22
1657232021360,CSE 190,A00,092507,Dubnov; Shlomo,7,0,20,13
1657232027381,ECE 45,A01,083139,Congero; Spencer William,5,0,75,70
1657232033409,ECE 65,A50,083695,Saad; Andrew S,12,0,30,18
1657232033409,ECE 65,A51,095125,Saad; Andrew S,25,0,26,1
1657232039436,ECE 109,A01,091882,Touri; Behrouz,19,0,70,51
1657232045476,ECE 180,A00,083140,Abi Samra; Nicholas Camill,1,0,30,29
1657232045476,ECE 180,B00,083141,Abi Samra; Nicholas Camill,0,0,30,30
1657232051500,MATH 10A,A01,083735,Patchell; Gregory David,2,0,30,28
1657232051500,MATH 10A,A02,083736,Patchell; Gregory David,20,0,30,10
1657232051500,MATH 10A,A03,083737,Patchell; Gregory David,16,0,30,14
1657232057528,MATH 10B,A01,083207,Lim; Seonhee,7,0,34,27
1657232057528,MATH 10B,A02,083208,Lim; Seonhee,9,0,35,26
1657232057528,MATH 10B,A03,093472,Lim; Seonhee,5,0,34,29
1657232057528,MATH 10B,B01,083739,Sinha; Shubham,11,0,30,19
1657232063566,MATH 18,A01,083743,Cinel; Cameron Alexander,6,0,30,24
1657232063566,MATH 18,A02,083744,Cinel; Cameron Alexander,16,0,30,14
1657232063566,MATH 18,A03,083745,Cinel; Cameron Alexander,8,0,30,22
1657232063566,MATH 18,B01,083748,Rideout; David Porter,4,0,37,33
1657232063566,MATH 18,B02,083749,Rideout; David Porter,4,0,36,32
1657232063566,MATH 18,B03,083750,Rideout; David Porter,2,0,37,35
1657232063566,MATH 18,B04,083751,Rideout; David Porter,6,0,36,30
1657232063566,MATH 18,B05,093473,Rideout; David Porter,5,0,36,31
1657232063566,MATH 18,B06,093474,Rideout; David Porter,5,0,36,31
1657232069591,MATH 20A,A01,083754,Zheng; Zequn,14,0,40,26
1657232075618,MATH 20B,A01,083756,Briones; Jor-el Thomas Caparas,3,0,36,33
1657232075618,MATH 20B,A02,083757,Briones; Jor-el Thomas Caparas,1,0,36,35
1657232075618,MATH 20B,A03,093475,Briones; Jor-el Thomas Caparas,2,0,36,34
1657232081642,MATH 20C,A01,083760,Briones; Jor-el Thomas Caparas,1,0,35,34
1657232081642,MATH 20C,A02,083761,Briones; Jor-el Thomas Caparas,8,0,35,27
1657232081642,MATH 20C,A03,093476,Briones; Jor-el Thomas Caparas,0,1,36,36
1657232081642,MATH 20C,B01,083762,Bach; Quang Tran,1,0,30,29
1657232087675,MATH 20D,A01,083765,Tran; Brian Kha,4,0,30,26
1657232087675,MATH 20D,A02,083766,Tran; Brian Kha,5,0,30,25
1657232087675,MATH 20D,A03,083767,Tran; Brian Kha,4,0,30,26
1657232093700,MATH 20E,A01,083771,Ganguly; Soumya,7,0,32,25
1657232093700,MATH 20E,A02,083772,Ganguly; Soumya,7,0,32,25
1657232093700,MATH 20E,B01,083773,Ciotti; Benjamin,19,0,35,16
1657232093700,MATH 20E,B02,083774,Ciotti; Benjamin,17,0,35,18
1657232099728,MATH 103A,A01,083777,Greenfeld; Be'Eri,3,0,36,33
1657232099728,MATH 103A,A02,083778,Greenfeld; Be'Eri,5,0,36,31
1657232099728,MATH 103A,A03,093561,Greenfeld; Be'Eri,4,0,36,32
1657232099728,MATH 103A,B01,083779,Greenfeld; Be'Eri,6,0,36,30
1657232099728,MATH 103A,B02,083780,Greenfeld; Be'Eri,3,0,36,33
1657232099728,MATH 103A,B03,093562,Greenfeld; Be'Eri,3,0,36,33
1657232105760,MATH 105,A01,085443,Carter; Anne Toulson,15,0,35,20
1657232105760,MATH 105,A02,093477,Carter; Anne Toulson,20,0,35,15
1657232111788,MATH 109,A01,083213,Ganzberger; Geoffrey Michael,2,0,34,32
1657232111788,MATH 109,A02,083214,Ganzberger; Geoffrey Michael,4,0,34,30
1657232111788,MATH 109,A03,093478,Ganzberger; Geoffrey Michael,2,0,34,32
1657232111788,MATH 109,B01,083215,Ganzberger; Geoffrey Michael,1,0,32,31
1657232111788,MATH 109,B02,083216,Ganzberger; Geoffrey Michael,1,0,32,31
1657232111788,MATH 109,B03,093479,Ganzberger; Geoffrey Michael,8,0,32,24
1657232117818,MATH 142A,A01,083219,Chow; Bennett,6,0,32,26
1657232117818,MATH 142A,A02,083220,Chow; Bennett,10,0,32,22
1657232117818,MATH 142A,A03,093480,Chow; Bennett,7,0,32,25
1657232117818,MATH 142A,B03,093481,Chow; Bennett,8,0,32,24
1657232117818,MATH 142A,B04,093558,Chow; Bennett,12,0,32,20
1657232117818,MATH 142A,B05,093559,Chow; Bennett,6,0,32,26
1657232123841,MATH 193A,A01,083224,Rotar; Vladimir,7,0,34,27
1657232123841,MATH 193A,A02,083225,Rotar; Vladimir,6,0,34,28
1657232123841,MATH 193A,A03,083781,Rotar; Vladimir,2,0,34,32
1657232123841,MATH 193A,A04,083782,Rotar; Vladimir,8,0,34,26
1657232123841,MATH 193A,A05,093482,Rotar; Vladimir,6,0,34,28
1657232129865,MATH 197,001,091859,McAuley; Julian John,9999,0,9999,0
1657232129865,MATH 197,002,095566,Kedlaya; Kiran S.,9997,0,9999,2
1657232129865,MATH 197,003,095567,Xiao; Ming,9999,0,9999,0
1657232129865,MATH 197,004,095571,Perols; Johan Lars,9998,0,9999,1
1657232136931,COGS 9,A01,083615,Shannon; Kyle Michael,8,0,75,67
1657232142958,COGS 11,A01,083617,Boyle; Mary E. T.,22,0,48,26
1657232148980,COGS 13,A01,083071,Bastos; Amalia Pinkusfeld,8,0,71,63
1657232155002,COGS 14A,A01,092681,Semenuks; Arturs,2,1,100,98
1657232161026,COGS 14B,A01,083073,Cheng; Tzu-Han,6,0,63,57
1657232167047,COGS 17,A01,092677,Semenuks; Arturs,5,0,81,76
1657232173069,COGS 100,A01,083619,Allen; Michael Gordon,16,0,70,54
1657232179094,COGS 101A,A01,083621,Davis; Joshua Daniel,9,0,68,59
1657232185115,COGS 101B,A01,091572,Allen; Michael Gordon,10,0,65,55
1657232191139,COGS 101C,A01,083625,Delgado; Tania,17,0,35,18
1657232197171,COGS 107A,A01,083627,Boyle; Mary E. T.,13,0,60,47
1657232203196,COGS 118A,A01,083075,Gupta; Anjum,16,0,76,60
1657232209222,CSE 3,A50,083646,Miranda; Gregory Joseph,24,0,50,26
1657232215256,CSE 8A,A50,083650,Miranda; Gregory Joseph,17,1,56,39
1657232221283,CSE 11,A01,083080,Cao; Yingjun,5,15,40,35
1657232227310,CSE 12,A01,083652,Krause-Levy; Sophia Louisa,24,1,120,96
1657232233334,CSE 15L,A01,083654,Morris; Justin Loren,9,0,50,41
1657232233334,CSE 15L,A02,083655,Morris; Justin Loren,9,0,50,41
1657232239361,CSE 20,A01,083657,Tran; Khoa Dang,38,0,80,42
1657232245387,CSE 21,A01,095574,Bach; Quang Tran,22,0,48,26
1657232251412,CSE 30,A01,083084,Eldon; John,4,0,80,76
1657232251412,CSE 30,B01,095061,Bhaskar; Nishant,8,0,50,42
1657232257433,CSE 100,A01,083659,Cao; Yingjun,4,4,70,66
1657232263455,CSE 134B,A01,083661,Powell; Thomas Allan,21,0,100,79
1657232269489,CSE 140,A01,083663,Gungor; Onat,13,0,85,72
1657232275513,CSE 140L,A01,083088,Eldon; John,17,0,100,83
1657232281538,CSE 175,A01,083665,Kumar; Rakesh,3,0,25,22
1657232287560,CSE 190,A00,092507,Dubnov; Shlomo,7,0,20,13
1657232293587,ECE 45,A01,083139,Congero; Spencer William,5,0,75,70
1657232299616,ECE 65,A50,083695,Saad; Andrew S,12,0,30,18
1657232299616,ECE 65,A51,095125,Saad; Andrew S,25,0,26,1
1657232305639,ECE 109,A01,091882,Touri; Behrouz,19,0,70,51
1657232311668,ECE 180,A00,083140,Abi Samra; Nicholas Camill,1,0,30,29
1657232311668,ECE 180,B00,083141,Abi Samra; Nicholas Camill,0,0,30,30
1657232317706,MATH 10A,A01,083735,Patchell; Gregory David,2,0,30,28
1657232317706,MATH 10A,A02,083736,Patchell; Gregory David,20,0,30,10
1657232317706,MATH 10A,A03,083737,Patchell; Gregory David,16,0,30,14
1657232323734,MATH 10B,A01,083207,Lim; Seonhee,7,0,34,27
1657232323734,MATH 10B,A02,083208,Lim; Seonhee,9,0,35,26
1657232323734,MATH 10B,A03,093472,Lim; Seonhee,5,0,34,29
1657232323734,MATH 10B,B01,083739,Sinha; Shubham,11,0,30,19
1657232329761,MATH 18,A01,083743,Cinel; Cameron Alexander,6,0,30,24
1657232329761,MATH 18,A02,083744,Cinel; Cameron Alexander,16,0,30,14
1657232329761,MATH 18,A03,083745,Cinel; Cameron Alexander,8,0,30,22
1657232329761,MATH 18,B01,083748,Rideout; David Porter,4,0,37,33
1657232329761,MATH 18,B02,083749,Rideout; David Porter,4,0,36,32
1657232329761,MATH 18,B03,083750,Rideout; David Porter,2,0,37,35
1657232329761,MATH 18,B04,083751,Rideout; David Porter,6,0,36,30
1657232329761,MATH 18,B05,093473,Rideout; David Porter,5,0,36,31
1657232329761,MATH 18,B06,093474,Rideout; David Porter,5,0,36,31
1657232335787,MATH 20A,A01,083754,Zheng; Zequn,14,0,40,26
1657232341808,MATH 20B,A01,083756,Briones; Jor-el Thomas Caparas,3,0,36,33
1657232341808,MATH 20B,A02,083757,Briones; Jor-el Thomas Caparas,1,0,36,35
1657232341808,MATH 20B,A03,093475,Briones; Jor-el Thomas Caparas,2,0,36,34
1657232347837,MATH 20C,A01,083760,Briones; Jor-el Thomas Caparas,1,0,35,34
1657232347837,MATH 20C,A02,083761,Briones; Jor-el Thomas Caparas,8,0,35,27
1657232347837,MATH 20C,A03,093476,Briones; Jor-el Thomas Caparas,0,1,36,36
1657232347837,MATH 20C,B01,083762,Bach; Quang Tran,1,0,30,29
1657232353860,MATH 20D,A01,083765,Tran; Brian Kha,4,0,30,26
1657232353860,MATH 20D,A02,083766,Tran; Brian Kha,5,0,30,25
1657232353860,MATH 20D,A03,083767,Tran; Brian Kha,4,0,30,26
1657232359890,MATH 20E,A01,083771,Ganguly; Soumya,7,0,32,25
1657232359890,MATH 20E,A02,083772,Ganguly; Soumya,7,0,32,25
1657232359890,MATH 20E,B01,083773,Ciotti; Benjamin,19,0,35,16
1657232359890,MATH 20E,B02,083774,Ciotti; Benjamin,17,0,35,18
1657232365915,MATH 103A,A01,083777,Greenfeld; Be'Eri,3,0,36,33
1657232365915,MATH 103A,A02,083778,Greenfeld; Be'Eri,5,0,36,31
1657232365915,MATH 103A,A03,093561,Greenfeld; Be'Eri,4,0,36,32
1657232365915,MATH 103A,B01,083779,Greenfeld; Be'Eri,6,0,36,30
1657232365915,MATH 103A,B02,083780,Greenfeld; Be'Eri,3,0,36,33
1657232365915,MATH 103A,B03,093562,Greenfeld; Be'Eri,3,0,36,33
1657232371946,MATH 105,A01,085443,Carter; Anne Toulson,15,0,35,20
1657232371946,MATH 105,A02,093477,Carter; Anne Toulson,20,0,35,15
1657232377968,MATH 109,A01,083213,Ganzberger; Geoffrey Michael,2,0,34,32
1657232377968,MATH 109,A02,083214,Ganzberger; Geoffrey Michael,4,0,34,30
1657232377968,MATH 109,A03,093478,Ganzberger; Geoffrey Michael,2,0,34,32
1657232377968,MATH 109,B01,083215,Ganzberger; Geoffrey Michael,1,0,32,31
1657232377968,MATH 109,B02,083216,Ganzberger; Geoffrey Michael,1,0,32,31
1657232377968,MATH 109,B03,093479,Ganzberger; Geoffrey Michael,8,0,32,24
1657232383996,MATH 142A,A01,083219,Chow; Bennett,6,0,32,26
1657232383996,MATH 142A,A02,083220,Chow; Bennett,10,0,32,22
1657232383996,MATH 142A,A03,093480,Chow; Bennett,7,0,32,25
1657232383996,MATH 142A,B03,093481,Chow; Bennett,8,0,32,24
1657232383996,MATH 142A,B04,093558,Chow; Bennett,12,0,32,20
1657232383996,MATH 142A,B05,093559,Chow; Bennett,6,0,32,26
1657232390017,MATH 193A,A01,083224,Rotar; Vladimir,7,0,34,27
1657232390017,MATH 193A,A02,083225,Rotar; Vladimir,6,0,34,28
1657232390017,MATH 193A,A03,083781,Rotar; Vladimir,2,0,34,32
1657232390017,MATH 193A,A04,083782,Rotar; Vladimir,8,0,34,26
1657232390017,MATH 193A,A05,093482,Rotar; Vladimir,6,0,34,28
1657232396041,MATH 197,001,091859,McAuley; Julian John,9999,0,9999,0
1657232396041,MATH 197,002,095566,Kedlaya; Kiran S.,9997,0,9999,2
1657232396041,MATH 197,003,095567,Xiao; Ming,9999,0,9999,0
1657232396041,MATH 197,004,095571,Perols; Johan Lars,9998,0,9999,1
1657232403102,COGS 9,A01,083615,Shannon; Kyle Michael,8,0,75,67
1657232409126,COGS 11,A01,083617,Boyle; Mary E. T.,22,0,48,26
1657232415252,COGS 13,A01,083071,Bastos; Amalia Pinkusfeld,8,0,71,63
1657232421290,COGS 14A,A01,092681,Semenuks; Arturs,2,1,100,98
1657232427313,COGS 14B,A01,083073,Cheng; Tzu-Han,6,0,63,57
1657232433336,COGS 17,A01,092677,Semenuks; Arturs,5,0,81,76
1657232439359,COGS 100,A01,083619,Allen; Michael Gordon,16,0,70,54
1657232445382,COGS 101A,A01,083621,Davis; Joshua Daniel,9,0,68,59
1657232451405,COGS 101B,A01,091572,Allen; Michael Gordon,10,0,65,55
1657232457435,COGS 101C,A01,083625,Delgado; Tania,17,0,35,18
1657232463457,COGS 107A,A01,083627,Boyle; Mary E. T.,13,0,60,47
1657232469484,COGS 118A,A01,083075,Gupta; Anjum,16,0,76,60
1657232475506,CSE 3,A50,083646,Miranda; Gregory Joseph,24,0,50,26
1657232481534,CSE 8A,A50,083650,Miranda; Gregory Joseph,17,1,56,39
1657232487564,CSE 11,A01,083080,Cao; Yingjun,5,15,40,35
1657232493587,CSE 12,A01,083652,Krause-Levy; Sophia Louisa,24,1,120,96
1657232499609,CSE 15L,A01,083654,Morris; Justin Loren,9,0,50,41
1657232499609,CSE 15L,A02,083655,Morris; Justin Loren,9,0,50,41
1657232505634,CSE 20,A01,083657,Tran; Khoa Dang,38,0,80,42
1657232511672,CSE 21,A01,095574,Bach; Quang Tran,22,0,48,26
1657232517696,CSE 30,A01,083084,Eldon; John,4,0,80,76
1657232517696,CSE 30,B01,095061,Bhaskar; Nishant,8,0,50,42
1657232523724,CSE 100,A01,083659,Cao; Yingjun,4,4,70,66
1657232529745,CSE 134B,A01,083661,Powell; Thomas Allan,21,0,100,79
1657232535773,CSE 140,A01,083663,Gungor; Onat,13,0,85,72
1657232541796,CSE 140L,A01,083088,Eldon; John,17,0,100,83
1657232547820,CSE 175,A01,083665,Kumar; Rakesh,3,0,25,22
1657232553852,CSE 190,A00,092507,Dubnov; Shlomo,7,0,20,13
1657232559876,ECE 45,A01,083139,Congero; Spencer William,5,0,75,70
1657232565899,ECE 65,A50,083695,Saad; Andrew S,12,0,30,18
1657232565899,ECE 65,A51,095125,Saad; Andrew S,25,0,26,1
1657232571928,ECE 109,A01,091882,Touri; Behrouz,19,0,70,51
1657232577953,ECE 180,A00,083140,Abi Samra; Nicholas Camill,1,0,30,29
1657232577953,ECE 180,B00,083141,Abi Samra; Nicholas Camill,0,0,30,30
1657232583976,MATH 10A,A01,083735,Patchell; Gregory David,2,0,30,28
1657232583976,MATH 10A,A02,083736,Patchell; Gregory David,20,0,30,10
1657232583976,MATH 10A,A03,083737,Patchell; Gregory David,16,0,30,14
1657232589999,MATH 10B,A01,083207,Lim; Seonhee,7,0,34,27
1657232589999,MATH 10B,A02,083208,Lim; Seonhee,9,0,35,26
1657232589999,MATH 10B,A03,093472,Lim; Seonhee,5,0,34,29
1657232589999,MATH 10B,B01,083739,Sinha; Shubham,11,0,30,19
1657232596030,MATH 18,A01,083743,Cinel; Cameron Alexander,6,0,30,24
1657232596030,MATH 18,A02,083744,Cinel; Cameron Alexander,16,0,30,14
1657232596030,MATH 18,A03,083745,Cinel; Cameron Alexander,8,0,30,22
1657232596030,MATH 18,B01,083748,Rideout; David Porter,4,0,37,33
1657232596030,MATH 18,B02,083749,Rideout; David Porter,4,0,36,32
1657232596030,MATH 18,B03,083750,Rideout; David Porter,2,0,37,35
1657232596030,MATH 18,B04,083751,Rideout; David Porter,6,0,36,30
1657232596030,MATH 18,B05,093473,Rideout; David Porter,5,0,36,31
1657232596030,MATH 18,B06,093474,Rideout; David Porter,5,0,36,31
1657232602064,MATH 20A,A01,083754,Zheng; Zequn,14,0,40,26
1657232608086,MATH 20B,A01,083756,Briones; Jor-el Thomas Caparas,3,0,36,33
1657232608086,MATH 20B,A02,083757,Briones; Jor-el Thomas Caparas,1,0,36,35
1657232608086,MATH 20B,A03,093475,Briones; Jor-el Thomas Caparas,2,0,36,34
1657232614115,MATH 20C,A01,083760,Briones; Jor-el Thomas Caparas,1,0,35,34
1657232614115,MATH 20C,A02,083761,Briones; Jor-el Thomas Caparas,8,0,35,27
1657232614115,MATH 20C,A03,093476,Briones; Jor-el Thomas Caparas,0,1,36,36
1657232614115,MATH 20C,B01,083762,Bach; Quang Tran,1,0,30,29
1657232620147,MATH 20D,A01,083765,Tran; Brian Kha,4,0,30,26
1657232620147,MATH 20D,A02,083766,Tran; Brian Kha,5,0,30,25
1657232620147,MATH 20D,A03,083767,Tran; Brian Kha,4,0,30,26
1657232626168,MATH 20E,A01,083771,Ganguly; Soumya,7,0,32,25
1657232626168,MATH 20E,A02,083772,Ganguly; Soumya,7,0,32,25
1657232626168,MATH 20E,B01,083773,Ciotti; Benjamin,19,0,35,16
1657232626168,MATH 20E,B02,083774,Ciotti; Benjamin,17,0,35,18
1657232632191,MATH 103A,A01,083777,Greenfeld; Be'Eri,3,0,36,33
1657232632191,MATH 103A,A02,083778,Greenfeld; Be'Eri,5,0,36,31
1657232632191,MATH 103A,A03,093561,Greenfeld; Be'Eri,4,0,36,32
1657232632191,MATH 103A,B01,083779,Greenfeld; Be'Eri,6,0,36,30
1657232632191,MATH 103A,B02,083780,Greenfeld; Be'Eri,3,0,36,33
1657232632191,MATH 103A,B03,093562,Greenfeld; Be'Eri,3,0,36,33
1657232638220,MATH 105,A01,085443,Carter; Anne Toulson,15,0,35,20
1657232638220,MATH 105,A02,093477,Carter; Anne Toulson,20,0,35,15
1657232644250,MATH 109,A01,083213,Ganzberger; Geoffrey Michael,2,0,34,32
1657232644250,MATH 109,A02,083214,Ganzberger; Geoffrey Michael,4,0,34,30
1657232644250,MATH 109,A03,093478,Ganzberger; Geoffrey Michael,2,0,34,32
1657232644250,MATH 109,B01,083215,Ganzberger; Geoffrey Michael,1,0,32,31
1657232644250,MATH 109,B02,083216,Ganzberger; Geoffrey Michael,1,0,32,31
1657232644250,MATH 109,B03,093479,Ganzberger; Geoffrey Michael,8,0,32,24
1657232650286,MATH 142A,A01,083219,Chow; Bennett,6,0,32,26
1657232650286,MATH 142A,A02,083220,Chow; Bennett,10,0,32,22
1657232650286,MATH 142A,A03,093480,Chow; Bennett,7,0,32,25
1657232650286,MATH 142A,B03,093481,Chow; Bennett,8,0,32,24
1657232650286,MATH 142A,B04,093558,Chow; Bennett,12,0,32,20
1657232650286,MATH 142A,B05,093559,Chow; Bennett,6,0,32,26
1657232656309,MATH 193A,A01,083224,Rotar; Vladimir,7,0,34,27
1657232656309,MATH 193A,A02,083225,Rotar; Vladimir,6,0,34,28
1657232656309,MATH 193A,A03,083781,Rotar; Vladimir,2,0,34,32
1657232656309,MATH 193A,A04,083782,Rotar; Vladimir,8,0,34,26
1657232656309,MATH 193A,A05,093482,Rotar; Vladimir,6,0,34,28
1657232662332,MATH 197,001,091859,McAuley; Julian John,9999,0,9999,0
1657232662332,MATH 197,002,095566,Kedlaya; Kiran S.,9997,0,9999,2
1657232662332,MATH 197,003,095567,Xiao; Ming,9999,0,9999,0
1657232662332,MATH 197,004,095571,Perols; Johan Lars,9998,0,9999,1
1657232669397,COGS 9,A01,083615,Shannon; Kyle Michael,8,0,75,67
1657232675426,COGS 11,A01,083617,Boyle; Mary E. T.,22,0,48,26
1657232681452,COGS 13,A01,083071,Bastos; Amalia Pinkusfeld,8,0,71,63
1657232687478,COGS 14A,A01,092681,Semenuks; Arturs,2,1,100,98
1657232693517,COGS 14B,A01,083073,Cheng; Tzu-Han,6,0,63,57
1657232699542,COGS 17,A01,092677,Semenuks; Arturs,5,0,81,76
1657232705569,COGS 100,A01,083619,Allen; Michael Gordon,16,0,70,54
1657232711597,COGS 101A,A01,083621,Davis; Joshua Daniel,9,0,68,59
1657232717623,COGS 101B,A01,091572,Allen; Michael Gordon,10,0,65,55
1657232723650,COGS 101C,A01,083625,Delgado; Tania,17,0,35,18
1657232729677,COGS 107A,A01,083627,Boyle; Mary E. T.,13,0,60,47
1657232735702,COGS 118A,A01,083075,Gupta; Anjum,16,0,76,60
1657232741731,CSE 3,A50,083646,Miranda; Gregory Joseph,24,0,50,26
1657232747767,CSE 8A,A50,083650,Miranda; Gregory Joseph,17,1,56,39
1657232753794,CSE 11,A01,083080,Cao; Yingjun,5,15,40,35
1657232759829,CSE 12,A01,083652,Krause-Levy; Sophia Louisa,24,1,120,96
1657232765854,CSE 15L,A01,083654,Morris; Justin Loren,9,0,50,41
1657232765854,CSE 15L,A02,083655,Morris; Justin Loren,9,0,50,41
1657232771897,CSE 20,A01,083657,Tran; Khoa Dang,38,0,80,42
1657232777920,CSE 21,A01,095574,Bach; Quang Tran,22,0,48,26
1657232783943,CSE 30,A01,083084,Eldon; John,4,0,80,76
1657232783943,CSE 30,B01,095061,Bhaskar; Nishant,8,0,50,42
1657232789966,CSE 100,A01,083659,Cao; Yingjun,4,4,70,66
1657232795991,CSE 134B,A01,083661,Powell; Thomas Allan,21,0,100,79
1657232802017,CSE 140,A01,083663,Gungor; Onat,13,0,85,72
1657232808040,CSE 140L,A01,083088,Eldon; John,17,0,100,83
1657232814062,CSE 175,A01,083665,Kumar; Rakesh,3,0,25,22
1657232820083,CSE 190,A00,092507,Dubnov; Shlomo,7,0,20,13
1657232826104,ECE 45,A01,083139,Congero; Spencer William,5,0,75,70
1657232832140,ECE 65,A50,083695,Saad; Andrew S,12,0,30,18
1657232832140,ECE 65,A51,095125,Saad; Andrew S,25,0,26,1
1657232838166,ECE 109,A01,091882,Touri; Behrouz,19,0,70,51
1657232844192,ECE 180,A00,083140,Abi Samra; Nicholas Camill,1,0,30,29
1657232844192,ECE 180,B00,083141,Abi Samra; Nicholas Camill,0,0,30,30
1657232850225,MATH 10A,A01,083735,Patchell; Gregory David,2,0,30,28
1657232850225,MATH 10A,A02,083736,Patchell; Gregory David,20,0,30,10
1657232850225,MATH 10A,A03,083737,Patchell; Gregory David,16,0,30,14
1657232856248,MATH 10B,A01,083207,Lim; Seonhee,7,0,34,27
1657232856248,MATH 10B,A02,083208,Lim; Seonhee,9,0,35,26
1657232856248,MATH 10B,A03,093472,Lim; Seonhee,5,0,34,29
1657232856248,MATH 10B,B01,083739,Sinha; Shubham,11,0,30,19
1657232862275,MATH 18,A01,083743,Cinel; Cameron Alexander,6,0,30,24
1657232862275,MATH 18,A02,083744,Cinel; Cameron Alexander,16,0,30,14
1657232862275,MATH 18,A03,083745,Cinel; Cameron Alexander,8,0,30,22
1657232862275,MATH 18,B01,083748,Rideout; David Porter,4,0,37,33
1657232862275,MATH 18,B02,083749,Rideout; David Porter,4,0,36,32
1657232862275,MATH 18,B03,083750,Rideout; David Porter,2,0,37,35
1657232862275,MATH 18,B04,083751,Rideout; David Porter,6,0,36,30
1657232862275,MATH 18,B05,093473,Rideout; David Porter,5,0,36,31
1657232862275,MATH 18,B06,093474,Rideout; David Porter,5,0,36,31
1657232868301,MATH 20A,A01,083754,Zheng; Zequn,14,0,40,26
1657232874325,MATH 20B,A01,083756,Briones; Jor-el Thomas Caparas,3,0,36,33
1657232874325,MATH 20B,A02,083757,Briones; Jor-el Thomas Caparas,1,0,36,35
1657232874325,MATH 20B,A03,093475,Briones; Jor-el Thomas Caparas,2,0,36,34
1657232880348,MATH 20C,A01,083760,Briones; Jor-el Thomas Caparas,1,0,35,34
1657232880348,MATH 20C,A02,083761,Briones; Jor-el Thomas Caparas,8,0,35,27
1657232880348,MATH 20C,A03,093476,Briones; Jor-el Thomas Caparas,0,1,36,36
1657232880348,MATH 20C,B01,083762,Bach; Quang Tran,1,0,30,29
1657232886371,MATH 20D,A01,083765,Tran; Brian Kha,4,0,30,26
1657232886371,MATH 20D,A02,083766,Tran; Brian Kha,5,0,30,25
1657232886371,MATH 20D,A03,083767,Tran; Brian Kha,4,0,30,26
1657232892398,MATH 20E,A01,083771,Ganguly; Soumya,7,0,32,25
1657232892398,MATH 20E,A02,083772,Ganguly; Soumya,7,0,32,25
1657232892398,MATH 20E,B01,083773,Ciotti; Benjamin,19,0,35,16
1657232892398,MATH 20E,B02,083774,Ciotti; Benjamin,17,0,35,18
1657232898420,MATH 103A,A01,083777,Greenfeld; Be'Eri,3,0,36,33
1657232898420,MATH 103A,A02,083778,Greenfeld; Be'Eri,5,0,36,31
1657232898420,MATH 103A,A03,093561,Greenfeld; Be'Eri,4,0,36,32
1657232898420,MATH 103A,B01,083779,Greenfeld; Be'Eri,6,0,36,30
1657232898420,MATH 103A,B02,083780,Greenfeld; Be'Eri,3,0,36,33
1657232898420,MATH 103A,B03,093562,Greenfeld; Be'Eri,3,0,36,33
1657232904447,MATH 105,A01,085443,Carter; Anne Toulson,15,0,35,20
1657232904447,MATH 105,A02,093477,Carter; Anne Toulson,20,0,35,15
1657232910471,MATH 109,A01,083213,Ganzberger; Geoffrey Michael,2,0,34,32
1657232910471,MATH 109,A02,083214,Ganzberger; Geoffrey Michael,4,0,34,30
1657232910471,MATH 109,A03,093478,Ganzberger; Geoffrey Michael,2,0,34,32
1657232910471,MATH 109,B01,083215,Ganzberger; Geoffrey Michael,1,0,32,31
1657232910471,MATH 109,B02,083216,Ganzberger; Geoffrey Michael,1,0,32,31
1657232910471,MATH 109,B03,093479,Ganzberger; Geoffrey Michael,8,0,32,24
1657232916499,MATH 142A,A01,083219,Chow; Bennett,6,0,32,26
1657232916499,MATH 142A,A02,083220,Chow; Bennett,10,0,32,22
1657232916499,MATH 142A,A03,093480,Chow; Bennett,7,0,32,25
1657232916499,MATH 142A,B03,093481,Chow; Bennett,8,0,32,24
1657232916499,MATH 142A,B04,093558,Chow; Bennett,12,0,32,20
1657232916499,MATH 142A,B05,093559,Chow; Bennett,6,0,32,26
1657232922526,MATH 193A,A01,083224,Rotar; Vladimir,7,0,34,27
1657232922526,MATH 193A,A02,083225,Rotar; Vladimir,6,0,34,28
1657232922526,MATH 193A,A03,083781,Rotar; Vladimir,2,0,34,32
1657232922526,MATH 193A,A04,083782,Rotar; Vladimir,8,0,34,26
1657232922526,MATH 193A,A05,093482,Rotar; Vladimir,6,0,34,28
1657232928549,MATH 197,001,091859,McAuley; Julian John,9999,0,9999,0
1657232928549,MATH 197,002,095566,Kedlaya; Kiran S.,9997,0,9999,2
1657232928549,MATH 197,003,095567,Xiao; Ming,9999,0,9999,0
1657232928549,MATH 197,004,095571,Perols; Johan Lars,9998,0,9999,1
1657232935607,COGS 9,A01,083615,Shannon; Kyle Michael,8,0,75,67
1657232941630,COGS 11,A01,083617,Boyle; Mary E. T.,22,0,48,26
1657232947654,COGS 13,A01,083071,Bastos; Amalia Pinkusfeld,8,0,71,63
1657232953677,COGS 14A,A01,092681,Semenuks; Arturs,2,1,100,98
1657232959706,COGS 14B,A01,083073,Cheng; Tzu-Han,6,0,63,57
1657232965728,COGS 17,A01,092677,Semenuks; Arturs,5,0,81,76
1657232971758,COGS 100,A01,083619,Allen; Michael Gordon,16,0,70,54
1657232977793,COGS 101A,A01,083621,Davis; Joshua Daniel,9,0,68,59
1657232983816,COGS 101B,A01,091572,Allen; Michael Gordon,11,0,65,54
1657232989842,COGS 101C,A01,083625,Delgado; Tania,17,0,35,18
1657232995865,COGS 107A,A01,083627,Boyle; Mary E. T.,13,0,60,47
1657233001893,COGS 118A,A01,083075,Gupta; Anjum,16,0,76,60
1657233007916,CSE 3,A50,083646,Miranda; Gregory Joseph,24,0,50,26
1657233014015,CSE 8A,A50,083650,Miranda; Gregory Joseph,17,1,56,39
1657233020037,CSE 11,A01,083080,Cao; Yingjun,5,15,40,35
1657233026066,CSE 12,A01,083652,Krause-Levy; Sophia Louisa,24,1,120,96
1657233032090,CSE 15L,A01,083654,Morris; Justin Loren,9,0,50,41
1657233032090,CSE 15L,A02,083655,Morris; Justin Loren,9,0,50,41
1657233038113,CSE 20,A01,083657,Tran; Khoa Dang,38,0,80,42
1657233044141,CSE 21,A01,095574,Bach; Quang Tran,22,0,48,26
1657233050167,CSE 30,A01,083084,Eldon; John,4,0,80,76
1657233050167,CSE 30,B01,095061,Bhaskar; Nishant,8,0,50,42
1657233056204,CSE 100,A01,083659,Cao; Yingjun,4,4,70,66
1657233062227,CSE 134B,A01,083661,Powell; Thomas Allan,21,0,100,79
1657233068261,CSE 140,A01,083663,Gungor; Onat,13,0,85,72
1657233074300,CSE 140L,A01,083088,Eldon; John,17,0,100,83
1657233080327,CSE 175,A01,083665,Kumar; Rakesh,3,0,25,22
1657233086353,CSE 190,A00,092507,Dubnov; Shlomo,7,0,20,13
1657233092378,ECE 45,A01,083139,Congero; Spencer William,5,0,75,70
1657233098410,ECE 65,A50,083695,Saad; Andrew S,12,0,30,18
1657233098410,ECE 65,A51,095125,Saad; Andrew S,25,0,26,1
1657233104440,ECE 109,A01,091882,Touri; Behrouz,19,0,70,51
1657233110463,ECE 180,A00,083140,Abi Samra; Nicholas Camill,1,0,30,29
1657233110463,ECE 180,B00,083141,Abi Samra; Nicholas Camill,0,0,30,30
1657233116487,MATH 10A,A01,083735,Patchell; Gregory David,2,0,30,28
1657233116487,MATH 10A,A02,083736,Patchell; Gregory David,20,0,30,10
1657233116487,MATH 10A,A03,083737,Patchell; Gregory David,16,0,30,14
1657233122526,MATH 10B,A01,083207,Lim; Seonhee,7,0,34,27
1657233122526,MATH 10B,A02,083208,Lim; Seonhee,9,0,35,26
1657233122526,MATH 10B,A03,093472,Lim; Seonhee,5,0,34,29
1657233122526,MATH 10B,B01,083739,Sinha; Shubham,11,0,30,19
1657233128559,MATH 18,A01,083743,Cinel; Cameron Alexander,6,0,30,24
1657233128559,MATH 18,A02,083744,Cinel; Cameron Alexander,17,0,30,13
1657233128559,MATH 18,A03,083745,Cinel; Cameron Alexander,8,0,30,22
1657233128559,MATH 18,B01,083748,Rideout; David Porter,4,0,37,33
1657233128559,MATH 18,B02,083749,Rideout; David Porter,4,0,36,32
1657233128559,MATH 18,B03,083750,Rideout; David Porter,2,0,37,35
1657233128559,MATH 18,B04,083751,Rideout; David Porter,6,0,36,30
1657233128559,MATH 18,B05,093473,Rideout; David Porter,5,0,36,31
1657233128559,MATH 18,B06,093474,Rideout; David Porter,5,0,36,31
1657233134597,MATH 20A,A01,083754,Zheng; Zequn,14,0,40,26
1657233140621,MATH 20B,A01,083756,Briones; Jor-el Thomas Caparas,3,0,36,33
1657233140621,MATH 20B,A02,083757,Briones; Jor-el Thomas Caparas,1,0,36,35
1657233140621,MATH 20B,A03,093475,Briones; Jor-el Thomas Caparas,2,0,36,34
1657233146649,MATH 20C,A01,083760,Briones; Jor-el Thomas Caparas,1,0,35,34
1657233146649,MATH 20C,A02,083761,Briones; Jor-el Thomas Caparas,8,0,35,27
1657233146649,MATH 20C,A03,093476,Briones; Jor-el Thomas Caparas,0,1,36,36
1657233146649,MATH 20C,B01,083762,Bach; Quang Tran,1,0,30,29
1657233152681,MATH 20D,A01,083765,Tran; Brian Kha,4,0,30,26
1657233152681,MATH 20D,A02,083766,Tran; Brian Kha,5,0,30,25
1657233152681,MATH 20D,A03,083767,Tran; Brian Kha,4,0,30,26
1657233158706,MATH 20E,A01,083771,Ganguly; Soumya,7,0,32,25
1657233158706,MATH 20E,A02,083772,Ganguly; Soumya,7,0,32,25
1657233158706,MATH 20E,B01,083773,Ciotti; Benjamin,19,0,35,16
1657233158706,MATH 20E,B02,083774,Ciotti; Benjamin,17,0,35,18
1657233164730,MATH 103A,A01,083777,Greenfeld; Be'Eri,3,0,36,33
1657233164730,MATH 103A,A02,083778,Greenfeld; Be'Eri,5,0,36,31
1657233164730,MATH 103A,A03,093561,Greenfeld; Be'Eri,4,0,36,32
1657233164730,MATH 103A,B01,083779,Greenfeld; Be'Eri,6,0,36,30
1657233164730,MATH 103A,B02,083780,Greenfeld; Be'Eri,3,0,36,33
1657233164730,MATH 103A,B03,093562,Greenfeld; Be'Eri,3,0,36,33
1657233170752,MATH 105,A01,085443,Carter; Anne Toulson,15,0,35,20
1657233170752,MATH 105,A02,093477,Carter; Anne Toulson,20,0,35,15
1657233176785,MATH 109,A01,083213,Ganzberger; Geoffrey Michael,2,0,34,32
1657233176785,MATH 109,A02,083214,Ganzberger; Geoffrey Michael,4,0,34,30
1657233176785,MATH 109,A03,093478,Ganzberger; Geoffrey Michael,2,0,34,32
1657233176785,MATH 109,B01,083215,Ganzberger; Geoffrey Michael,1,0,32,31
1657233176785,MATH 109,B02,083216,Ganzberger; Geoffrey Michael,1,0,32,31
1657233176785,MATH 109,B03,093479,Ganzberger; Geoffrey Michael,8,0,32,24
1657233182809,MATH 142A,A01,083219,Chow; Bennett,6,0,32,26
1657233182809,MATH 142A,A02,083220,Chow; Bennett,10,0,32,22
1657233182809,MATH 142A,A03,093480,Chow; Bennett,7,0,32,25
1657233182809,MATH 142A,B03,093481,Chow; Bennett,8,0,32,24
1657233182809,MATH 142A,B04,093558,Chow; Bennett,12,0,32,20
1657233182809,MATH 142A,B05,093559,Chow; Bennett,6,0,32,26
1657233188832,MATH 193A,A01,083224,Rotar; Vladimir,7,0,34,27
1657233188832,MATH 193A,A02,083225,Rotar; Vladimir,6,0,34,28
1657233188832,MATH 193A,A03,083781,Rotar; Vladimir,2,0,34,32
1657233188832,MATH 193A,A04,083782,Rotar; Vladimir,8,0,34,26
1657233188832,MATH 193A,A05,093482,Rotar; Vladimir,6,0,34,28
1657233194854,MATH 197,001,091859,McAuley; Julian John,9999,0,9999,0
1657233194854,MATH 197,002,095566,Kedlaya; Kiran S.,9997,0,9999,2
1657233194854,MATH 197,003,095567,Xiao; Ming,9999,0,9999,0
1657233194854,MATH 197,004,095571,Perols; Johan Lars,9998,0,9999,1
1657233201909,COGS 9,A01,083615,Shannon; Kyle Michael,8,0,75,67
1657233207932,COGS 11,A01,083617,Boyle; Mary E. T.,22,0,48,26
1657233213955,COGS 13,A01,083071,Bastos; Amalia Pinkusfeld,8,0,71,63
1657233219982,COGS 14A,A01,092681,Semenuks; Arturs,2,1,100,98
1657233226011,COGS 14B,A01,083073,Cheng; Tzu-Han,6,0,63,57
1657233232037,COGS 17,A01,092677,Semenuks; Arturs,5,0,81,76
1657233238064,COGS 100,A01,083619,Allen; Michael Gordon,16,0,70,54
1657233244091,COGS 101A,A01,083621,Davis; Joshua Daniel,9,0,68,59
1657233250118,COGS 101B,A01,091572,Allen; Michael Gordon,11,0,65,54
1657233256142,COGS 101C,A01,083625,Delgado; Tania,17,0,35,18
1657233262178,COGS 107A,A01,083627,Boyle; Mary E. T.,13,0,60,47
1657233268202,COGS 118A,A01,083075,Gupta; Anjum,16,0,76,60
1657233274236,CSE 3,A50,083646,Miranda; Gregory Joseph,24,0,50,26
1657233280279,CSE 8A,A50,083650,Miranda; Gregory Joseph,17,1,56,39
1657233286302,CSE 11,A01,083080,Cao; Yingjun,5,15,40,35
1657233292324,CSE 12,A01,083652,Krause-Levy; Sophia Louisa,24,1,120,96
1657233298347,CSE 15L,A01,083654,Morris; Justin Loren,9,0,50,41
1657233298347,CSE 15L,A02,083655,Morris; Justin Loren,9,0,50,41
1657233304374,CSE 20,A01,083657,Tran; Khoa Dang,38,0,80,42
1657233310396,CSE 21,A01,095574,Bach; Quang Tran,22,0,48,26
1657233316421,CSE 30,A01,083084,Eldon; John,4,0,80,76
1657233316421,CSE 30,B01,095061,Bhaskar; Nishant,8,0,50,42
1657233322444,CSE 100,A01,083659,Cao; Yingjun,4,4,70,66
1657233328476,CSE 134B,A01,083661,Powell; Thomas Allan,21,0,100,79
1657233334497,CSE 140,A01,083663,Gungor; Onat,13,0,85,72
1657233340524,CSE 140L,A01,083088,Eldon; John,17,0,100,83
1657233346548,CSE 175,A01,083665,Kumar; Rakesh,3,0,25,22
1657233352582,CSE 190,A00,092507,Dubnov; Shlomo,7,0,20,13
1657233358610,ECE 45,A01,083139,Congero; Spencer William,5,0,75,70
1657233364649,ECE 65,A50,083695,Saad; Andrew S,12,0,30,18
1657233364649,ECE 65,A51,095125,Saad; Andrew S,25,0,26,1
1657233370672,ECE 109,A01,091882,Touri; Behrouz,19,0,70,51
1657233376698,ECE 180,A00,083140,Abi Samra; Nicholas Camill,1,0,30,29
1657233376698,ECE 180,B00,083141,Abi Samra; Nicholas Camill,0,0,30,30
1657233382724,MATH 10A,A01,083735,Patchell; Gregory David,2,0,30,28
1657233382724,MATH 10A,A02,083736,Patchell; Gregory David,20,0,30,10
1657233382724,MATH 10A,A03,083737,Patchell; Gregory David,16,0,30,14
1657233388777,MATH 10B,A01,083207,Lim; Seonhee,7,0,34,27
1657233388777,MATH 10B,A02,083208,Lim; Seonhee,9,0,35,26
1657233388777,MATH 10B,A03,093472,Lim; Seonhee,5,0,34,29
1657233388777,MATH 10B,B01,083739,Sinha; Shubham,11,0,30,19
1657233394806,MATH 18,A01,083743,Cinel; Cameron Alexander,6,0,30,24
1657233394806,MATH 18,A02,083744,Cinel; Cameron Alexander,17,0,30,13
1657233394806,MATH 18,A03,083745,Cinel; Cameron Alexander,8,0,30,22
1657233394806,MATH 18,B01,083748,Rideout; David Porter,4,0,37,33
1657233394806,MATH 18,B02,083749,Rideout; David Porter,4,0,36,32
1657233394806,MATH 18,B03,083750,Rideout; David Porter,2,0,37,35
1657233394806,MATH 18,B04,083751,Rideout; David Porter,6,0,36,30
1657233394806,MATH 18,B05,093473,Rideout; David Porter,5,0,36,31
1657233394806,MATH 18,B06,093474,Rideout; David Porter,5,0,36,31
1657233400834,MATH 20A,A01,083754,Zheng; Zequn,14,0,40,26
1657233406865,MATH 20B,A01,083756,Briones; Jor-el Thomas Caparas,3,0,36,33
1657233406865,MATH 20B,A02,083757,Briones; Jor-el Thomas Caparas,1,0,36,35
1657233406865,MATH 20B,A03,093475,Briones; Jor-el Thomas Caparas,2,0,36,34
1657233412892,MATH 20C,A01,083760,Briones; Jor-el Thomas Caparas,1,0,35,34
1657233412892,MATH 20C,A02,083761,Briones; Jor-el Thomas Caparas,8,0,35,27
1657233412892,MATH 20C,A03,093476,Briones; Jor-el Thomas Caparas,0,1,36,36
1657233412892,MATH 20C,B01,083762,Bach; Quang Tran,1,0,30,29
1657233418923,MATH 20D,A01,083765,Tran; Brian Kha,4,0,30,26
1657233418923,MATH 20D,A02,083766,Tran; Brian Kha,5,0,30,25
1657233418923,MATH 20D,A03,083767,Tran; Brian Kha,4,0,30,26
1657233424948,MATH 20E,A01,083771,Ganguly; Soumya,7,0,32,25
1657233424948,MATH 20E,A02,083772,Ganguly; Soumya,7,0,32,25
1657233424948,MATH 20E,B01,083773,Ciotti; Benjamin,19,0,35,16
1657233424948,MATH 20E,B02,083774,Ciotti; Benjamin,17,0,35,18
1657233430980,MATH 103A,A01,083777,Greenfeld; Be'Eri,3,0,36,33
1657233430980,MATH 103A,A02,083778,Greenfeld; Be'Eri,5,0,36,31
1657233430980,MATH 103A,A03,093561,Greenfeld; Be'Eri,4,0,36,32
1657233430980,MATH 103A,B01,083779,Greenfeld; Be'Eri,6,0,36,30
1657233430980,MATH 103A,B02,083780,Greenfeld; Be'Eri,3,0,36,33
1657233430980,MATH 103A,B03,093562,Greenfeld; Be'Eri,3,0,36,33
1657233437003,MATH 105,A01,085443,Carter; Anne Toulson,15,0,35,20
1657233437003,MATH 105,A02,093477,Carter; Anne Toulson,20,0,35,15
1657233443026,MATH 109,A01,083213,Ganzberger; Geoffrey Michael,2,0,34,32
1657233443026,MATH 109,A02,083214,Ganzberger; Geoffrey Michael,4,0,34,30
1657233443026,MATH 109,A03,093478,Ganzberger; Geoffrey Michael,2,0,34,32
1657233443026,MATH 109,B01,083215,Ganzberger; Geoffrey Michael,1,0,32,31
1657233443026,MATH 109,B02,083216,Ganzberger; Geoffrey Michael,1,0,32,31
1657233443026,MATH 109,B03,093479,Ganzberger; Geoffrey Michael,8,0,32,24
1657233449059,MATH 142A,A01,083219,Chow; Bennett,6,0,32,26
1657233449059,MATH 142A,A02,083220,Chow; Bennett,10,0,32,22
1657233449059,MATH 142A,A03,093480,Chow; Bennett,7,0,32,25
1657233449059,MATH 142A,B03,093481,Chow; Bennett,8,0,32,24
1657233449059,MATH 142A,B04,093558,Chow; Bennett,12,0,32,20
1657233449059,MATH 142A,B05,093559,Chow; Bennett,6,0,32,26
1657233455087,MATH 193A,A01,083224,Rotar; Vladimir,7,0,34,27
1657233455087,MATH 193A,A02,083225,Rotar; Vladimir,6,0,34,28
1657233455087,MATH 193A,A03,083781,Rotar; Vladimir,2,0,34,32
1657233455087,MATH 193A,A04,083782,Rotar; Vladimir,8,0,34,26
1657233455087,MATH 193A,A05,093482,Rotar; Vladimir,6,0,34,28
1657233461122,MATH 197,001,091859,McAuley; Julian John,9999,0,9999,0
1657233461122,MATH 197,002,095566,Kedlaya; Kiran S.,9997,0,9999,2
1657233461122,MATH 197,003,095567,Xiao; Ming,9999,0,9999,0
1657233461122,MATH 197,004,095571,Perols; Johan Lars,9998,0,9999,1
1657233468186,COGS 9,A01,083615,Shannon; Kyle Michael,8,0,75,67
1657233474216,COGS 11,A01,083617,Boyle; Mary E. T.,22,0,48,26
1657233480240,COGS 13,A01,083071,Bastos; Amalia Pinkusfeld,8,0,71,63
1657233486263,COGS 14A,A01,092681,Semenuks; Arturs,2,1,100,98
1657233492292,COGS 14B,A01,083073,Cheng; Tzu-Han,6,0,63,57
1657233498317,COGS 17,A01,092677,Semenuks; Arturs,5,0,81,76
1657233504342,COGS 100,A01,083619,Allen; Michael Gordon,16,0,70,54
1657233510369,COGS 101A,A01,083621,Davis; Joshua Daniel,9,0,68,59
1657233516392,COGS 101B,A01,091572,Allen; Michael Gordon,11,0,65,54
1657233522418,COGS 101C,A01,083625,Delgado; Tania,17,0,35,18
1657233528447,COGS 107A,A01,083627,Boyle; Mary E. T.,13,0,60,47
1657233534472,COGS 118A,A01,083075,Gupta; Anjum,16,0,76,60
1657233540500,CSE 3,A50,083646,Miranda; Gregory Joseph,24,0,50,26
1657233546542,CSE 8A,A50,083650,Miranda; Gregory Joseph,17,1,56,39
1657233552570,CSE 11,A01,083080,Cao; Yingjun,5,15,40,35
1657233558606,CSE 12,A01,083652,Krause-Levy; Sophia Louisa,25,1,120,95
1657233564632,CSE 15L,A01,083654,Morris; Justin Loren,9,0,50,41
1657233564632,CSE 15L,A02,083655,Morris; Justin Loren,9,0,50,41
1657233570656,CSE 20,A01,083657,Tran; Khoa Dang,38,0,80,42
1657233576678,CSE 21,A01,095574,Bach; Quang Tran,22,0,48,26
1657233582699,CSE 30,A01,083084,Eldon; John,4,0,80,76
1657233582699,CSE 30,B01,095061,Bhaskar; Nishant,8,0,50,42
1657233588722,CSE 100,A01,083659,Cao; Yingjun,4,4,70,66
1657233594745,CSE 134B,A01,083661,Powell; Thomas Allan,21,0,100,79
1657233600788,CSE 140,A01,083663,Gungor; Onat,13,0,85,72
1657233606810,CSE 140L,A01,083088,Eldon; John,17,0,100,83
1657233612911,CSE 175,A01,083665,Kumar; Rakesh,3,0,25,22
1657233618935,CSE 190,A00,092507,Dubnov; Shlomo,7,0,20,13
1657233624966,ECE 45,A01,083139,Congero; Spencer William,5,0,75,70
1657233630990,ECE 65,A50,083695,Saad; Andrew S,12,0,30,18
1657233630990,ECE 65,A51,095125,Saad; Andrew S,25,0,26,1
1657233637016,ECE 109,A01,091882,Touri; Behrouz,19,0,70,51
1657233643042,ECE 180,A00,083140,Abi Samra; Nicholas Camill,1,0,30,29
1657233643042,ECE 180,B00,083141,Abi Samra; Nicholas Camill,0,0,30,30
1657233649066,MATH 10A,A01,083735,Patchell; Gregory David,2,0,30,28
1657233649066,MATH 10A,A02,083736,Patchell; Gregory David,20,0,30,10
1657233649066,MATH 10A,A03,083737,Patchell; Gregory David,16,0,30,14
1657233655095,MATH 10B,A01,083207,Lim; Seonhee,7,0,34,27
1657233655095,MATH 10B,A02,083208,Lim; Seonhee,9,0,35,26
1657233655095,MATH 10B,A03,093472,Lim; Seonhee,5,0,34,29
1657233655095,MATH 10B,B01,083739,Sinha; Shubham,11,0,30,19
1657233661130,MATH 18,A01,083743,Cinel; Cameron Alexander,6,0,30,24
1657233661130,MATH 18,A02,083744,Cinel; Cameron Alexander,17,0,30,13
1657233661130,MATH 18,A03,083745,Cinel; Cameron Alexander,8,0,30,22
1657233661130,MATH 18,B01,083748,Rideout; David Porter,4,0,37,33
1657233661130,MATH 18,B02,083749,Rideout; David Porter,4,0,36,32
1657233661130,MATH 18,B03,083750,Rideout; David Porter,2,0,37,35
1657233661130,MATH 18,B04,083751,Rideout; David Porter,6,0,36,30
1657233661130,MATH 18,B05,093473,Rideout; David Porter,5,0,36,31
1657233661130,MATH 18,B06,093474,Rideout; David Porter,5,0,36,31
1657233667153,MATH 20A,A01,083754,Zheng; Zequn,14,0,40,26
1657233673185,MATH 20B,A01,083756,Briones; Jor-el Thomas Caparas,3,0,36,33
1657233673185,MATH 20B,A02,083757,Briones; Jor-el Thomas Caparas,1,0,36,35
1657233673185,MATH 20B,A03,093475,Briones; Jor-el Thomas Caparas,2,0,36,34
1657233679208,MATH 20C,A01,083760,Briones; Jor-el Thomas Caparas,1,0,35,34
1657233679208,MATH 20C,A02,083761,Briones; Jor-el Thomas Caparas,8,0,35,27
1657233679208,MATH 20C,A03,093476,Briones; Jor-el Thomas Caparas,0,1,36,36
1657233679208,MATH 20C,B01,083762,Bach; Quang Tran,1,0,30,29
1657233685238,MATH 20D,A01,083765,Tran; Brian Kha,4,0,30,26
1657233685238,MATH 20D,A02,083766,Tran; Brian Kha,5,0,30,25
1657233685238,MATH 20D,A03,083767,Tran; Brian Kha,4,0,30,26
1657233691267,MATH 20E,A01,083771,Ganguly; Soumya,7,0,32,25
1657233691267,MATH 20E,A02,083772,Ganguly; Soumya,7,0,32,25
1657233691267,MATH 20E,B01,083773,Ciotti; Benjamin,19,0,35,16
1657233691267,MATH 20E,B02,083774,Ciotti; Benjamin,17,0,35,18
1657233697291,MATH 103A,A01,083777,Greenfeld; Be'Eri,3,0,36,33
1657233697291,MATH 103A,A02,083778,Greenfeld; Be'Eri,5,0,36,31
1657233697291,MATH 103A,A03,093561,Greenfeld; Be'Eri,4,0,36,32
1657233697291,MATH 103A,B01,083779,Greenfeld; Be'Eri,6,0,36,30
1657233697291,MATH 103A,B02,083780,Greenfeld; Be'Eri,3,0,36,33
1657233697291,MATH 103A,B03,093562,Greenfeld; Be'Eri,3,0,36,33
1657233703313,MATH 105,A01,085443,Carter; Anne Toulson,15,0,35,20
1657233703313,MATH 105,A02,093477,Carter; Anne Toulson,20,0,35,15
1657233709341,MATH 109,A01,083213,Ganzberger; Geoffrey Michael,2,0,34,32
1657233709341,MATH 109,A02,083214,Ganzberger; Geoffrey Michael,4,0,34,30
1657233709341,MATH 109,A03,093478,Ganzberger; Geoffrey Michael,2,0,34,32
1657233709341,MATH 109,B01,083215,Ganzberger; Geoffrey Michael,1,0,32,31
1657233709341,MATH 109,B02,083216,Ganzberger; Geoffrey Michael,1,0,32,31
1657233709341,MATH 109,B03,093479,Ganzberger; Geoffrey Michael,8,0,32,24
1657233715371,MATH 142A,A01,083219,Chow; Bennett,6,0,32,26
1657233715371,MATH 142A,A02,083220,Chow; Bennett,10,0,32,22
1657233715371,MATH 142A,A03,093480,Chow; Bennett,7,0,32,25
1657233715371,MATH 142A,B03,093481,Chow; Bennett,8,0,32,24
1657233715371,MATH 142A,B04,093558,Chow; Bennett,12,0,32,20
1657233715371,MATH 142A,B05,093559,Chow; Bennett,6,0,32,26
1657233721397,MATH 193A,A01,083224,Rotar; Vladimir,7,0,34,27
1657233721397,MATH 193A,A02,083225,Rotar; Vladimir,6,0,34,28
1657233721397,MATH 193A,A03,083781,Rotar; Vladimir,2,0,34,32
1657233721397,MATH 193A,A04,083782,Rotar; Vladimir,8,0,34,26
1657233721397,MATH 193A,A05,093482,Rotar; Vladimir,6,0,34,28
1657233727427,MATH 197,001,091859,McAuley; Julian John,9999,0,9999,0
1657233727427,MATH 197,002,095566,Kedlaya; Kiran S.,9997,0,9999,2
1657233727427,MATH 197,003,095567,Xiao; Ming,9999,0,9999,0
1657233727427,MATH 197,004,095571,Perols; Johan Lars,9998,0,9999,1
1657233734482,COGS 9,A01,083615,Shannon; Kyle Michael,8,0,75,67
1657233740506,COGS 11,A01,083617,Boyle; Mary E. T.,22,0,48,26
1657233746545,COGS 13,A01,083071,Bastos; Amalia Pinkusfeld,8,0,71,63
1657233752571,COGS 14A,A01,092681,Semenuks; Arturs,2,1,100,98
1657233758607,COGS 14B,A01,083073,Cheng; Tzu-Han,6,0,63,57
1657233764629,COGS 17,A01,092677,Semenuks; Arturs,5,0,81,76
1657233770652,COGS 100,A01,083619,Allen; Michael Gordon,16,0,70,54
1657233776684,COGS 101A,A01,083621,Davis; Joshua Daniel,9,0,68,59
1657233782707,COGS 101B,A01,091572,Allen; Michael Gordon,11,0,65,54
1657233788736,COGS 101C,A01,083625,Delgado; Tania,17,0,35,18
1657233794767,COGS 107A,A01,083627,Boyle; Mary E. T.,13,0,60,47
1657233800798,COGS 118A,A01,083075,Gupta; Anjum,16,0,76,60
1657233806821,CSE 3,A50,083646,Miranda; Gregory Joseph,24,0,50,26
1657233812846,CSE 8A,A50,083650,Miranda; Gregory Joseph,17,1,56,39
1657233818871,CSE 11,A01,083080,Cao; Yingjun,5,15,40,35
1657233824895,CSE 12,A01,083652,Krause-Levy; Sophia Louisa,25,1,120,95
1657233830917,CSE 15L,A01,083654,Morris; Justin Loren,9,0,50,41
1657233830917,CSE 15L,A02,083655,Morris; Justin Loren,9,0,50,41
1657233836941,CSE 20,A01,083657,Tran; Khoa Dang,38,0,80,42
1657233842963,CSE 21,A01,095574,Bach; Quang Tran,22,0,48,26
1657233848987,CSE 30,A01,083084,Eldon; John,4,0,80,76
1657233848987,CSE 30,B01,095061,Bhaskar; Nishant,8,0,50,42
1657233855010,CSE 100,A01,083659,Cao; Yingjun,4,4,70,66
1657233861041,CSE 134B,A01,083661,Powell; Thomas Allan,21,0,100,79
1657233867068,CSE 140,A01,083663,Gungor; Onat,13,0,85,72
1657233873097,CSE 140L,A01,083088,Eldon; John,17,0,100,83
1657233879124,CSE 175,A01,083665,Kumar; Rakesh,3,0,25,22
1657233885145,CSE 190,A00,092507,Dubnov; Shlomo,7,0,20,13
1657233891170,ECE 45,A01,083139,Congero; Spencer William,5,0,75,70
1657233897198,ECE 65,A50,083695,Saad; Andrew S,12,0,30,18
1657233897198,ECE 65,A51,095125,Saad; Andrew S,25,0,26,1
1657233903228,ECE 109,A01,091882,Touri; Behrouz,19,0,70,51
1657233909253,ECE 180,A00,083140,Abi Samra; Nicholas Camill,1,0,30,29
1657233909253,ECE 180,B00,083141,Abi Samra; Nicholas Camill,0,0,30,30
1657233915283,MATH 10A,A01,083735,Patchell; Gregory David,2,0,30,28
1657233915283,MATH 10A,A02,083736,Patchell; Gregory David,20,0,30,10
1657233915283,MATH 10A,A03,083737,Patchell; Gregory David,16,0,30,14
1657233921309,MATH 10B,A01,083207,Lim; Seonhee,7,0,34,27
1657233921309,MATH 10B,A02,083208,Lim; Seonhee,9,0,35,26
1657233921309,MATH 10B,A03,093472,Lim; Seonhee,5,0,34,29
1657233921309,MATH 10B,B01,083739,Sinha; Shubham,11,0,30,19
1657233927335,MATH 18,A01,083743,Cinel; Cameron Alexander,6,0,30,24
1657233927335,MATH 18,A02,083744,Cinel; Cameron Alexander,17,0,30,13
1657233927335,MATH 18,A03,083745,Cinel; Cameron Alexander,8,0,30,22
1657233927335,MATH 18,B01,083748,Rideout; David Porter,4,0,37,33
1657233927335,MATH 18,B02,083749,Rideout; David Porter,4,0,36,32
1657233927335,MATH 18,B03,083750,Rideout; David Porter,2,0,37,35
1657233927335,MATH 18,B04,083751,Rideout; David Porter,6,0,36,30
1657233927335,MATH 18,B05,093473,Rideout; David Porter,5,0,36,31
1657233927335,MATH 18,B06,093474,Rideout; David Porter,5,0,36,31
1657233933358,MATH 20A,A01,083754,Zheng; Zequn,14,0,40,26
1657233939381,MATH 20B,A01,083756,Briones; Jor-el Thomas Caparas,3,0,36,33
1657233939381,MATH 20B,A02,083757,Briones; Jor-el Thomas Caparas,1,0,36,35
1657233939381,MATH 20B,A03,093475,Briones; Jor-el Thomas Caparas,2,0,36,34
1657233945410,MATH 20C,A01,083760,Briones; Jor-el Thomas Caparas,1,0,35,34
1657233945410,MATH 20C,A02,083761,Briones; Jor-el Thomas Caparas,8,0,35,27
1657233945410,MATH 20C,A03,093476,Briones; Jor-el Thomas Caparas,0,1,36,36
1657233945410,MATH 20C,B01,083762,Bach; Quang Tran,1,0,30,29
1657233951440,MATH 20D,A01,083765,Tran; Brian Kha,4,0,30,26
1657233951440,MATH 20D,A02,083766,Tran; Brian Kha,5,0,30,25
1657233951440,MATH 20D,A03,083767,Tran; Brian Kha,4,0,30,26
1657233957470,MATH 20E,A01,083771,Ganguly; Soumya,7,0,32,25
1657233957470,MATH 20E,A02,083772,Ganguly; Soumya,7,0,32,25
1657233957470,MATH 20E,B01,083773,Ciotti; Benjamin,19,0,35,16
1657233957470,MATH 20E,B02,083774,Ciotti; Benjamin,17,0,35,18
1657233963498,MATH 103A,A01,083777,Greenfeld; Be'Eri,3,0,36,33
1657233963498,MATH 103A,A02,083778,Greenfeld; Be'Eri,5,0,36,31
1657233963498,MATH 103A,A03,093561,Greenfeld; Be'Eri,4,0,36,32
1657233963498,MATH 103A,B01,083779,Greenfeld; Be'Eri,6,0,36,30
1657233963498,MATH 103A,B02,083780,Greenfeld; Be'Eri,3,0,36,33
1657233963498,MATH 103A,B03,093562,Greenfeld; Be'Eri,3,0,36,33
1657233969527,MATH 105,A01,085443,Carter; Anne Toulson,15,0,35,20
1657233969527,MATH 105,A02,093477,Carter; Anne Toulson,20,0,35,15
1657233975557,MATH 109,A01,083213,Ganzberger; Geoffrey Michael,2,0,34,32
1657233975557,MATH 109,A02,083214,Ganzberger; Geoffrey Michael,4,0,34,30
1657233975557,MATH 109,A03,093478,Ganzberger; Geoffrey Michael,2,0,34,32
1657233975557,MATH 109,B01,083215,Ganzberger; Geoffrey Michael,1,0,32,31
1657233975557,MATH 109,B02,083216,Ganzberger; Geoffrey Michael,1,0,32,31
1657233975557,MATH 109,B03,093479,Ganzberger; Geoffrey Michael,8,0,32,24
1657233981584,MATH 142A,A01,083219,Chow; Bennett,6,0,32,26
1657233981584,MATH 142A,A02,083220,Chow; Bennett,10,0,32,22
1657233981584,MATH 142A,A03,093480,Chow; Bennett,7,0,32,25
1657233981584,MATH 142A,B03,093481,Chow; Bennett,8,0,32,24
1657233981584,MATH 142A,B04,093558,Chow; Bennett,12,0,32,20
1657233981584,MATH 142A,B05,093559,Chow; Bennett,6,0,32,26
1657233987612,MATH 193A,A01,083224,Rotar; Vladimir,7,0,34,27
1657233987612,MATH 193A,A02,083225,Rotar; Vladimir,6,0,34,28
1657233987612,MATH 193A,A03,083781,Rotar; Vladimir,2,0,34,32
1657233987612,MATH 193A,A04,083782,Rotar; Vladimir,8,0,34,26
1657233987612,MATH 193A,A05,093482,Rotar; Vladimir,6,0,34,28
1657233993638,MATH 197,001,091859,McAuley; Julian John,9999,0,9999,0
1657233993638,MATH 197,002,095566,Kedlaya; Kiran S.,9997,0,9999,2
1657233993638,MATH 197,003,095567,Xiao; Ming,9999,0,9999,0
1657233993638,MATH 197,004,095571,Perols; Johan Lars,9998,0,9999,1
1657234000694,COGS 9,A01,083615,Shannon; Kyle Michael,8,0,75,67
1657234006720,COGS 11,A01,083617,Boyle; Mary E. T.,22,0,48,26
1657234012746,COGS 13,A01,083071,Bastos; Amalia Pinkusfeld,8,0,71,63
1657234018781,COGS 14A,A01,092681,Semenuks; Arturs,2,1,100,98
1657234024803,COGS 14B,A01,083073,Cheng; Tzu-Han,6,0,63,57
1657234030829,COGS 17,A01,092677,Semenuks; Arturs,5,0,81,76
1657234036858,COGS 100,A01,083619,Allen; Michael Gordon,16,0,70,54
1657234042887,COGS 101A,A01,083621,Davis; Joshua Daniel,9,0,68,59
1657234048909,COGS 101B,A01,091572,Allen; Michael Gordon,11,0,65,54
1657234054933,COGS 101C,A01,083625,Delgado; Tania,17,0,35,18
1657234060968,COGS 107A,A01,083627,Boyle; Mary E. T.,13,0,60,47
1657234066997,COGS 118A,A01,083075,Gupta; Anjum,16,0,76,60
1657234073025,CSE 3,A50,083646,Miranda; Gregory Joseph,24,0,50,26
1657234079058,CSE 8A,A50,083650,Miranda; Gregory Joseph,17,1,56,39
1657234085095,CSE 11,A01,083080,Cao; Yingjun,5,15,40,35
1657234091118,CSE 12,A01,083652,Krause-Levy; Sophia Louisa,25,1,120,95
1657234097140,CSE 15L,A01,083654,Morris; Justin Loren,9,0,50,41
1657234097140,CSE 15L,A02,083655,Morris; Justin Loren,9,0,50,41
1657234103168,CSE 20,A01,083657,Tran; Khoa Dang,38,0,80,42
1657234109200,CSE 21,A01,095574,Bach; Quang Tran,22,0,48,26
1657234115223,CSE 30,A01,083084,Eldon; John,4,0,80,76
1657234115223,CSE 30,B01,095061,Bhaskar; Nishant,8,0,50,42
1657234121253,CSE 100,A01,083659,Cao; Yingjun,4,4,70,66
1657234127277,CSE 134B,A01,083661,Powell; Thomas Allan,21,0,100,79
1657234133303,CSE 140,A01,083663,Gungor; Onat,13,0,85,72
1657234139334,CSE 140L,A01,083088,Eldon; John,17,0,100,83
1657234145358,CSE 175,A01,083665,Kumar; Rakesh,3,0,25,22
1657234151384,CSE 190,A00,092507,Dubnov; Shlomo,7,0,20,13
1657234157407,ECE 45,A01,083139,Congero; Spencer William,5,0,75,70
1657234163431,ECE 65,A50,083695,Saad; Andrew S,12,0,30,18
1657234163431,ECE 65,A51,095125,Saad; Andrew S,25,0,26,1
1657234169458,ECE 109,A01,091882,Touri; Behrouz,19,0,70,51
1657234175503,ECE 180,A00,083140,Abi Samra; Nicholas Camill,1,0,30,29
1657234175503,ECE 180,B00,083141,Abi Samra; Nicholas Camill,0,0,30,30
1657234181536,MATH 10A,A01,083735,Patchell; Gregory David,2,0,30,28
1657234181536,MATH 10A,A02,083736,Patchell; Gregory David,20,0,30,10
1657234181536,MATH 10A,A03,083737,Patchell; Gregory David,16,0,30,14
1657234187564,MATH 10B,A01,083207,Lim; Seonhee,7,0,34,27
1657234187564,MATH 10B,A02,083208,Lim; Seonhee,9,0,35,26
1657234187564,MATH 10B,A03,093472,Lim; Seonhee,5,0,34,29
1657234187564,MATH 10B,B01,083739,Sinha; Shubham,11,0,30,19
1657234193590,MATH 18,A01,083743,Cinel; Cameron Alexander,6,0,30,24
1657234193590,MATH 18,A02,083744,Cinel; Cameron Alexander,17,0,30,13
1657234193590,MATH 18,A03,083745,Cinel; Cameron Alexander,8,0,30,22
1657234193590,MATH 18,B01,083748,Rideout; David Porter,4,0,37,33
1657234193590,MATH 18,B02,083749,Rideout; David Porter,4,0,36,32
1657234193590,MATH 18,B03,083750,Rideout; David Porter,2,0,37,35
1657234193590,MATH 18,B04,083751,Rideout; David Porter,6,0,36,30
1657234193590,MATH 18,B05,093473,Rideout; David Porter,5,0,36,31
1657234193590,MATH 18,B06,093474,Rideout; David Porter,5,0,36,31
1657234199615,MATH 20A,A01,083754,Zheng; Zequn,14,0,40,26
1657234205648,MATH 20B,A01,083756,Briones; Jor-el Thomas Caparas,3,0,36,33
1657234205648,MATH 20B,A02,083757,Briones; Jor-el Thomas Caparas,1,0,36,35
1657234205648,MATH 20B,A03,093475,Briones; Jor-el Thomas Caparas,2,0,36,34
1657234211753,MATH 20C,A01,083760,Briones; Jor-el Thomas Caparas,1,0,35,34
1657234211753,MATH 20C,A02,083761,Briones; Jor-el Thomas Caparas,8,0,35,27
1657234211753,MATH 20C,A03,093476,Briones; Jor-el Thomas Caparas,0,1,36,36
1657234211753,MATH 20C,B01,083762,Bach; Quang Tran,1,0,30,29
1657234217775,MATH 20D,A01,083765,Tran; Brian Kha,4,0,30,26
1657234217775,MATH 20D,A02,083766,Tran; Brian Kha,5,0,30,25
1657234217775,MATH 20D,A03,083767,Tran; Brian Kha,4,0,30,26
1657234223802,MATH 20E,A01,083771,Ganguly; Soumya,7,0,32,25
1657234223802,MATH 20E,A02,083772,Ganguly; Soumya,7,0,32,25
1657234223802,MATH 20E,B01,083773,Ciotti; Benjamin,19,0,35,16
1657234223802,MATH 20E,B02,083774,Ciotti; Benjamin,17,0,35,18
1657234229827,MATH 103A,A01,083777,Greenfeld; Be'Eri,3,0,36,33
1657234229827,MATH 103A,A02,083778,Greenfeld; Be'Eri,5,0,36,31
1657234229827,MATH 103A,A03,093561,Greenfeld; Be'Eri,4,0,36,32
1657234229827,MATH 103A,B01,083779,Greenfeld; Be'Eri,6,0,36,30
1657234229827,MATH 103A,B02,083780,Greenfeld; Be'Eri,3,0,36,33
1657234229827,MATH 103A,B03,093562,Greenfeld; Be'Eri,3,0,36,33
1657234235850,MATH 105,A01,085443,Carter; Anne Toulson,15,0,35,20
1657234235850,MATH 105,A02,093477,Carter; Anne Toulson,20,0,35,15
1657234241872,MATH 109,A01,083213,Ganzberger; Geoffrey Michael,2,0,34,32
1657234241872,MATH 109,A02,083214,Ganzberger; Geoffrey Michael,4,0,34,30
1657234241872,MATH 109,A03,093478,Ganzberger; Geoffrey Michael,2,0,34,32
1657234241872,MATH 109,B01,083215,Ganzberger; Geoffrey Michael,1,0,32,31
1657234241872,MATH 109,B02,083216,Ganzberger; Geoffrey Michael,1,0,32,31
1657234241872,MATH 109,B03,093479,Ganzberger; Geoffrey Michael,8,0,32,24
1657234247902,MATH 142A,A01,083219,Chow; Bennett,6,0,32,26
1657234247902,MATH 142A,A02,083220,Chow; Bennett,10,0,32,22
1657234247902,MATH 142A,A03,093480,Chow; Bennett,7,0,32,25
1657234247902,MATH 142A,B03,093481,Chow; Bennett,8,0,32,24
1657234247902,MATH 142A,B04,093558,Chow; Bennett,12,0,32,20
1657234247902,MATH 142A,B05,093559,Chow; Bennett,6,0,32,26
1657234253927,MATH 193A,A01,083224,Rotar; Vladimir,7,0,34,27
1657234253927,MATH 193A,A02,083225,Rotar; Vladimir,6,0,34,28
1657234253927,MATH 193A,A03,083781,Rotar; Vladimir,2,0,34,32
1657234253927,MATH 193A,A04,083782,Rotar; Vladimir,8,0,34,26
1657234253927,MATH 193A,A05,093482,Rotar; Vladimir,6,0,34,28
1657234259953,MATH 197,001,091859,McAuley; Julian John,9999,0,9999,0
1657234259953,MATH 197,002,095566,Kedlaya; Kiran S.,9997,0,9999,2
1657234259953,MATH 197,003,095567,Xiao; Ming,9999,0,9999,0
1657234259953,MATH 197,004,095571,Perols; Johan Lars,9998,0,9999,1
1657234267033,COGS 9,A01,083615,Shannon; Kyle Michael,8,0,75,67
1657234273057,COGS 11,A01,083617,Boyle; Mary E. T.,22,0,48,26
1657234279084,COGS 13,A01,083071,Bastos; Amalia Pinkusfeld,8,0,71,63
1657234285113,COGS 14A,A01,092681,Semenuks; Arturs,2,1,100,98
1657234291134,COGS 14B,A01,083073,Cheng; Tzu-Han,6,0,63,57
1657234297158,COGS 17,A01,092677,Semenuks; Arturs,5,0,81,76
1657234303186,COGS 100,A01,083619,Allen; Michael Gordon,16,0,70,54
1657234309207,COGS 101A,A01,083621,Davis; Joshua Daniel,9,0,68,59
1657234315233,COGS 101B,A01,091572,Allen; Michael Gordon,11,0,65,54
1657234321257,COGS 101C,A01,083625,Delgado; Tania,17,0,35,18
1657234327285,COGS 107A,A01,083627,Boyle; Mary E. T.,13,0,60,47
1657234333310,COGS 118A,A01,083075,Gupta; Anjum,16,0,76,60
1657234339334,CSE 3,A50,083646,Miranda; Gregory Joseph,24,0,50,26
1657234345359,CSE 8A,A50,083650,Miranda; Gregory Joseph,17,1,56,39
1657234351384,CSE 11,A01,083080,Cao; Yingjun,5,15,40,35
1657234357410,CSE 12,A01,083652,Krause-Levy; Sophia Louisa,26,1,120,94
1657234363434,CSE 15L,A01,083654,Morris; Justin Loren,9,0,50,41
1657234363434,CSE 15L,A02,083655,Morris; Justin Loren,9,0,50,41
1657234369457,CSE 20,A01,083657,Tran; Khoa Dang,38,0,80,42
1657234375482,CSE 21,A01,095574,Bach; Quang Tran,22,0,48,26
1657234381509,CSE 30,A01,083084,Eldon; John,4,0,80,76
1657234381509,CSE 30,B01,095061,Bhaskar; Nishant,8,0,50,42
1657234387551,CSE 100,A01,083659,Cao; Yingjun,4,4,70,66
1657234393574,CSE 134B,A01,083661,Powell; Thomas Allan,21,0,100,79
1657234399613,CSE 140,A01,083663,Gungor; Onat,13,0,85,72
1657234405639,CSE 140L,A01,083088,Eldon; John,17,0,100,83
1657234411660,CSE 175,A01,083665,Kumar; Rakesh,3,0,25,22
1657234417682,CSE 190,A00,092507,Dubnov; Shlomo,7,0,20,13
1657234423707,ECE 45,A01,083139,Congero; Spencer William,5,0,75,70
1657234429729,ECE 65,A50,083695,Saad; Andrew S,12,0,30,18
1657234429729,ECE 65,A51,095125,Saad; Andrew S,25,0,26,1
1657234435755,ECE 109,A01,091882,Touri; Behrouz,19,0,70,51
1657234441778,ECE 180,A00,083140,Abi Samra; Nicholas Camill,1,0,30,29
1657234441778,ECE 180,B00,083141,Abi Samra; Nicholas Camill,0,0,30,30
1657234447802,MATH 10A,A01,083735,Patchell; Gregory David,2,0,30,28
1657234447802,MATH 10A,A02,083736,Patchell; Gregory David,20,0,30,10
1657234447802,MATH 10A,A03,083737,Patchell; Gregory David,16,0,30,14
1657234453826,MATH 10B,A01,083207,Lim; Seonhee,7,0,34,27
1657234453826,MATH 10B,A02,083208,Lim; Seonhee,9,0,35,26
1657234453826,MATH 10B,A03,093472,Lim; Seonhee,5,0,34,29
1657234453826,MATH 10B,B01,083739,Sinha; Shubham,11,0,30,19
1657234459849,MATH 18,A01,083743,Cinel; Cameron Alexander,6,0,30,24
1657234459849,MATH 18,A02,083744,Cinel; Cameron Alexander,17,0,30,13
1657234459849,MATH 18,A03,083745,Cinel; Cameron Alexander,8,0,30,22
1657234459849,MATH 18,B01,083748,Rideout; David Porter,4,0,37,33
1657234459849,MATH 18,B02,083749,Rideout; David Porter,4,0,36,32
1657234459849,MATH 18,B03,083750,Rideout; David Porter,2,0,37,35
1657234459849,MATH 18,B04,083751,Rideout; David Porter,6,0,36,30
1657234459849,MATH 18,B05,093473,Rideout; David Porter,5,0,36,31
1657234459849,MATH 18,B06,093474,Rideout; David Porter,5,0,36,31
1657234465875,MATH 20A,A01,083754,Zheng; Zequn,14,0,40,26
1657234471897,MATH 20B,A01,083756,Briones; Jor-el Thomas Caparas,3,0,36,33
1657234471897,MATH 20B,A02,083757,Briones; Jor-el Thomas Caparas,1,0,36,35
1657234471897,MATH 20B,A03,093475,Briones; Jor-el Thomas Caparas,2,0,36,34
1657234477926,MATH 20C,A01,083760,Briones; Jor-el Thomas Caparas,1,0,35,34
1657234477926,MATH 20C,A02,083761,Briones; Jor-el Thomas Caparas,8,0,35,27
1657234477926,MATH 20C,A03,093476,Briones; Jor-el Thomas Caparas,0,1,36,36
1657234477926,MATH 20C,B01,083762,Bach; Quang Tran,1,0,30,29
1657234483949,MATH 20D,A01,083765,Tran; Brian Kha,4,0,30,26
1657234483949,MATH 20D,A02,083766,Tran; Brian Kha,5,0,30,25
1657234483949,MATH 20D,A03,083767,Tran; Brian Kha,4,0,30,26
1657234489976,MATH 20E,A01,083771,Ganguly; Soumya,7,0,32,25
1657234489976,MATH 20E,A02,083772,Ganguly; Soumya,7,0,32,25
1657234489976,MATH 20E,B01,083773,Ciotti; Benjamin,19,0,35,16
1657234489976,MATH 20E,B02,083774,Ciotti; Benjamin,17,0,35,18
1657234496011,MATH 103A,A01,083777,Greenfeld; Be'Eri,3,0,36,33
1657234496011,MATH 103A,A02,083778,Greenfeld; Be'Eri,5,0,36,31
1657234496011,MATH 103A,A03,093561,Greenfeld; Be'Eri,4,0,36,32
1657234496011,MATH 103A,B01,083779,Greenfeld; Be'Eri,6,0,36,30
1657234496011,MATH 103A,B02,083780,Greenfeld; Be'Eri,3,0,36,33
1657234496011,MATH 103A,B03,093562,Greenfeld; Be'Eri,3,0,36,33
1657234502039,MATH 105,A01,085443,Carter; Anne Toulson,15,0,35,20
1657234502039,MATH 105,A02,093477,Carter; Anne Toulson,20,0,35,15
1657234508083,MATH 109,A01,083213,Ganzberger; Geoffrey Michael,2,0,34,32
1657234508083,MATH 109,A02,083214,Ganzberger; Geoffrey Michael,4,0,34,30
1657234508083,MATH 109,A03,093478,Ganzberger; Geoffrey Michael,2,0,34,32
1657234508083,MATH 109,B01,083215,Ganzberger; Geoffrey Michael,1,0,32,31
1657234508083,MATH 109,B02,083216,Ganzberger; Geoffrey Michael,1,0,32,31
1657234508083,MATH 109,B03,093479,Ganzberger; Geoffrey Michael,8,0,32,24
1657234514106,MATH 142A,A01,083219,Chow; Bennett,6,0,32,26
1657234514106,MATH 142A,A02,083220,Chow; Bennett,10,0,32,22
1657234514106,MATH 142A,A03,093480,Chow; Bennett,7,0,32,25
1657234514106,MATH 142A,B03,093481,Chow; Bennett,8,0,32,24
1657234514106,MATH 142A,B04,093558,Chow; Bennett,12,0,32,20
1657234514106,MATH 142A,B05,093559,Chow; Bennett,6,0,32,26
1657234520129,MATH 193A,A01,083224,Rotar; Vladimir,7,0,34,27
1657234520129,MATH 193A,A02,083225,Rotar; Vladimir,6,0,34,28
1657234520129,MATH 193A,A03,083781,Rotar; Vladimir,2,0,34,32
1657234520129,MATH 193A,A04,083782,Rotar; Vladimir,8,0,34,26
1657234520129,MATH 193A,A05,093482,Rotar; Vladimir,6,0,34,28
1657234526156,MATH 197,001,091859,McAuley; Julian John,9999,0,9999,0
1657234526156,MATH 197,002,095566,Kedlaya; Kiran S.,9997,0,9999,2
1657234526156,MATH 197,003,095567,Xiao; Ming,9999,0,9999,0
1657234526156,MATH 197,004,095571,Perols; Johan Lars,9998,0,9999,1
1657234533221,COGS 9,A01,083615,Shannon; Kyle Michael,8,0,75,67
1657234539246,COGS 11,A01,083617,Boyle; Mary E. T.,22,0,48,26
1657234545278,COGS 13,A01,083071,Bastos; Amalia Pinkusfeld,8,0,71,63
1657234551312,COGS 14A,A01,092681,Semenuks; Arturs,2,1,100,98
1657234557337,COGS 14B,A01,083073,Cheng; Tzu-Han,6,0,63,57
1657234563363,COGS 17,A01,092677,Semenuks; Arturs,5,0,81,76
1657234569388,COGS 100,A01,083619,Allen; Michael Gordon,16,0,70,54
1657234575411,COGS 101A,A01,083621,Davis; Joshua Daniel,9,0,68,59
1657234581434,COGS 101B,A01,091572,Allen; Michael Gordon,11,0,65,54
1657234587457,COGS 101C,A01,083625,Delgado; Tania,17,0,35,18
1657234593489,COGS 107A,A01,083627,Boyle; Mary E. T.,13,0,60,47
1657234599525,COGS 118A,A01,083075,Gupta; Anjum,16,0,76,60
1657234605547,CSE 3,A50,083646,Miranda; Gregory Joseph,24,0,50,26
1657234611570,CSE 8A,A50,083650,Miranda; Gregory Joseph,17,1,56,39
1657234617608,CSE 11,A01,083080,Cao; Yingjun,5,15,40,35
1657234623630,CSE 12,A01,083652,Krause-Levy; Sophia Louisa,26,1,120,94
1657234629659,CSE 15L,A01,083654,Morris; Justin Loren,9,0,50,41
1657234629659,CSE 15L,A02,083655,Morris; Justin Loren,9,0,50,41
1657234635700,CSE 20,A01,083657,Tran; Khoa Dang,38,0,80,42
1657234641724,CSE 21,A01,095574,Bach; Quang Tran,22,0,48,26
1657234647760,CSE 30,A01,083084,Eldon; John,4,0,80,76
1657234647760,CSE 30,B01,095061,Bhaskar; Nishant,8,0,50,42
1657234653784,CSE 100,A01,083659,Cao; Yingjun,4,4,70,66
1657234659816,CSE 134B,A01,083661,Powell; Thomas Allan,21,0,100,79
1657234665839,CSE 140,A01,083663,Gungor; Onat,13,0,85,72
1657234671865,CSE 140L,A01,083088,Eldon; John,17,0,100,83
1657234677889,CSE 175,A01,083665,Kumar; Rakesh,3,0,25,22
1657234683910,CSE 190,A00,092507,Dubnov; Shlomo,7,0,20,13
1657234689938,ECE 45,A01,083139,Congero; Spencer William,5,0,75,70
1657234695964,ECE 65,A50,083695,Saad; Andrew S,12,0,30,18
1657234695964,ECE 65,A51,095125,Saad; Andrew S,25,0,26,1
1657234701986,ECE 109,A01,091882,Touri; Behrouz,19,0,70,51
1657234708008,ECE 180,A00,083140,Abi Samra; Nicholas Camill,1,0,30,29
1657234708008,ECE 180,B00,083141,Abi Samra; Nicholas Camill,0,0,30,30
1657234714035,MATH 10A,A01,083735,Patchell; Gregory David,2,0,30,28
1657234714035,MATH 10A,A02,083736,Patchell; Gregory David,20,0,30,10
1657234714035,MATH 10A,A03,083737,Patchell; Gregory David,16,0,30,14
1657234720062,MATH 10B,A01,083207,Lim; Seonhee,7,0,34,27
1657234720062,MATH 10B,A02,083208,Lim; Seonhee,9,0,35,26
1657234720062,MATH 10B,A03,093472,Lim; Seonhee,5,0,34,29
1657234720062,MATH 10B,B01,083739,Sinha; Shubham,11,0,30,19
1657234726089,MATH 18,A01,083743,Cinel; Cameron Alexander,6,0,30,24
1657234726089,MATH 18,A02,083744,Cinel; Cameron Alexander,17,0,30,13
1657234726089,MATH 18,A03,083745,Cinel; Cameron Alexander,8,0,30,22
1657234726089,MATH 18,B01,083748,Rideout; David Porter,4,0,37,33
1657234726089,MATH 18,B02,083749,Rideout; David Porter,4,0,36,32
1657234726089,MATH 18,B03,083750,Rideout; David Porter,2,0,37,35
1657234726089,MATH 18,B04,083751,Rideout; David Porter,6,0,36,30
1657234726089,MATH 18,B05,093473,Rideout; David Porter,5,0,36,31
1657234726089,MATH 18,B06,093474,Rideout; David Porter,5,0,36,31
1657234732121,MATH 20A,A01,083754,Zheng; Zequn,14,0,40,26
1657234738149,MATH 20B,A01,083756,Briones; Jor-el Thomas Caparas,3,0,36,33
1657234738149,MATH 20B,A02,083757,Briones; Jor-el Thomas Caparas,1,0,36,35
1657234738149,MATH 20B,A03,093475,Briones; Jor-el Thomas Caparas,2,0,36,34
1657234744172,MATH 20C,A01,083760,Briones; Jor-el Thomas Caparas,1,0,35,34
1657234744172,MATH 20C,A02,083761,Briones; Jor-el Thomas Caparas,8,0,35,27
1657234744172,MATH 20C,A03,093476,Briones; Jor-el Thomas Caparas,0,1,36,36
1657234744172,MATH 20C,B01,083762,Bach; Quang Tran,1,0,30,29
1657234750202,MATH 20D,A01,083765,Tran; Brian Kha,4,0,30,26
1657234750202,MATH 20D,A02,083766,Tran; Brian Kha,5,0,30,25
1657234750202,MATH 20D,A03,083767,Tran; Brian Kha,4,0,30,26
1657234756238,MATH 20E,A01,083771,Ganguly; Soumya,7,0,32,25
1657234756238,MATH 20E,A02,083772,Ganguly; Soumya,7,0,32,25
1657234756238,MATH 20E,B01,083773,Ciotti; Benjamin,19,0,35,16
1657234756238,MATH 20E,B02,083774,Ciotti; Benjamin,17,0,35,18
1657234762262,MATH 103A,A01,083777,Greenfeld; Be'Eri,3,0,36,33
1657234762262,MATH 103A,A02,083778,Greenfeld; Be'Eri,5,0,36,31
1657234762262,MATH 103A,A03,093561,Greenfeld; Be'Eri,4,0,36,32
1657234762262,MATH 103A,B01,083779,Greenfeld; Be'Eri,6,0,36,30
1657234762262,MATH 103A,B02,083780,Greenfeld; Be'Eri,3,0,36,33
1657234762262,MATH 103A,B03,093562,Greenfeld; Be'Eri,3,0,36,33
1657234768293,MATH 105,A01,085443,Carter; Anne Toulson,15,0,35,20
1657234768293,MATH 105,A02,093477,Carter; Anne Toulson,20,0,35,15
1657234774321,MATH 109,A01,083213,Ganzberger; Geoffrey Michael,2,0,34,32
1657234774321,MATH 109,A02,083214,Ganzberger; Geoffrey Michael,4,0,34,30
1657234774321,MATH 109,A03,093478,Ganzberger; Geoffrey Michael,2,0,34,32
1657234774321,MATH 109,B01,083215,Ganzberger; Geoffrey Michael,1,0,32,31
1657234774321,MATH 109,B02,083216,Ganzberger; Geoffrey Michael,1,0,32,31
1657234774321,MATH 109,B03,093479,Ganzberger; Geoffrey Michael,8,0,32,24
1657234780351,MATH 142A,A01,083219,Chow; Bennett,6,0,32,26
1657234780351,MATH 142A,A02,083220,Chow; Bennett,10,0,32,22
1657234780351,MATH 142A,A03,093480,Chow; Bennett,7,0,32,25
1657234780351,MATH 142A,B03,093481,Chow; Bennett,8,0,32,24
1657234780351,MATH 142A,B04,093558,Chow; Bennett,12,0,32,20
1657234780351,MATH 142A,B05,093559,Chow; Bennett,6,0,32,26
1657234786374,MATH 193A,A01,083224,Rotar; Vladimir,7,0,34,27
1657234786374,MATH 193A,A02,083225,Rotar; Vladimir,6,0,34,28
1657234786374,MATH 193A,A03,083781,Rotar; Vladimir,2,0,34,32
1657234786374,MATH 193A,A04,083782,Rotar; Vladimir,8,0,34,26
1657234786374,MATH 193A,A05,093482,Rotar; Vladimir,6,0,34,28
1657234792400,MATH 197,001,091859,McAuley; Julian John,9999,0,9999,0
1657234792400,MATH 197,002,095566,Kedlaya; Kiran S.,9997,0,9999,2
1657234792400,MATH 197,003,095567,Xiao; Ming,9999,0,9999,0
1657234792400,MATH 197,004,095571,Perols; Johan Lars,9998,0,9999,1
1657234799472,COGS 9,A01,083615,Shannon; Kyle Michael,8,0,75,67
1657234805574,COGS 11,A01,083617,Boyle; Mary E. T.,22,0,48,26
1657234811600,COGS 13,A01,083071,Bastos; Amalia Pinkusfeld,8,0,71,63
1657234817621,COGS 14A,A01,092681,Semenuks; Arturs,2,1,100,98
1657234823644,COGS 14B,A01,083073,Cheng; Tzu-Han,6,0,63,57
1657234829682,COGS 17,A01,092677,Semenuks; Arturs,5,0,81,76
1657234835704,COGS 100,A01,083619,Allen; Michael Gordon,16,0,70,54
1657234841726,COGS 101A,A01,083621,Davis; Joshua Daniel,9,0,68,59
1657234847756,COGS 101B,A01,091572,Allen; Michael Gordon,11,0,65,54
1657234853778,COGS 101C,A01,083625,Delgado; Tania,17,0,35,18
1657234859799,COGS 107A,A01,083627,Boyle; Mary E. T.,13,0,60,47
1657234865829,COGS 118A,A01,083075,Gupta; Anjum,16,0,76,60
1657234871852,CSE 3,A50,083646,Miranda; Gregory Joseph,24,0,50,26
1657234877882,CSE 8A,A50,083650,Miranda; Gregory Joseph,17,1,56,39
1657234883905,CSE 11,A01,083080,Cao; Yingjun,5,15,40,35
1657234889933,CSE 12,A01,083652,Krause-Levy; Sophia Louisa,26,1,120,94
1657234895956,CSE 15L,A01,083654,Morris; Justin Loren,9,0,50,41
1657234895956,CSE 15L,A02,083655,Morris; Justin Loren,9,0,50,41
1657234901981,CSE 20,A01,083657,Tran; Khoa Dang,38,0,80,42
1657234908008,CSE 21,A01,095574,Bach; Quang Tran,22,0,48,26
1657234914033,CSE 30,A01,083084,Eldon; John,4,0,80,76
1657234914033,CSE 30,B01,095061,Bhaskar; Nishant,8,0,50,42
1657234920057,CSE 100,A01,083659,Cao; Yingjun,4,4,70,66
1657234926084,CSE 134B,A01,083661,Powell; Thomas Allan,21,0,100,79
1657234932108,CSE 140,A01,083663,Gungor; Onat,13,0,85,72
1657234938134,CSE 140L,A01,083088,Eldon; John,17,0,100,83
1657234944158,CSE 175,A01,083665,Kumar; Rakesh,3,0,25,22
1657234950185,CSE 190,A00,092507,Dubnov; Shlomo,7,0,20,13
1657234956218,ECE 45,A01,083139,Congero; Spencer William,5,0,75,70
1657234962241,ECE 65,A50,083695,Saad; Andrew S,12,0,30,18
1657234962241,ECE 65,A51,095125,Saad; Andrew S,25,0,26,1
1657234968273,ECE 109,A01,091882,Touri; Behrouz,19,0,70,51
1657234974300,ECE 180,A00,083140,Abi Samra; Nicholas Camill,1,0,30,29
1657234974300,ECE 180,B00,083141,Abi Samra; Nicholas Camill,0,0,30,30
1657234980327,MATH 10A,A01,083735,Patchell; Gregory David,2,0,30,28
1657234980327,MATH 10A,A02,083736,Patchell; Gregory David,20,0,30,10
1657234980327,MATH 10A,A03,083737,Patchell; Gregory David,16,0,30,14
1657234986369,MATH 10B,A01,083207,Lim; Seonhee,7,0,34,27
1657234986369,MATH 10B,A02,083208,Lim; Seonhee,9,0,35,26
1657234986369,MATH 10B,A03,093472,Lim; Seonhee,5,0,34,29
1657234986369,MATH 10B,B01,083739,Sinha; Shubham,11,0,30,19
1657234992392,MATH 18,A01,083743,Cinel; Cameron Alexander,6,0,30,24
1657234992392,MATH 18,A02,083744,Cinel; Cameron Alexander,17,0,30,13
1657234992392,MATH 18,A03,083745,Cinel; Cameron Alexander,8,0,30,22
1657234992392,MATH 18,B01,083748,Rideout; David Porter,4,0,37,33
1657234992392,MATH 18,B02,083749,Rideout; David Porter,4,0,36,32
1657234992392,MATH 18,B03,083750,Rideout; David Porter,2,0,37,35
1657234992392,MATH 18,B04,083751,Rideout; David Porter,6,0,36,30
1657234992392,MATH 18,B05,093473,Rideout; David Porter,5,0,36,31
1657234992392,MATH 18,B06,093474,Rideout; David Porter,5,0,36,31
1657234998413,MATH 20A,A01,083754,Zheng; Zequn,14,0,40,26
1657235004440,MATH 20B,A01,083756,Briones; Jor-el Thomas Caparas,3,0,36,33
1657235004440,MATH 20B,A02,083757,Briones; Jor-el Thomas Caparas,1,0,36,35
1657235004440,MATH 20B,A03,093475,Briones; Jor-el Thomas Caparas,2,0,36,34
1657235010473,MATH 20C,A01,083760,Briones; Jor-el Thomas Caparas,1,0,35,34
1657235010473,MATH 20C,A02,083761,Briones; Jor-el Thomas Caparas,8,0,35,27
1657235010473,MATH 20C,A03,093476,Briones; Jor-el Thomas Caparas,0,1,36,36
1657235010473,MATH 20C,B01,083762,Bach; Quang Tran,1,0,30,29
1657235016501,MATH 20D,A01,083765,Tran; Brian Kha,4,0,30,26
1657235016501,MATH 20D,A02,083766,Tran; Brian Kha,5,0,30,25
1657235016501,MATH 20D,A03,083767,Tran; Brian Kha,4,0,30,26
1657235022526,MATH 20E,A01,083771,Ganguly; Soumya,7,0,32,25
1657235022526,MATH 20E,A02,083772,Ganguly; Soumya,7,0,32,25
1657235022526,MATH 20E,B01,083773,Ciotti; Benjamin,19,0,35,16
1657235022526,MATH 20E,B02,083774,Ciotti; Benjamin,17,0,35,18
1657235028560,MATH 103A,A01,083777,Greenfeld; Be'Eri,3,0,36,33
1657235028560,MATH 103A,A02,083778,Greenfeld; Be'Eri,5,0,36,31
1657235028560,MATH 103A,A03,093561,Greenfeld; Be'Eri,4,0,36,32
1657235028560,MATH 103A,B01,083779,Greenfeld; Be'Eri,6,0,36,30
1657235028560,MATH 103A,B02,083780,Greenfeld; Be'Eri,3,0,36,33
1657235028560,MATH 103A,B03,093562,Greenfeld; Be'Eri,3,0,36,33
1657235034588,MATH 105,A01,085443,Carter; Anne Toulson,15,0,35,20
1657235034588,MATH 105,A02,093477,Carter; Anne Toulson,20,0,35,15
1657235040613,MATH 109,A01,083213,Ganzberger; Geoffrey Michael,2,0,34,32
1657235040613,MATH 109,A02,083214,Ganzberger; Geoffrey Michael,4,0,34,30
1657235040613,MATH 109,A03,093478,Ganzberger; Geoffrey Michael,2,0,34,32
1657235040613,MATH 109,B01,083215,Ganzberger; Geoffrey Michael,1,0,32,31
1657235040613,MATH 109,B02,083216,Ganzberger; Geoffrey Michael,1,0,32,31
1657235040613,MATH 109,B03,093479,Ganzberger; Geoffrey Michael,8,0,32,24
1657235046637,MATH 142A,A01,083219,Chow; Bennett,6,0,32,26
1657235046637,MATH 142A,A02,083220,Chow; Bennett,10,0,32,22
1657235046637,MATH 142A,A03,093480,Chow; Bennett,7,0,32,25
1657235046637,MATH 142A,B03,093481,Chow; Bennett,8,0,32,24
1657235046637,MATH 142A,B04,093558,Chow; Bennett,12,0,32,20
1657235046637,MATH 142A,B05,093559,Chow; Bennett,6,0,32,26
1657235052661,MATH 193A,A01,083224,Rotar; Vladimir,7,0,34,27
1657235052661,MATH 193A,A02,083225,Rotar; Vladimir,6,0,34,28
1657235052661,MATH 193A,A03,083781,Rotar; Vladimir,2,0,34,32
1657235052661,MATH 193A,A04,083782,Rotar; Vladimir,8,0,34,26
1657235052661,MATH 193A,A05,093482,Rotar; Vladimir,6,0,34,28
1657235058683,MATH 197,001,091859,McAuley; Julian John,9999,0,9999,0
1657235058683,MATH 197,002,095566,Kedlaya; Kiran S.,9997,0,9999,2
1657235058683,MATH 197,003,095567,Xiao; Ming,9999,0,9999,0
1657235058683,MATH 197,004,095571,Perols; Johan Lars,9998,0,9999,1
1657235065750,COGS 9,A01,083615,Shannon; Kyle Michael,8,0,75,67
1657235071781,COGS 11,A01,083617,Boyle; Mary E. T.,22,0,48,26
1657235077802,COGS 13,A01,083071,Bastos; Amalia Pinkusfeld,8,0,71,63
1657235083824,COGS 14A,A01,092681,Semenuks; Arturs,2,1,100,98
1657235089846,COGS 14B,A01,083073,Cheng; Tzu-Han,6,0,63,57
1657235095872,COGS 17,A01,092677,Semenuks; Arturs,5,0,81,76
1657235101896,COGS 100,A01,083619,Allen; Michael Gordon,16,0,70,54
1657235107918,COGS 101A,A01,083621,Davis; Joshua Daniel,9,0,68,59
1657235113945,COGS 101B,A01,091572,Allen; Michael Gordon,11,0,65,54
1657235119968,COGS 101C,A01,083625,Delgado; Tania,17,0,35,18
1657235125997,COGS 107A,A01,083627,Boyle; Mary E. T.,13,0,60,47
1657235132029,COGS 118A,A01,083075,Gupta; Anjum,16,0,76,60
1657235138065,CSE 3,A50,083646,Miranda; Gregory Joseph,24,0,50,26
1657235144092,CSE 8A,A50,083650,Miranda; Gregory Joseph,17,1,56,39
1657235150115,CSE 11,A01,083080,Cao; Yingjun,5,15,40,35
1657235156156,CSE 12,A01,083652,Krause-Levy; Sophia Louisa,26,1,120,94
1657235162180,CSE 15L,A01,083654,Morris; Justin Loren,9,0,50,41
1657235162180,CSE 15L,A02,083655,Morris; Justin Loren,9,0,50,41
1657235168206,CSE 20,A01,083657,Tran; Khoa Dang,38,0,80,42
1657235174229,CSE 21,A01,095574,Bach; Quang Tran,22,0,48,26
1657235180254,CSE 30,A01,083084,Eldon; John,4,0,80,76
1657235180254,CSE 30,B01,095061,Bhaskar; Nishant,8,0,50,42
1657235186279,CSE 100,A01,083659,Cao; Yingjun,4,4,70,66
1657235192304,CSE 134B,A01,083661,Powell; Thomas Allan,21,0,100,79
1657235198331,CSE 140,A01,083663,Gungor; Onat,13,0,85,72
1657235204355,CSE 140L,A01,083088,Eldon; John,17,0,100,83
1657235210382,CSE 175,A01,083665,Kumar; Rakesh,3,0,25,22
1657235216404,CSE 190,A00,092507,Dubnov; Shlomo,7,0,20,13
1657235222430,ECE 45,A01,083139,Congero; Spencer William,5,0,75,70
1657235228459,ECE 65,A50,083695,Saad; Andrew S,12,0,30,18
1657235228459,ECE 65,A51,095125,Saad; Andrew S,25,0,26,1
1657235234484,ECE 109,A01,091882,Touri; Behrouz,19,0,70,51
1657235240508,ECE 180,A00,083140,Abi Samra; Nicholas Camill,1,0,30,29
1657235240508,ECE 180,B00,083141,Abi Samra; Nicholas Camill,0,0,30,30
1657235246535,MATH 10A,A01,083735,Patchell; Gregory David,2,0,30,28
1657235246535,MATH 10A,A02,083736,Patchell; Gregory David,20,0,30,10
1657235246535,MATH 10A,A03,083737,Patchell; Gregory David,16,0,30,14
1657235252562,MATH 10B,A01,083207,Lim; Seonhee,7,0,34,27
1657235252562,MATH 10B,A02,083208,Lim; Seonhee,9,0,35,26
1657235252562,MATH 10B,A03,093472,Lim; Seonhee,5,0,34,29
1657235252562,MATH 10B,B01,083739,Sinha; Shubham,11,0,30,19
1657235258588,MATH 18,A01,083743,Cinel; Cameron Alexander,6,0,30,24
1657235258588,MATH 18,A02,083744,Cinel; Cameron Alexander,17,0,30,13
1657235258588,MATH 18,A03,083745,Cinel; Cameron Alexander,8,0,30,22
1657235258588,MATH 18,B01,083748,Rideout; David Porter,4,0,37,33
1657235258588,MATH 18,B02,083749,Rideout; David Porter,4,0,36,32
1657235258588,MATH 18,B03,083750,Rideout; David Porter,2,0,37,35
1657235258588,MATH 18,B04,083751,Rideout; David Porter,6,0,36,30
1657235258588,MATH 18,B05,093473,Rideout; David Porter,5,0,36,31
1657235258588,MATH 18,B06,093474,Rideout; David Porter,5,0,36,31
1657235264615,MATH 20A,A01,083754,Zheng; Zequn,14,0,40,26
1657235270639,MATH 20B,A01,083756,Briones; Jor-el Thomas Caparas,3,0,36,33
1657235270639,MATH 20B,A02,083757,Briones; Jor-el Thomas Caparas,1,0,36,35
1657235270639,MATH 20B,A03,093475,Briones; Jor-el Thomas Caparas,2,0,36,34
1657235276673,MATH 20C,A01,083760,Briones; Jor-el Thomas Caparas,1,0,35,34
1657235276673,MATH 20C,A02,083761,Briones; Jor-el Thomas Caparas,8,0,35,27
1657235276673,MATH 20C,A03,093476,Briones; Jor-el Thomas Caparas,0,1,36,36
1657235276673,MATH 20C,B01,083762,Bach; Quang Tran,1,0,30,29
1657235282698,MATH 20D,A01,083765,Tran; Brian Kha,4,0,30,26
1657235282698,MATH 20D,A02,083766,Tran; Brian Kha,5,0,30,25
1657235282698,MATH 20D,A03,083767,Tran; Brian Kha,4,0,30,26
1657235288726,MATH 20E,A01,083771,Ganguly; Soumya,7,0,32,25
1657235288726,MATH 20E,A02,083772,Ganguly; Soumya,7,0,32,25
1657235288726,MATH 20E,B01,083773,Ciotti; Benjamin,19,0,35,16
1657235288726,MATH 20E,B02,083774,Ciotti; Benjamin,17,0,35,18
1657235294767,MATH 103A,A01,083777,Greenfeld; Be'Eri,3,0,36,33
1657235294767,MATH 103A,A02,083778,Greenfeld; Be'Eri,5,0,36,31
1657235294767,MATH 103A,A03,093561,Greenfeld; Be'Eri,4,0,36,32
1657235294767,MATH 103A,B01,083779,Greenfeld; Be'Eri,6,0,36,30
1657235294767,MATH 103A,B02,083780,Greenfeld; Be'Eri,3,0,36,33
1657235294767,MATH 103A,B03,093562,Greenfeld; Be'Eri,3,0,36,33
1657235300789,MATH 105,A01,085443,Carter; Anne Toulson,15,0,35,20
1657235300789,MATH 105,A02,093477,Carter; Anne Toulson,20,0,35,15
1657235306813,MATH 109,A01,083213,Ganzberger; Geoffrey Michael,2,0,34,32
1657235306813,MATH 109,A02,083214,Ganzberger; Geoffrey Michael,4,0,34,30
1657235306813,MATH 109,A03,093478,Ganzberger; Geoffrey Michael,2,0,34,32
1657235306813,MATH 109,B01,083215,Ganzberger; Geoffrey Michael,1,0,32,31
1657235306813,MATH 109,B02,083216,Ganzberger; Geoffrey Michael,1,0,32,31
1657235306813,MATH 109,B03,093479,Ganzberger; Geoffrey Michael,8,0,32,24
1657235312843,MATH 142A,A01,083219,Chow; Bennett,6,0,32,26
1657235312843,MATH 142A,A02,083220,Chow; Bennett,10,0,32,22
1657235312843,MATH 142A,A03,093480,Chow; Bennett,7,0,32,25
1657235312843,MATH 142A,B03,093481,Chow; Bennett,8,0,32,24
1657235312843,MATH 142A,B04,093558,Chow; Bennett,12,0,32,20
1657235312843,MATH 142A,B05,093559,Chow; Bennett,6,0,32,26
1657235318875,MATH 193A,A01,083224,Rotar; Vladimir,7,0,34,27
1657235318875,MATH 193A,A02,083225,Rotar; Vladimir,6,0,34,28
1657235318875,MATH 193A,A03,083781,Rotar; Vladimir,2,0,34,32
1657235318875,MATH 193A,A04,083782,Rotar; Vladimir,8,0,34,26
1657235318875,MATH 193A,A05,093482,Rotar; Vladimir,6,0,34,28
1657235324904,MATH 197,001,091859,McAuley; Julian John,9999,0,9999,0
1657235324904,MATH 197,002,095566,Kedlaya; Kiran S.,9997,0,9999,2
1657235324904,MATH 197,003,095567,Xiao; Ming,9999,0,9999,0
1657235324904,MATH 197,004,095571,Perols; Johan Lars,9998,0,9999,1
1657235331976,COGS 9,A01,083615,Shannon; Kyle Michael,8,0,75,67
1657235337999,COGS 11,A01,083617,Boyle; Mary E. T.,22,0,48,26
1657235344026,COGS 13,A01,083071,Bastos; Amalia Pinkusfeld,8,0,71,63
1657235350048,COGS 14A,A01,092681,Semenuks; Arturs,2,1,100,98
1657235356075,COGS 14B,A01,083073,Cheng; Tzu-Han,6,0,63,57
1657235362099,COGS 17,A01,092677,Semenuks; Arturs,5,0,81,76
1657235368125,COGS 100,A01,083619,Allen; Michael Gordon,16,0,70,54
1657235374149,COGS 101A,A01,083621,Davis; Joshua Daniel,9,0,68,59
1657235380180,COGS 101B,A01,091572,Allen; Michael Gordon,11,0,65,54
1657235386210,COGS 101C,A01,083625,Delgado; Tania,17,0,35,18
1657235392269,COGS 107A,A01,083627,Boyle; Mary E. T.,13,0,60,47
1657235398297,COGS 118A,A01,083075,Gupta; Anjum,16,0,76,60
1657235404395,CSE 3,A50,083646,Miranda; Gregory Joseph,24,0,50,26
1657235410418,CSE 8A,A50,083650,Miranda; Gregory Joseph,17,1,56,39
1657235416441,CSE 11,A01,083080,Cao; Yingjun,5,15,40,35
1657235422470,CSE 12,A01,083652,Krause-Levy; Sophia Louisa,26,1,120,94
1657235428494,CSE 15L,A01,083654,Morris; Justin Loren,9,0,50,41
1657235428494,CSE 15L,A02,083655,Morris; Justin Loren,9,0,50,41
1657235434520,CSE 20,A01,083657,Tran; Khoa Dang,38,0,80,42
1657235440546,CSE 21,A01,095574,Bach; Quang Tran,22,0,48,26
1657235446575,CSE 30,A01,083084,Eldon; John,4,0,80,76
1657235446575,CSE 30,B01,095061,Bhaskar; Nishant,8,0,50,42
1657235452598,CSE 100,A01,083659,Cao; Yingjun,4,4,70,66
1657235458623,CSE 134B,A01,083661,Powell; Thomas Allan,21,0,100,79
1657235464651,CSE 140,A01,083663,Gungor; Onat,13,0,85,72
1657235470689,CSE 140L,A01,083088,Eldon; John,17,0,100,83
1657235476725,CSE 175,A01,083665,Kumar; Rakesh,3,0,25,22
1657235482747,CSE 190,A00,092507,Dubnov; Shlomo,7,0,20,13
1657235488772,ECE 45,A01,083139,Congero; Spencer William,5,0,75,70
1657235494795,ECE 65,A50,083695,Saad; Andrew S,12,0,30,18
1657235494795,ECE 65,A51,095125,Saad; Andrew S,25,0,26,1
1657235500820,ECE 109,A01,091882,Touri; Behrouz,19,0,70,51
1657235506846,ECE 180,A00,083140,Abi Samra; Nicholas Camill,1,0,30,29
1657235506846,ECE 180,B00,083141,Abi Samra; Nicholas Camill,0,0,30,30
1657235512875,MATH 10A,A01,083735,Patchell; Gregory David,2,0,30,28
1657235512875,MATH 10A,A02,083736,Patchell; Gregory David,20,0,30,10
1657235512875,MATH 10A,A03,083737,Patchell; Gregory David,16,0,30,14
1657235518898,MATH 10B,A01,083207,Lim; Seonhee,7,0,34,27
1657235518898,MATH 10B,A02,083208,Lim; Seonhee,9,0,35,26
1657235518898,MATH 10B,A03,093472,Lim; Seonhee,5,0,34,29
1657235518898,MATH 10B,B01,083739,Sinha; Shubham,11,0,30,19
1657235524929,MATH 18,A01,083743,Cinel; Cameron Alexander,6,0,30,24
1657235524929,MATH 18,A02,083744,Cinel; Cameron Alexander,17,0,30,13
1657235524929,MATH 18,A03,083745,Cinel; Cameron Alexander,8,0,30,22
1657235524929,MATH 18,B01,083748,Rideout; David Porter,4,0,37,33
1657235524929,MATH 18,B02,083749,Rideout; David Porter,4,0,36,32
1657235524929,MATH 18,B03,083750,Rideout; David Porter,2,0,37,35
1657235524929,MATH 18,B04,083751,Rideout; David Porter,6,0,36,30
1657235524929,MATH 18,B05,093473,Rideout; David Porter,5,0,36,31
1657235524929,MATH 18,B06,093474,Rideout; David Porter,5,0,36,31
1657235530951,MATH 20A,A01,083754,Zheng; Zequn,14,0,40,26
1657235536977,MATH 20B,A01,083756,Briones; Jor-el Thomas Caparas,3,0,36,33
1657235536977,MATH 20B,A02,083757,Briones; Jor-el Thomas Caparas,1,0,36,35
1657235536977,MATH 20B,A03,093475,Briones; Jor-el Thomas Caparas,2,0,36,34
1657235543004,MATH 20C,A01,083760,Briones; Jor-el Thomas Caparas,1,0,35,34
1657235543004,MATH 20C,A02,083761,Briones; Jor-el Thomas Caparas,8,0,35,27
1657235543004,MATH 20C,A03,093476,Briones; Jor-el Thomas Caparas,0,1,36,36
1657235543004,MATH 20C,B01,083762,Bach; Quang Tran,1,0,30,29
1657235549033,MATH 20D,A01,083765,Tran; Brian Kha,4,0,30,26
1657235549033,MATH 20D,A02,083766,Tran; Brian Kha,5,0,30,25
1657235549033,MATH 20D,A03,083767,Tran; Brian Kha,4,0,30,26
1657235555060,MATH 20E,A01,083771,Ganguly; Soumya,7,0,32,25
1657235555060,MATH 20E,A02,083772,Ganguly; Soumya,7,0,32,25
1657235555060,MATH 20E,B01,083773,Ciotti; Benjamin,19,0,35,16
1657235555060,MATH 20E,B02,083774,Ciotti; Benjamin,17,0,35,18
1657235561095,MATH 103A,A01,083777,Greenfeld; Be'Eri,3,0,36,33
1657235561095,MATH 103A,A02,083778,Greenfeld; Be'Eri,5,0,36,31
1657235561095,MATH 103A,A03,093561,Greenfeld; Be'Eri,4,0,36,32
1657235561095,MATH 103A,B01,083779,Greenfeld; Be'Eri,6,0,36,30
1657235561095,MATH 103A,B02,083780,Greenfeld; Be'Eri,3,0,36,33
1657235561095,MATH 103A,B03,093562,Greenfeld; Be'Eri,3,0,36,33
1657235567122,MATH 105,A01,085443,Carter; Anne Toulson,15,0,35,20
1657235567122,MATH 105,A02,093477,Carter; Anne Toulson,20,0,35,15
1657235573160,MATH 109,A01,083213,Ganzberger; Geoffrey Michael,2,0,34,32
1657235573160,MATH 109,A02,083214,Ganzberger; Geoffrey Michael,4,0,34,30
1657235573160,MATH 109,A03,093478,Ganzberger; Geoffrey Michael,2,0,34,32
1657235573160,MATH 109,B01,083215,Ganzberger; Geoffrey Michael,1,0,32,31
1657235573160,MATH 109,B02,083216,Ganzberger; Geoffrey Michael,1,0,32,31
1657235573160,MATH 109,B03,093479,Ganzberger; Geoffrey Michael,8,0,32,24
1657235579198,MATH 142A,A01,083219,Chow; Bennett,6,0,32,26
1657235579198,MATH 142A,A02,083220,Chow; Bennett,10,0,32,22
1657235579198,MATH 142A,A03,093480,Chow; Bennett,7,0,32,25
1657235579198,MATH 142A,B03,093481,Chow; Bennett,8,0,32,24
1657235579198,MATH 142A,B04,093558,Chow; Bennett,12,0,32,20
1657235579198,MATH 142A,B05,093559,Chow; Bennett,6,0,32,26
1657235585222,MATH 193A,A01,083224,Rotar; Vladimir,7,0,34,27
1657235585222,MATH 193A,A02,083225,Rotar; Vladimir,6,0,34,28
1657235585222,MATH 193A,A03,083781,Rotar; Vladimir,2,0,34,32
1657235585222,MATH 193A,A04,083782,Rotar; Vladimir,8,0,34,26
1657235585222,MATH 193A,A05,093482,Rotar; Vladimir,6,0,34,28
1657235591247,MATH 197,001,091859,McAuley; Julian John,9999,0,9999,0
1657235591247,MATH 197,002,095566,Kedlaya; Kiran S.,9997,0,9999,2
1657235591247,MATH 197,003,095567,Xiao; Ming,9999,0,9999,0
1657235591247,MATH 197,004,095571,Perols; Johan Lars,9998,0,9999,1
1657235598317,COGS 9,A01,083615,Shannon; Kyle Michael,8,0,75,67
1657235604344,COGS 11,A01,083617,Boyle; Mary E. T.,22,0,48,26
1657235610373,COGS 13,A01,083071,Bastos; Amalia Pinkusfeld,8,0,71,63
1657235616409,COGS 14A,A01,092681,Semenuks; Arturs,2,1,100,98
1657235622435,COGS 14B,A01,083073,Cheng; Tzu-Han,6,0,63,57
1657235628461,COGS 17,A01,092677,Semenuks; Arturs,5,0,81,76
1657235634483,COGS 100,A01,083619,Allen; Michael Gordon,16,0,70,54
1657235640515,COGS 101A,A01,083621,Davis; Joshua Daniel,9,0,68,59
1657235646541,COGS 101B,A01,091572,Allen; Michael Gordon,11,0,65,54
1657235652576,COGS 101C,A01,083625,Delgado; Tania,17,0,35,18
1657235658613,COGS 107A,A01,083627,Boyle; Mary E. T.,13,0,60,47
1657235664635,COGS 118A,A01,083075,Gupta; Anjum,16,0,76,60
1657235670660,CSE 3,A50,083646,Miranda; Gregory Joseph,24,0,50,26
1657235676683,CSE 8A,A50,083650,Miranda; Gregory Joseph,17,1,56,39
1657235682706,CSE 11,A01,083080,Cao; Yingjun,5,15,40,35
1657235688732,CSE 12,A01,083652,Krause-Levy; Sophia Louisa,26,1,120,94
1657235694755,CSE 15L,A01,083654,Morris; Justin Loren,9,0,50,41
1657235694755,CSE 15L,A02,083655,Morris; Justin Loren,9,0,50,41
1657235700779,CSE 20,A01,083657,Tran; Khoa Dang,38,0,80,42
1657235706807,CSE 21,A01,095574,Bach; Quang Tran,22,0,48,26
1657235712830,CSE 30,A01,083084,Eldon; John,4,0,80,76
1657235712830,CSE 30,B01,095061,Bhaskar; Nishant,8,0,50,42
1657235718856,CSE 100,A01,083659,Cao; Yingjun,4,4,70,66
1657235724883,CSE 134B,A01,083661,Powell; Thomas Allan,21,0,100,79
1657235730905,CSE 140,A01,083663,Gungor; Onat,13,0,85,72
1657235736933,CSE 140L,A01,083088,Eldon; John,17,0,100,83
1657235742960,CSE 175,A01,083665,Kumar; Rakesh,3,0,25,22
1657235748982,CSE 190,A00,092507,Dubnov; Shlomo,7,0,20,13
1657235755012,ECE 45,A01,083139,Congero; Spencer William,5,0,75,70
1657235761037,ECE 65,A50,083695,Saad; Andrew S,12,0,30,18
1657235761037,ECE 65,A51,095125,Saad; Andrew S,25,0,26,1
1657235767061,ECE 109,A01,091882,Touri; Behrouz,19,0,70,51
1657235773092,ECE 180,A00,083140,Abi Samra; Nicholas Camill,1,0,30,29
1657235773092,ECE 180,B00,083141,Abi Samra; Nicholas Camill,0,0,30,30
1657235779114,MATH 10A,A01,083735,Patchell; Gregory David,2,0,30,28
1657235779114,MATH 10A,A02,083736,Patchell; Gregory David,20,0,30,10
1657235779114,MATH 10A,A03,083737,Patchell; Gregory David,16,0,30,14
1657235785138,MATH 10B,A01,083207,Lim; Seonhee,7,0,34,27
1657235785138,MATH 10B,A02,083208,Lim; Seonhee,9,0,35,26
1657235785138,MATH 10B,A03,093472,Lim; Seonhee,5,0,34,29
1657235785138,MATH 10B,B01,083739,Sinha; Shubham,11,0,30,19
1657235791168,MATH 18,A01,083743,Cinel; Cameron Alexander,6,0,30,24
1657235791168,MATH 18,A02,083744,Cinel; Cameron Alexander,17,0,30,13
1657235791168,MATH 18,A03,083745,Cinel; Cameron Alexander,8,0,30,22
1657235791168,MATH 18,B01,083748,Rideout; David Porter,4,0,37,33
1657235791168,MATH 18,B02,083749,Rideout; David Porter,4,0,36,32
1657235791168,MATH 18,B03,083750,Rideout; David Porter,2,0,37,35
1657235791168,MATH 18,B04,083751,Rideout; David Porter,6,0,36,30
1657235791168,MATH 18,B05,093473,Rideout; David Porter,5,0,36,31
1657235791168,MATH 18,B06,093474,Rideout; David Porter,5,0,36,31
1657235797189,MATH 20A,A01,083754,Zheng; Zequn,14,0,40,26
1657235803213,MATH 20B,A01,083756,Briones; Jor-el Thomas Caparas,3,0,36,33
1657235803213,MATH 20B,A02,083757,Briones; Jor-el Thomas Caparas,1,0,36,35
1657235803213,MATH 20B,A03,093475,Briones; Jor-el Thomas Caparas,2,0,36,34
1657235809238,MATH 20C,A01,083760,Briones; Jor-el Thomas Caparas,1,0,35,34
1657235809238,MATH 20C,A02,083761,Briones; Jor-el Thomas Caparas,8,0,35,27
1657235809238,MATH 20C,A03,093476,Briones; Jor-el Thomas Caparas,0,1,36,36
1657235809238,MATH 20C,B01,083762,Bach; Quang Tran,1,0,30,29
1657235815260,MATH 20D,A01,083765,Tran; Brian Kha,4,0,30,26
1657235815260,MATH 20D,A02,083766,Tran; Brian Kha,5,0,30,25
1657235815260,MATH 20D,A03,083767,Tran; Brian Kha,4,0,30,26
1657235821287,MATH 20E,A01,083771,Ganguly; Soumya,7,0,32,25
1657235821287,MATH 20E,A02,083772,Ganguly; Soumya,7,0,32,25
1657235821287,MATH 20E,B01,083773,Ciotti; Benjamin,19,0,35,16
1657235821287,MATH 20E,B02,083774,Ciotti; Benjamin,17,0,35,18
1657235827310,MATH 103A,A01,083777,Greenfeld; Be'Eri,3,0,36,33
1657235827310,MATH 103A,A02,083778,Greenfeld; Be'Eri,5,0,36,31
1657235827310,MATH 103A,A03,093561,Greenfeld; Be'Eri,4,0,36,32
1657235827310,MATH 103A,B01,083779,Greenfeld; Be'Eri,6,0,36,30
1657235827310,MATH 103A,B02,083780,Greenfeld; Be'Eri,3,0,36,33
1657235827310,MATH 103A,B03,093562,Greenfeld; Be'Eri,3,0,36,33
1657235833336,MATH 105,A01,085443,Carter; Anne Toulson,15,0,35,20
1657235833336,MATH 105,A02,093477,Carter; Anne Toulson,20,0,35,15
1657235839359,MATH 109,A01,083213,Ganzberger; Geoffrey Michael,2,0,34,32
1657235839359,MATH 109,A02,083214,Ganzberger; Geoffrey Michael,4,0,34,30
1657235839359,MATH 109,A03,093478,Ganzberger; Geoffrey Michael,2,0,34,32
1657235839359,MATH 109,B01,083215,Ganzberger; Geoffrey Michael,1,0,32,31
1657235839359,MATH 109,B02,083216,Ganzberger; Geoffrey Michael,1,0,32,31
1657235839359,MATH 109,B03,093479,Ganzberger; Geoffrey Michael,8,0,32,24
1657235845384,MATH 142A,A01,083219,Chow; Bennett,6,0,32,26
1657235845384,MATH 142A,A02,083220,Chow; Bennett,10,0,32,22
1657235845384,MATH 142A,A03,093480,Chow; Bennett,7,0,32,25
1657235845384,MATH 142A,B03,093481,Chow; Bennett,8,0,32,24
1657235845384,MATH 142A,B04,093558,Chow; Bennett,12,0,32,20
1657235845384,MATH 142A,B05,093559,Chow; Bennett,6,0,32,26
1657235851411,MATH 193A,A01,083224,Rotar; Vladimir,7,0,34,27
1657235851411,MATH 193A,A02,083225,Rotar; Vladimir,6,0,34,28
1657235851411,MATH 193A,A03,083781,Rotar; Vladimir,2,0,34,32
1657235851411,MATH 193A,A04,083782,Rotar; Vladimir,8,0,34,26
1657235851411,MATH 193A,A05,093482,Rotar; Vladimir,6,0,34,28
1657235857439,MATH 197,001,091859,McAuley; Julian John,9999,0,9999,0
1657235857439,MATH 197,002,095566,Kedlaya; Kiran S.,9997,0,9999,2
1657235857439,MATH 197,003,095567,Xiao; Ming,9999,0,9999,0
1657235857439,MATH 197,004,095571,Perols; Johan Lars,9998,0,9999,1
1657235864493,COGS 9,A01,083615,Shannon; Kyle Michael,8,0,75,67
1657235870519,COGS 11,A01,083617,Boyle; Mary E. T.,22,0,48,26
1657235876546,COGS 13,A01,083071,Bastos; Amalia Pinkusfeld,8,0,71,63
1657235882572,COGS 14A,A01,092681,Semenuks; Arturs,2,1,100,98
1657235888596,COGS 14B,A01,083073,Cheng; Tzu-Han,6,0,63,57
1657235894624,COGS 17,A01,092677,Semenuks; Arturs,5,0,81,76
1657235900646,COGS 100,A01,083619,Allen; Michael Gordon,16,0,70,54
1657235906669,COGS 101A,A01,083621,Davis; Joshua Daniel,9,0,68,59
1657235912694,COGS 101B,A01,091572,Allen; Michael Gordon,11,0,65,54
1657235918716,COGS 101C,A01,083625,Delgado; Tania,17,0,35,18
1657235924738,COGS 107A,A01,083627,Boyle; Mary E. T.,13,0,60,47
1657235930761,COGS 118A,A01,083075,Gupta; Anjum,16,0,76,60
1657235936789,CSE 3,A50,083646,Miranda; Gregory Joseph,24,0,50,26
1657235942818,CSE 8A,A50,083650,Miranda; Gregory Joseph,17,1,56,39
1657235948842,CSE 11,A01,083080,Cao; Yingjun,5,15,40,35
1657235954873,CSE 12,A01,083652,Krause-Levy; Sophia Louisa,26,1,120,94
1657235960910,CSE 15L,A01,083654,Morris; Justin Loren,9,0,50,41
1657235960910,CSE 15L,A02,083655,Morris; Justin Loren,9,0,50,41
1657235966939,CSE 20,A01,083657,Tran; Khoa Dang,38,0,80,42
1657235972966,CSE 21,A01,095574,Bach; Quang Tran,22,0,48,26
1657235978989,CSE 30,A01,083084,Eldon; John,4,0,80,76
1657235978989,CSE 30,B01,095061,Bhaskar; Nishant,8,0,50,42
1657235985029,CSE 100,A01,083659,Cao; Yingjun,4,4,70,66
1657235991056,CSE 134B,A01,083661,Powell; Thomas Allan,21,0,100,79
1657235997084,CSE 140,A01,083663,Gungor; Onat,13,0,85,72
1657236003184,CSE 140L,A01,083088,Eldon; John,17,0,100,83
1657236009212,CSE 175,A01,083665,Kumar; Rakesh,3,0,25,22
1657236015238,CSE 190,A00,092507,Dubnov; Shlomo,7,0,20,13
1657236021265,ECE 45,A01,083139,Congero; Spencer William,5,0,75,70
1657236027291,ECE 65,A50,083695,Saad; Andrew S,12,0,30,18
1657236027291,ECE 65,A51,095125,Saad; Andrew S,25,0,26,1
1657236033318,ECE 109,A01,091882,Touri; Behrouz,19,0,70,51
1657236039345,ECE 180,A00,083140,Abi Samra; Nicholas Camill,1,0,30,29
1657236039345,ECE 180,B00,083141,Abi Samra; Nicholas Camill,0,0,30,30
1657236045377,MATH 10A,A01,083735,Patchell; Gregory David,2,0,30,28
1657236045377,MATH 10A,A02,083736,Patchell; Gregory David,20,0,30,10
1657236045377,MATH 10A,A03,083737,Patchell; Gregory David,16,0,30,14
1657236051406,MATH 10B,A01,083207,Lim; Seonhee,7,0,34,27
1657236051406,MATH 10B,A02,083208,Lim; Seonhee,9,0,35,26
1657236051406,MATH 10B,A03,093472,Lim; Seonhee,5,0,34,29
1657236051406,MATH 10B,B01,083739,Sinha; Shubham,11,0,30,19
1657236057432,MATH 18,A01,083743,Cinel; Cameron Alexander,6,0,30,24
1657236057432,MATH 18,A02,083744,Cinel; Cameron Alexander,17,0,30,13
1657236057432,MATH 18,A03,083745,Cinel; Cameron Alexander,8,0,30,22
1657236057432,MATH 18,B01,083748,Rideout; David Porter,4,0,37,33
1657236057432,MATH 18,B02,083749,Rideout; David Porter,4,0,36,32
1657236057432,MATH 18,B03,083750,Rideout; David Porter,2,0,37,35
1657236057432,MATH 18,B04,083751,Rideout; David Porter,6,0,36,30
1657236057432,MATH 18,B05,093473,Rideout; David Porter,5,0,36,31
1657236057432,MATH 18,B06,093474,Rideout; David Porter,5,0,36,31
1657236063454,MATH 20A,A01,083754,Zheng; Zequn,14,0,40,26
1657236069477,MATH 20B,A01,083756,Briones; Jor-el Thomas Caparas,3,0,36,33
1657236069477,MATH 20B,A02,083757,Briones; Jor-el Thomas Caparas,1,0,36,35
1657236069477,MATH 20B,A03,093475,Briones; Jor-el Thomas Caparas,2,0,36,34
1657236075509,MATH 20C,A01,083760,Briones; Jor-el Thomas Caparas,1,0,35,34
1657236075509,MATH 20C,A02,083761,Briones; Jor-el Thomas Caparas,8,0,35,27
1657236075509,MATH 20C,A03,093476,Briones; Jor-el Thomas Caparas,0,1,36,36
1657236075509,MATH 20C,B01,083762,Bach; Quang Tran,1,0,30,29
1657236081536,MATH 20D,A01,083765,Tran; Brian Kha,4,0,30,26
1657236081536,MATH 20D,A02,083766,Tran; Brian Kha,5,0,30,25
1657236081536,MATH 20D,A03,083767,Tran; Brian Kha,4,0,30,26
1657236087560,MATH 20E,A01,083771,Ganguly; Soumya,7,0,32,25
1657236087560,MATH 20E,A02,083772,Ganguly; Soumya,7,0,32,25
1657236087560,MATH 20E,B01,083773,Ciotti; Benjamin,19,0,35,16
1657236087560,MATH 20E,B02,083774,Ciotti; Benjamin,17,0,35,18
1657236093584,MATH 103A,A01,083777,Greenfeld; Be'Eri,3,0,36,33
1657236093584,MATH 103A,A02,083778,Greenfeld; Be'Eri,5,0,36,31
1657236093584,MATH 103A,A03,093561,Greenfeld; Be'Eri,4,0,36,32
1657236093584,MATH 103A,B01,083779,Greenfeld; Be'Eri,6,0,36,30
1657236093584,MATH 103A,B02,083780,Greenfeld; Be'Eri,3,0,36,33
1657236093584,MATH 103A,B03,093562,Greenfeld; Be'Eri,3,0,36,33
1657236099611,MATH 105,A01,085443,Carter; Anne Toulson,15,0,35,20
1657236099611,MATH 105,A02,093477,Carter; Anne Toulson,20,0,35,15
1657236105642,MATH 109,A01,083213,Ganzberger; Geoffrey Michael,2,0,34,32
1657236105642,MATH 109,A02,083214,Ganzberger; Geoffrey Michael,4,0,34,30
1657236105642,MATH 109,A03,093478,Ganzberger; Geoffrey Michael,2,0,34,32
1657236105642,MATH 109,B01,083215,Ganzberger; Geoffrey Michael,1,0,32,31
1657236105642,MATH 109,B02,083216,Ganzberger; Geoffrey Michael,1,0,32,31
1657236105642,MATH 109,B03,093479,Ganzberger; Geoffrey Michael,8,0,32,24
1657236111666,MATH 142A,A01,083219,Chow; Bennett,6,0,32,26
1657236111666,MATH 142A,A02,083220,Chow; Bennett,10,0,32,22
1657236111666,MATH 142A,A03,093480,Chow; Bennett,7,0,32,25
1657236111666,MATH 142A,B03,093481,Chow; Bennett,8,0,32,24
1657236111666,MATH 142A,B04,093558,Chow; Bennett,12,0,32,20
1657236111666,MATH 142A,B05,093559,Chow; Bennett,6,0,32,26
1657236117690,MATH 193A,A01,083224,Rotar; Vladimir,7,0,34,27
1657236117690,MATH 193A,A02,083225,Rotar; Vladimir,6,0,34,28
1657236117690,MATH 193A,A03,083781,Rotar; Vladimir,2,0,34,32
1657236117690,MATH 193A,A04,083782,Rotar; Vladimir,8,0,34,26
1657236117690,MATH 193A,A05,093482,Rotar; Vladimir,6,0,34,28
1657236123714,MATH 197,001,091859,McAuley; Julian John,9999,0,9999,0
1657236123714,MATH 197,002,095566,Kedlaya; Kiran S.,9997,0,9999,2
1657236123714,MATH 197,003,095567,Xiao; Ming,9999,0,9999,0
1657236123714,MATH 197,004,095571,Perols; Johan Lars,9998,0,9999,1
1657236130776,COGS 9,A01,083615,Shannon; Kyle Michael,8,0,75,67
1657236136797,COGS 11,A01,083617,Boyle; Mary E. T.,22,0,48,26
1657236142821,COGS 13,A01,083071,Bastos; Amalia Pinkusfeld,8,0,71,63
1657236148844,COGS 14A,A01,092681,Semenuks; Arturs,2,1,100,98
1657236154878,COGS 14B,A01,083073,Cheng; Tzu-Han,6,0,63,57
1657236160903,COGS 17,A01,092677,Semenuks; Arturs,5,0,81,76
1657236166925,COGS 100,A01,083619,Allen; Michael Gordon,16,0,70,54
1657236172951,COGS 101A,A01,083621,Davis; Joshua Daniel,9,0,68,59
1657236178974,COGS 101B,A01,091572,Allen; Michael Gordon,11,0,65,54
1657236185002,COGS 101C,A01,083625,Delgado; Tania,17,0,35,18
1657236191027,COGS 107A,A01,083627,Boyle; Mary E. T.,13,0,60,47
1657236197052,COGS 118A,A01,083075,Gupta; Anjum,16,0,76,60
1657236203078,CSE 3,A50,083646,Miranda; Gregory Joseph,24,0,50,26
1657236209101,CSE 8A,A50,083650,Miranda; Gregory Joseph,17,1,56,39
1657236215123,CSE 11,A01,083080,Cao; Yingjun,5,15,40,35
1657236221145,CSE 12,A01,083652,Krause-Levy; Sophia Louisa,26,1,120,94
1657236227169,CSE 15L,A01,083654,Morris; Justin Loren,9,0,50,41
1657236227169,CSE 15L,A02,083655,Morris; Justin Loren,9,0,50,41
1657236233197,CSE 20,A01,083657,Tran; Khoa Dang,38,0,80,42
1657236239221,CSE 21,A01,095574,Bach; Quang Tran,22,0,48,26
1657236245244,CSE 30,A01,083084,Eldon; John,4,0,80,76
1657236245244,CSE 30,B01,095061,Bhaskar; Nishant,8,0,50,42
1657236251271,CSE 100,A01,083659,Cao; Yingjun,4,4,70,66
1657236257295,CSE 134B,A01,083661,Powell; Thomas Allan,21,0,100,79
1657236263320,CSE 140,A01,083663,Gungor; Onat,13,0,85,72
1657236269343,CSE 140L,A01,083088,Eldon; John,17,0,100,83
1657236275366,CSE 175,A01,083665,Kumar; Rakesh,3,0,25,22
1657236281407,CSE 190,A00,092507,Dubnov; Shlomo,7,0,20,13
1657236287437,ECE 45,A01,083139,Congero; Spencer William,5,0,75,70
1657236293473,ECE 65,A50,083695,Saad; Andrew S,12,0,30,18
1657236293473,ECE 65,A51,095125,Saad; Andrew S,25,0,26,1
1657236299498,ECE 109,A01,091882,Touri; Behrouz,19,0,70,51
1657236305522,ECE 180,A00,083140,Abi Samra; Nicholas Camill,1,0,30,29
1657236305522,ECE 180,B00,083141,Abi Samra; Nicholas Camill,0,0,30,30
1657236311554,MATH 10A,A01,083735,Patchell; Gregory David,2,0,30,28
1657236311554,MATH 10A,A02,083736,Patchell; Gregory David,20,0,30,10
1657236311554,MATH 10A,A03,083737,Patchell; Gregory David,16,0,30,14
1657236317578,MATH 10B,A01,083207,Lim; Seonhee,7,0,34,27
1657236317578,MATH 10B,A02,083208,Lim; Seonhee,9,0,35,26
1657236317578,MATH 10B,A03,093472,Lim; Seonhee,5,0,34,29
1657236317578,MATH 10B,B01,083739,Sinha; Shubham,11,0,30,19
1657236323611,MATH 18,A01,083743,Cinel; Cameron Alexander,6,0,30,24
1657236323611,MATH 18,A02,083744,Cinel; Cameron Alexander,17,0,30,13
1657236323611,MATH 18,A03,083745,Cinel; Cameron Alexander,8,0,30,22
1657236323611,MATH 18,B01,083748,Rideout; David Porter,4,0,37,33
1657236323611,MATH 18,B02,083749,Rideout; David Porter,4,0,36,32
1657236323611,MATH 18,B03,083750,Rideout; David Porter,2,0,37,35
1657236323611,MATH 18,B04,083751,Rideout; David Porter,6,0,36,30
1657236323611,MATH 18,B05,093473,Rideout; David Porter,5,0,36,31
1657236323611,MATH 18,B06,093474,Rideout; David Porter,5,0,36,31
1657236329638,MATH 20A,A01,083754,Zheng; Zequn,14,0,40,26
1657236335664,MATH 20B,A01,083756,Briones; Jor-el Thomas Caparas,3,0,36,33
1657236335664,MATH 20B,A02,083757,Briones; Jor-el Thomas Caparas,1,0,36,35
1657236335664,MATH 20B,A03,093475,Briones; Jor-el Thomas Caparas,2,0,36,34
1657236341688,MATH 20C,A01,083760,Briones; Jor-el Thomas Caparas,1,0,35,34
1657236341688,MATH 20C,A02,083761,Briones; Jor-el Thomas Caparas,8,0,35,27
1657236341688,MATH 20C,A03,093476,Briones; Jor-el Thomas Caparas,0,1,36,36
1657236341688,MATH 20C,B01,083762,Bach; Quang Tran,1,0,30,29
1657236347712,MATH 20D,A01,083765,Tran; Brian Kha,4,0,30,26
1657236347712,MATH 20D,A02,083766,Tran; Brian Kha,5,0,30,25
1657236347712,MATH 20D,A03,083767,Tran; Brian Kha,4,0,30,26
1657236353738,MATH 20E,A01,083771,Ganguly; Soumya,7,0,32,25
1657236353738,MATH 20E,A02,083772,Ganguly; Soumya,7,0,32,25
1657236353738,MATH 20E,B01,083773,Ciotti; Benjamin,19,0,35,16
1657236353738,MATH 20E,B02,083774,Ciotti; Benjamin,17,0,35,18
1657236359769,MATH 103A,A01,083777,Greenfeld; Be'Eri,3,0,36,33
1657236359769,MATH 103A,A02,083778,Greenfeld; Be'Eri,5,0,36,31
1657236359769,MATH 103A,A03,093561,Greenfeld; Be'Eri,4,0,36,32
1657236359769,MATH 103A,B01,083779,Greenfeld; Be'Eri,6,0,36,30
1657236359769,MATH 103A,B02,083780,Greenfeld; Be'Eri,3,0,36,33
1657236359769,MATH 103A,B03,093562,Greenfeld; Be'Eri,3,0,36,33
1657236365798,MATH 105,A01,085443,Carter; Anne Toulson,15,0,35,20
1657236365798,MATH 105,A02,093477,Carter; Anne Toulson,20,0,35,15
1657236371827,MATH 109,A01,083213,Ganzberger; Geoffrey Michael,2,0,34,32
1657236371827,MATH 109,A02,083214,Ganzberger; Geoffrey Michael,4,0,34,30
1657236371827,MATH 109,A03,093478,Ganzberger; Geoffrey Michael,2,0,34,32
1657236371827,MATH 109,B01,083215,Ganzberger; Geoffrey Michael,1,0,32,31
1657236371827,MATH 109,B02,083216,Ganzberger; Geoffrey Michael,1,0,32,31
1657236371827,MATH 109,B03,093479,Ganzberger; Geoffrey Michael,8,0,32,24
1657236377854,MATH 142A,A01,083219,Chow; Bennett,6,0,32,26
1657236377854,MATH 142A,A02,083220,Chow; Bennett,10,0,32,22
1657236377854,MATH 142A,A03,093480,Chow; Bennett,7,0,32,25
1657236377854,MATH 142A,B03,093481,Chow; Bennett,8,0,32,24
1657236377854,MATH 142A,B04,093558,Chow; Bennett,12,0,32,20
1657236377854,MATH 142A,B05,093559,Chow; Bennett,6,0,32,26
1657236383882,MATH 193A,A01,083224,Rotar; Vladimir,7,0,34,27
1657236383882,MATH 193A,A02,083225,Rotar; Vladimir,6,0,34,28
1657236383882,MATH 193A,A03,083781,Rotar; Vladimir,2,0,34,32
1657236383882,MATH 193A,A04,083782,Rotar; Vladimir,8,0,34,26
1657236383882,MATH 193A,A05,093482,Rotar; Vladimir,6,0,34,28
1657236389905,MATH 197,001,091859,McAuley; Julian John,9999,0,9999,0
1657236389905,MATH 197,002,095566,Kedlaya; Kiran S.,9997,0,9999,2
1657236389905,MATH 197,003,095567,Xiao; Ming,9999,0,9999,0
1657236389905,MATH 197,004,095571,Perols; Johan Lars,9998,0,9999,1
1657236396967,COGS 9,A01,083615,Shannon; Kyle Michael,8,0,75,67
1657236402989,COGS 11,A01,083617,Boyle; Mary E. T.,22,0,48,26
1657236409013,COGS 13,A01,083071,Bastos; Amalia Pinkusfeld,8,0,71,63
1657236415036,COGS 14A,A01,092681,Semenuks; Arturs,2,1,100,98
1657236421060,COGS 14B,A01,083073,Cheng; Tzu-Han,6,0,63,57
1657236427082,COGS 17,A01,092677,Semenuks; Arturs,5,0,81,76
1657236433110,COGS 100,A01,083619,Allen; Michael Gordon,16,0,70,54
1657236439133,COGS 101A,A01,083621,Davis; Joshua Daniel,9,0,68,59
1657236445156,COGS 101B,A01,091572,Allen; Michael Gordon,11,0,65,54
1657236451179,COGS 101C,A01,083625,Delgado; Tania,17,0,35,18
1657236457206,COGS 107A,A01,083627,Boyle; Mary E. T.,13,0,60,47
1657236463235,COGS 118A,A01,083075,Gupta; Anjum,16,0,76,60
1657236469259,CSE 3,A50,083646,Miranda; Gregory Joseph,24,0,50,26
1657236475281,CSE 8A,A50,083650,Miranda; Gregory Joseph,17,1,56,39
1657236481309,CSE 11,A01,083080,Cao; Yingjun,5,15,40,35
1657236487332,CSE 12,A01,083652,Krause-Levy; Sophia Louisa,26,1,120,94
1657236493362,CSE 15L,A01,083654,Morris; Justin Loren,9,0,50,41
1657236493362,CSE 15L,A02,083655,Morris; Justin Loren,9,0,50,41
1657236499388,CSE 20,A01,083657,Tran; Khoa Dang,38,0,80,42
1657236505420,CSE 21,A01,095574,Bach; Quang Tran,22,0,48,26
1657236511445,CSE 30,A01,083084,Eldon; John,4,0,80,76
1657236511445,CSE 30,B01,095061,Bhaskar; Nishant,8,0,50,42
1657236517473,CSE 100,A01,083659,Cao; Yingjun,4,4,70,66
1657236523496,CSE 134B,A01,083661,Powell; Thomas Allan,21,0,100,79
1657236529520,CSE 140,A01,083663,Gungor; Onat,13,0,85,72
1657236535546,CSE 140L,A01,083088,Eldon; John,17,0,100,83
1657236541571,CSE 175,A01,083665,Kumar; Rakesh,3,0,25,22
1657236547600,CSE 190,A00,092507,Dubnov; Shlomo,7,0,20,13
1657236553622,ECE 45,A01,083139,Congero; Spencer William,5,0,75,70
1657236559646,ECE 65,A50,083695,Saad; Andrew S,12,0,30,18
1657236559646,ECE 65,A51,095125,Saad; Andrew S,25,0,26,1
1657236565667,ECE 109,A01,091882,Touri; Behrouz,19,0,70,51
1657236571689,ECE 180,A00,083140,Abi Samra; Nicholas Camill,1,0,30,29
1657236571689,ECE 180,B00,083141,Abi Samra; Nicholas Camill,0,0,30,30
1657236577715,MATH 10A,A01,083735,Patchell; Gregory David,2,0,30,28
1657236577715,MATH 10A,A02,083736,Patchell; Gregory David,20,0,30,10
1657236577715,MATH 10A,A03,083737,Patchell; Gregory David,16,0,30,14
1657236583744,MATH 10B,A01,083207,Lim; Seonhee,7,0,34,27
1657236583744,MATH 10B,A02,083208,Lim; Seonhee,9,0,35,26
1657236583744,MATH 10B,A03,093472,Lim; Seonhee,5,0,34,29
1657236583744,MATH 10B,B01,083739,Sinha; Shubham,11,0,30,19
1657236589768,MATH 18,A01,083743,Cinel; Cameron Alexander,6,0,30,24
1657236589768,MATH 18,A02,083744,Cinel; Cameron Alexander,17,0,30,13
1657236589768,MATH 18,A03,083745,Cinel; Cameron Alexander,8,0,30,22
1657236589768,MATH 18,B01,083748,Rideout; David Porter,4,0,37,33
1657236589768,MATH 18,B02,083749,Rideout; David Porter,4,0,36,32
1657236589768,MATH 18,B03,083750,Rideout; David Porter,2,0,37,35
1657236589768,MATH 18,B04,083751,Rideout; David Porter,6,0,36,30
1657236589768,MATH 18,B05,093473,Rideout; David Porter,5,0,36,31
1657236589768,MATH 18,B06,093474,Rideout; David Porter,5,0,36,31
1657236595791,MATH 20A,A01,083754,Zheng; Zequn,14,0,40,26
1657236601887,MATH 20B,A01,083756,Briones; Jor-el Thomas Caparas,3,0,36,33
1657236601887,MATH 20B,A02,083757,Briones; Jor-el Thomas Caparas,1,0,36,35
1657236601887,MATH 20B,A03,093475,Briones; Jor-el Thomas Caparas,2,0,36,34
1657236607915,MATH 20C,A01,083760,Briones; Jor-el Thomas Caparas,1,0,35,34
1657236607915,MATH 20C,A02,083761,Briones; Jor-el Thomas Caparas,8,0,35,27
1657236607915,MATH 20C,A03,093476,Briones; Jor-el Thomas Caparas,0,1,36,36
1657236607915,MATH 20C,B01,083762,Bach; Quang Tran,1,0,30,29
1657236613938,MATH 20D,A01,083765,Tran; Brian Kha,4,0,30,26
1657236613938,MATH 20D,A02,083766,Tran; Brian Kha,5,0,30,25
1657236613938,MATH 20D,A03,083767,Tran; Brian Kha,4,0,30,26
1657236619973,MATH 20E,A01,083771,Ganguly; Soumya,7,0,32,25
1657236619973,MATH 20E,A02,083772,Ganguly; Soumya,7,0,32,25
1657236619973,MATH 20E,B01,083773,Ciotti; Benjamin,19,0,35,16
1657236619973,MATH 20E,B02,083774,Ciotti; Benjamin,17,0,35,18
1657236626004,MATH 103A,A01,083777,Greenfeld; Be'Eri,3,0,36,33
1657236626004,MATH 103A,A02,083778,Greenfeld; Be'Eri,5,0,36,31
1657236626004,MATH 103A,A03,093561,Greenfeld; Be'Eri,4,0,36,32
1657236626004,MATH 103A,B01,083779,Greenfeld; Be'Eri,6,0,36,30
1657236626004,MATH 103A,B02,083780,Greenfeld; Be'Eri,3,0,36,33
1657236626004,MATH 103A,B03,093562,Greenfeld; Be'Eri,3,0,36,33
1657236632027,MATH 105,A01,085443,Carter; Anne Toulson,15,0,35,20
1657236632027,MATH 105,A02,093477,Carter; Anne Toulson,20,0,35,15
1657236638051,MATH 109,A01,083213,Ganzberger; Geoffrey Michael,2,0,34,32
1657236638051,MATH 109,A02,083214,Ganzberger; Geoffrey Michael,4,0,34,30
1657236638051,MATH 109,A03,093478,Ganzberger; Geoffrey Michael,2,0,34,32
1657236638051,MATH 109,B01,083215,Ganzberger; Geoffrey Michael,1,0,32,31
1657236638051,MATH 109,B02,083216,Ganzberger; Geoffrey Michael,1,0,32,31
1657236638051,MATH 109,B03,093479,Ganzberger; Geoffrey Michael,8,0,32,24
1657236644079,MATH 142A,A01,083219,Chow; Bennett,6,0,32,26
1657236644079,MATH 142A,A02,083220,Chow; Bennett,10,0,32,22
1657236644079,MATH 142A,A03,093480,Chow; Bennett,7,0,32,25
1657236644079,MATH 142A,B03,093481,Chow; Bennett,8,0,32,24
1657236644079,MATH 142A,B04,093558,Chow; Bennett,12,0,32,20
1657236644079,MATH 142A,B05,093559,Chow; Bennett,6,0,32,26
1657236650107,MATH 193A,A01,083224,Rotar; Vladimir,7,0,34,27
1657236650107,MATH 193A,A02,083225,Rotar; Vladimir,6,0,34,28
1657236650107,MATH 193A,A03,083781,Rotar; Vladimir,2,0,34,32
1657236650107,MATH 193A,A04,083782,Rotar; Vladimir,8,0,34,26
1657236650107,MATH 193A,A05,093482,Rotar; Vladimir,6,0,34,28
1657236656134,MATH 197,001,091859,McAuley; Julian John,9999,0,9999,0
1657236656134,MATH 197,002,095566,Kedlaya; Kiran S.,9997,0,9999,2
1657236656134,MATH 197,003,095567,Xiao; Ming,9999,0,9999,0
1657236656134,MATH 197,004,095571,Perols; Johan Lars,9998,0,9999,1
1657236663185,COGS 9,A01,083615,Shannon; Kyle Michael,8,0,75,67
1657236669213,COGS 11,A01,083617,Boyle; Mary E. T.,22,0,48,26
1657236675242,COGS 13,A01,083071,Bastos; Amalia Pinkusfeld,8,0,71,63
1657236681268,COGS 14A,A01,092681,Semenuks; Arturs,2,1,100,98
1657236687317,COGS 14B,A01,083073,Cheng; Tzu-Han,6,0,63,57
1657236693345,COGS 17,A01,092677,Semenuks; Arturs,5,0,81,76
1657236699372,COGS 100,A01,083619,Allen; Michael Gordon,16,0,70,54
1657236705401,COGS 101A,A01,083621,Davis; Joshua Daniel,9,0,68,59
1657236711428,COGS 101B,A01,091572,Allen; Michael Gordon,11,0,65,54
1657236717451,COGS 101C,A01,083625,Delgado; Tania,17,0,35,18
1657236723474,COGS 107A,A01,083627,Boyle; Mary E. T.,13,0,60,47
1657236729509,COGS 118A,A01,083075,Gupta; Anjum,16,0,76,60
1657236735536,CSE 3,A50,083646,Miranda; Gregory Joseph,24,0,50,26
1657236741561,CSE 8A,A50,083650,Miranda; Gregory Joseph,17,1,56,39
1657236747584,CSE 11,A01,083080,Cao; Yingjun,5,15,40,35
1657236753608,CSE 12,A01,083652,Krause-Levy; Sophia Louisa,26,1,120,94
1657236759634,CSE 15L,A01,083654,Morris; Justin Loren,9,0,50,41
1657236759634,CSE 15L,A02,083655,Morris; Justin Loren,9,0,50,41
1657236765659,CSE 20,A01,083657,Tran; Khoa Dang,38,0,80,42
1657236771691,CSE 21,A01,095574,Bach; Quang Tran,22,0,48,26
1657236777720,CSE 30,A01,083084,Eldon; John,4,0,80,76
1657236777720,CSE 30,B01,095061,Bhaskar; Nishant,8,0,50,42
1657236783747,CSE 100,A01,083659,Cao; Yingjun,4,4,70,66
1657236789770,CSE 134B,A01,083661,Powell; Thomas Allan,21,0,100,79
1657236795793,CSE 140,A01,083663,Gungor; Onat,13,0,85,72
1657236801817,CSE 140L,A01,083088,Eldon; John,17,0,100,83
1657236807839,CSE 175,A01,083665,Kumar; Rakesh,3,0,25,22
1657236813871,CSE 190,A00,092507,Dubnov; Shlomo,7,0,20,13
1657236819897,ECE 45,A01,083139,Congero; Spencer William,5,0,75,70
1657236825923,ECE 65,A50,083695,Saad; Andrew S,12,0,30,18
1657236825923,ECE 65,A51,095125,Saad; Andrew S,25,0,26,1
1657236831948,ECE 109,A01,091882,Touri; Behrouz,19,0,70,51
1657236837971,ECE 180,A00,083140,Abi Samra; Nicholas Camill,1,0,30,29
1657236837971,ECE 180,B00,083141,Abi Samra; Nicholas Camill,0,0,30,30
1657236844000,MATH 10A,A01,083735,Patchell; Gregory David,2,0,30,28
1657236844000,MATH 10A,A02,083736,Patchell; Gregory David,20,0,30,10
1657236844000,MATH 10A,A03,083737,Patchell; Gregory David,16,0,30,14
1657236850023,MATH 10B,A01,083207,Lim; Seonhee,7,0,34,27
1657236850023,MATH 10B,A02,083208,Lim; Seonhee,9,0,35,26
1657236850023,MATH 10B,A03,093472,Lim; Seonhee,5,0,34,29
1657236850023,MATH 10B,B01,083739,Sinha; Shubham,11,0,30,19
1657236856055,MATH 18,A01,083743,Cinel; Cameron Alexander,6,0,30,24
1657236856055,MATH 18,A02,083744,Cinel; Cameron Alexander,17,0,30,13
1657236856055,MATH 18,A03,083745,Cinel; Cameron Alexander,8,0,30,22
1657236856055,MATH 18,B01,083748,Rideout; David Porter,4,0,37,33
1657236856055,MATH 18,B02,083749,Rideout; David Porter,4,0,36,32
1657236856055,MATH 18,B03,083750,Rideout; David Porter,2,0,37,35
1657236856055,MATH 18,B04,083751,Rideout; David Porter,6,0,36,30
1657236856055,MATH 18,B05,093473,Rideout; David Porter,5,0,36,31
1657236856055,MATH 18,B06,093474,Rideout; David Porter,5,0,36,31
1657236862082,MATH 20A,A01,083754,Zheng; Zequn,14,0,40,26
1657236868117,MATH 20B,A01,083756,Briones; Jor-el Thomas Caparas,3,0,36,33
1657236868117,MATH 20B,A02,083757,Briones; Jor-el Thomas Caparas,1,0,36,35
1657236868117,MATH 20B,A03,093475,Briones; Jor-el Thomas Caparas,2,0,36,34
1657236874140,MATH 20C,A01,083760,Briones; Jor-el Thomas Caparas,1,0,35,34
1657236874140,MATH 20C,A02,083761,Briones; Jor-el Thomas Caparas,8,0,35,27
1657236874140,MATH 20C,A03,093476,Briones; Jor-el Thomas Caparas,0,1,36,36
1657236874140,MATH 20C,B01,083762,Bach; Quang Tran,1,0,30,29
1657236880163,MATH 20D,A01,083765,Tran; Brian Kha,4,0,30,26
1657236880163,MATH 20D,A02,083766,Tran; Brian Kha,5,0,30,25
1657236880163,MATH 20D,A03,083767,Tran; Brian Kha,4,0,30,26
1657236886190,MATH 20E,A01,083771,Ganguly; Soumya,7,0,32,25
1657236886190,MATH 20E,A02,083772,Ganguly; Soumya,7,0,32,25
1657236886190,MATH 20E,B01,083773,Ciotti; Benjamin,19,0,35,16
1657236886190,MATH 20E,B02,083774,Ciotti; Benjamin,17,0,35,18
1657236892218,MATH 103A,A01,083777,Greenfeld; Be'Eri,3,0,36,33
1657236892218,MATH 103A,A02,083778,Greenfeld; Be'Eri,5,0,36,31
1657236892218,MATH 103A,A03,093561,Greenfeld; Be'Eri,4,0,36,32
1657236892218,MATH 103A,B01,083779,Greenfeld; Be'Eri,6,0,36,30
1657236892218,MATH 103A,B02,083780,Greenfeld; Be'Eri,3,0,36,33
1657236892218,MATH 103A,B03,093562,Greenfeld; Be'Eri,3,0,36,33
1657236898244,MATH 105,A01,085443,Carter; Anne Toulson,15,0,35,20
1657236898244,MATH 105,A02,093477,Carter; Anne Toulson,20,0,35,15
1657236904274,MATH 109,A01,083213,Ganzberger; Geoffrey Michael,2,0,34,32
1657236904274,MATH 109,A02,083214,Ganzberger; Geoffrey Michael,4,0,34,30
1657236904274,MATH 109,A03,093478,Ganzberger; Geoffrey Michael,2,0,34,32
1657236904274,MATH 109,B01,083215,Ganzberger; Geoffrey Michael,1,0,32,31
1657236904274,MATH 109,B02,083216,Ganzberger; Geoffrey Michael,1,0,32,31
1657236904274,MATH 109,B03,093479,Ganzberger; Geoffrey Michael,8,0,32,24
1657236910298,MATH 142A,A01,083219,Chow; Bennett,6,0,32,26
1657236910298,MATH 142A,A02,083220,Chow; Bennett,10,0,32,22
1657236910298,MATH 142A,A03,093480,Chow; Bennett,7,0,32,25
1657236910298,MATH 142A,B03,093481,Chow; Bennett,8,0,32,24
1657236910298,MATH 142A,B04,093558,Chow; Bennett,12,0,32,20
1657236910298,MATH 142A,B05,093559,Chow; Bennett,6,0,32,26
1657236916322,MATH 193A,A01,083224,Rotar; Vladimir,7,0,34,27
1657236916322,MATH 193A,A02,083225,Rotar; Vladimir,6,0,34,28
1657236916322,MATH 193A,A03,083781,Rotar; Vladimir,2,0,34,32
1657236916322,MATH 193A,A04,083782,Rotar; Vladimir,8,0,34,26
1657236916322,MATH 193A,A05,093482,Rotar; Vladimir,6,0,34,28
1657236922345,MATH 197,001,091859,McAuley; Julian John,9999,0,9999,0
1657236922345,MATH 197,002,095566,Kedlaya; Kiran S.,9997,0,9999,2
1657236922345,MATH 197,003,095567,Xiao; Ming,9999,0,9999,0
1657236922345,MATH 197,004,095571,Perols; Johan Lars,9998,0,9999,1
1657236929405,COGS 9,A01,083615,Shannon; Kyle Michael,8,0,75,67
1657236935431,COGS 11,A01,083617,Boyle; Mary E. T.,22,0,48,26
1657236941470,COGS 13,A01,083071,Bastos; Amalia Pinkusfeld,8,0,71,63
1657236947500,COGS 14A,A01,092681,Semenuks; Arturs,2,1,100,98
1657236953525,COGS 14B,A01,083073,Cheng; Tzu-Han,6,0,63,57
1657236959548,COGS 17,A01,092677,Semenuks; Arturs,5,0,81,76
1657236965573,COGS 100,A01,083619,Allen; Michael Gordon,16,0,70,54
1657236971596,COGS 101A,A01,083621,Davis; Joshua Daniel,9,0,68,59
1657236977622,COGS 101B,A01,091572,Allen; Michael Gordon,11,0,65,54
1657236983645,COGS 101C,A01,083625,Delgado; Tania,17,0,35,18
1657236989669,COGS 107A,A01,083627,Boyle; Mary E. T.,13,0,60,47
1657236995696,COGS 118A,A01,083075,Gupta; Anjum,16,0,76,60
1657237001724,CSE 3,A50,083646,Miranda; Gregory Joseph,24,0,50,26
1657237007749,CSE 8A,A50,083650,Miranda; Gregory Joseph,17,1,56,39
1657237013776,CSE 11,A01,083080,Cao; Yingjun,5,15,40,35
1657237019802,CSE 12,A01,083652,Krause-Levy; Sophia Louisa,26,1,120,94
1657237025828,CSE 15L,A01,083654,Morris; Justin Loren,9,0,50,41
1657237025828,CSE 15L,A02,083655,Morris; Justin Loren,9,0,50,41
1657237031858,CSE 20,A01,083657,Tran; Khoa Dang,38,0,80,42
1657237037883,CSE 21,A01,095574,Bach; Quang Tran,22,0,48,26
1657237043928,CSE 30,A01,083084,Eldon; John,4,0,80,76
1657237043928,CSE 30,B01,095061,Bhaskar; Nishant,8,0,50,42
1657237049953,CSE 100,A01,083659,Cao; Yingjun,4,4,70,66
1657237055978,CSE 134B,A01,083661,Powell; Thomas Allan,21,0,100,79
1657237062007,CSE 140,A01,083663,Gungor; Onat,13,0,85,72
1657237068034,CSE 140L,A01,083088,Eldon; John,17,0,100,83
1657237074057,CSE 175,A01,083665,Kumar; Rakesh,3,0,25,22
1657237080081,CSE 190,A00,092507,Dubnov; Shlomo,7,0,20,13
1657237086104,ECE 45,A01,083139,Congero; Spencer William,5,0,75,70
1657237092131,ECE 65,A50,083695,Saad; Andrew S,12,0,30,18
1657237092131,ECE 65,A51,095125,Saad; Andrew S,25,0,26,1
1657237098156,ECE 109,A01,091882,Touri; Behrouz,19,0,70,51
1657237104181,ECE 180,A00,083140,Abi Samra; Nicholas Camill,1,0,30,29
1657237104181,ECE 180,B00,083141,Abi Samra; Nicholas Camill,0,0,30,30
1657237110211,MATH 10A,A01,083735,Patchell; Gregory David,2,0,30,28
1657237110211,MATH 10A,A02,083736,Patchell; Gregory David,20,0,30,10
1657237110211,MATH 10A,A03,083737,Patchell; Gregory David,16,0,30,14
1657237116233,MATH 10B,A01,083207,Lim; Seonhee,7,0,34,27
1657237116233,MATH 10B,A02,083208,Lim; Seonhee,9,0,35,26
1657237116233,MATH 10B,A03,093472,Lim; Seonhee,5,0,34,29
1657237116233,MATH 10B,B01,083739,Sinha; Shubham,11,0,30,19
1657237122265,MATH 18,A01,083743,Cinel; Cameron Alexander,6,0,30,24
1657237122265,MATH 18,A02,083744,Cinel; Cameron Alexander,17,0,30,13
1657237122265,MATH 18,A03,083745,Cinel; Cameron Alexander,8,0,30,22
1657237122265,MATH 18,B01,083748,Rideout; David Porter,4,0,37,33
1657237122265,MATH 18,B02,083749,Rideout; David Porter,4,0,36,32
1657237122265,MATH 18,B03,083750,Rideout; David Porter,2,0,37,35
1657237122265,MATH 18,B04,083751,Rideout; David Porter,6,0,36,30
1657237122265,MATH 18,B05,093473,Rideout; David Porter,5,0,36,31
1657237122265,MATH 18,B06,093474,Rideout; David Porter,5,0,36,31
1657237128288,MATH 20A,A01,083754,Zheng; Zequn,14,0,40,26
1657237134311,MATH 20B,A01,083756,Briones; Jor-el Thomas Caparas,3,0,36,33
1657237134311,MATH 20B,A02,083757,Briones; Jor-el Thomas Caparas,1,0,36,35
1657237134311,MATH 20B,A03,093475,Briones; Jor-el Thomas Caparas,2,0,36,34
1657237140333,MATH 20C,A01,083760,Briones; Jor-el Thomas Caparas,1,0,35,34
1657237140333,MATH 20C,A02,083761,Briones; Jor-el Thomas Caparas,8,0,35,27
1657237140333,MATH 20C,A03,093476,Briones; Jor-el Thomas Caparas,0,1,36,36
1657237140333,MATH 20C,B01,083762,Bach; Quang Tran,1,0,30,29
1657237146371,MATH 20D,A01,083765,Tran; Brian Kha,4,0,30,26
1657237146371,MATH 20D,A02,083766,Tran; Brian Kha,5,0,30,25
1657237146371,MATH 20D,A03,083767,Tran; Brian Kha,4,0,30,26
1657237152394,MATH 20E,A01,083771,Ganguly; Soumya,7,0,32,25
1657237152394,MATH 20E,A02,083772,Ganguly; Soumya,7,0,32,25
1657237152394,MATH 20E,B01,083773,Ciotti; Benjamin,19,0,35,16
1657237152394,MATH 20E,B02,083774,Ciotti; Benjamin,17,0,35,18
1657237158417,MATH 103A,A01,083777,Greenfeld; Be'Eri,3,0,36,33
1657237158417,MATH 103A,A02,083778,Greenfeld; Be'Eri,5,0,36,31
1657237158417,MATH 103A,A03,093561,Greenfeld; Be'Eri,4,0,36,32
1657237158417,MATH 103A,B01,083779,Greenfeld; Be'Eri,6,0,36,30
1657237158417,MATH 103A,B02,083780,Greenfeld; Be'Eri,3,0,36,33
1657237158417,MATH 103A,B03,093562,Greenfeld; Be'Eri,3,0,36,33
1657237164439,MATH 105,A01,085443,Carter; Anne Toulson,15,0,35,20
1657237164439,MATH 105,A02,093477,Carter; Anne Toulson,20,0,35,15
1657237170464,MATH 109,A01,083213,Ganzberger; Geoffrey Michael,2,0,34,32
1657237170464,MATH 109,A02,083214,Ganzberger; Geoffrey Michael,4,0,34,30
1657237170464,MATH 109,A03,093478,Ganzberger; Geoffrey Michael,2,0,34,32
1657237170464,MATH 109,B01,083215,Ganzberger; Geoffrey Michael,1,0,32,31
1657237170464,MATH 109,B02,083216,Ganzberger; Geoffrey Michael,1,0,32,31
1657237170464,MATH 109,B03,093479,Ganzberger; Geoffrey Michael,8,0,32,24
1657237176492,MATH 142A,A01,083219,Chow; Bennett,6,0,32,26
1657237176492,MATH 142A,A02,083220,Chow; Bennett,10,0,32,22
1657237176492,MATH 142A,A03,093480,Chow; Bennett,7,0,32,25
1657237176492,MATH 142A,B03,093481,Chow; Bennett,8,0,32,24
1657237176492,MATH 142A,B04,093558,Chow; Bennett,12,0,32,20
1657237176492,MATH 142A,B05,093559,Chow; Bennett,6,0,32,26
1657237182521,MATH 193A,A01,083224,Rotar; Vladimir,7,0,34,27
1657237182521,MATH 193A,A02,083225,Rotar; Vladimir,6,0,34,28
1657237182521,MATH 193A,A03,083781,Rotar; Vladimir,2,0,34,32
1657237182521,MATH 193A,A04,083782,Rotar; Vladimir,8,0,34,26
1657237182521,MATH 193A,A05,093482,Rotar; Vladimir,6,0,34,28
1657237188545,MATH 197,001,091859,McAuley; Julian John,9999,0,9999,0
1657237188545,MATH 197,002,095566,Kedlaya; Kiran S.,9997,0,9999,2
1657237188545,MATH 197,003,095567,Xiao; Ming,9999,0,9999,0
1657237188545,MATH 197,004,095571,Perols; Johan Lars,9998,0,9999,1
1657237195690,COGS 9,A01,083615,Shannon; Kyle Michael,8,0,75,67
1657237201718,COGS 11,A01,083617,Boyle; Mary E. T.,22,0,48,26
1657237207749,COGS 13,A01,083071,Bastos; Amalia Pinkusfeld,8,0,71,63
1657237213774,COGS 14A,A01,092681,Semenuks; Arturs,2,1,100,98
1657237219798,COGS 14B,A01,083073,Cheng; Tzu-Han,6,0,63,57
1657237225824,COGS 17,A01,092677,Semenuks; Arturs,5,0,81,76
1657237231852,COGS 100,A01,083619,Allen; Michael Gordon,16,0,70,54
1657237237878,COGS 101A,A01,083621,Davis; Joshua Daniel,9,0,68,59
1657237243904,COGS 101B,A01,091572,Allen; Michael Gordon,11,0,65,54
1657237249933,COGS 101C,A01,083625,Delgado; Tania,17,0,35,18
1657237255966,COGS 107A,A01,083627,Boyle; Mary E. T.,13,0,60,47
1657237261992,COGS 118A,A01,083075,Gupta; Anjum,16,0,76,60
1657237268022,CSE 3,A50,083646,Miranda; Gregory Joseph,24,0,50,26
1657237274045,CSE 8A,A50,083650,Miranda; Gregory Joseph,17,1,56,39
1657237280067,CSE 11,A01,083080,Cao; Yingjun,5,15,40,35
1657237286094,CSE 12,A01,083652,Krause-Levy; Sophia Louisa,26,1,120,94
1657237292116,CSE 15L,A01,083654,Morris; Justin Loren,9,0,50,41
1657237292116,CSE 15L,A02,083655,Morris; Justin Loren,9,0,50,41
1657237298139,CSE 20,A01,083657,Tran; Khoa Dang,38,0,80,42
1657237304167,CSE 21,A01,095574,Bach; Quang Tran,22,0,48,26
1657237310201,CSE 30,A01,083084,Eldon; John,4,0,80,76
1657237310201,CSE 30,B01,095061,Bhaskar; Nishant,8,0,50,42
1657237316227,CSE 100,A01,083659,Cao; Yingjun,4,4,70,66
1657237322252,CSE 134B,A01,083661,Powell; Thomas Allan,21,0,100,79
1657237328279,CSE 140,A01,083663,Gungor; Onat,13,0,85,72
1657237334301,CSE 140L,A01,083088,Eldon; John,17,0,100,83
1657237340328,CSE 175,A01,083665,Kumar; Rakesh,3,0,25,22
1657237346352,CSE 190,A00,092507,Dubnov; Shlomo,7,0,20,13
1657237352382,ECE 45,A01,083139,Congero; Spencer William,5,0,75,70
1657237358411,ECE 65,A50,083695,Saad; Andrew S,12,0,30,18
1657237358411,ECE 65,A51,095125,Saad; Andrew S,25,0,26,1
1657237364435,ECE 109,A01,091882,Touri; Behrouz,19,0,70,51
1657237370459,ECE 180,A00,083140,Abi Samra; Nicholas Camill,1,0,30,29
1657237370459,ECE 180,B00,083141,Abi Samra; Nicholas Camill,0,0,30,30
1657237376482,MATH 10A,A01,083735,Patchell; Gregory David,2,0,30,28
1657237376482,MATH 10A,A02,083736,Patchell; Gregory David,20,0,30,10
1657237376482,MATH 10A,A03,083737,Patchell; Gregory David,16,0,30,14
1657237382504,MATH 10B,A01,083207,Lim; Seonhee,7,0,34,27
1657237382504,MATH 10B,A02,083208,Lim; Seonhee,9,0,35,26
1657237382504,MATH 10B,A03,093472,Lim; Seonhee,5,0,34,29
1657237382504,MATH 10B,B01,083739,Sinha; Shubham,11,0,30,19
1657237388534,MATH 18,A01,083743,Cinel; Cameron Alexander,6,0,30,24
1657237388534,MATH 18,A02,083744,Cinel; Cameron Alexander,17,0,30,13
1657237388534,MATH 18,A03,083745,Cinel; Cameron Alexander,8,0,30,22
1657237388534,MATH 18,B01,083748,Rideout; David Porter,4,0,37,33
1657237388534,MATH 18,B02,083749,Rideout; David Porter,4,0,36,32
1657237388534,MATH 18,B03,083750,Rideout; David Porter,2,0,37,35
1657237388534,MATH 18,B04,083751,Rideout; David Porter,6,0,36,30
1657237388534,MATH 18,B05,093473,Rideout; David Porter,5,0,36,31
1657237388534,MATH 18,B06,093474,Rideout; David Porter,5,0,36,31
1657237394560,MATH 20A,A01,083754,Zheng; Zequn,14,0,40,26
1657237400585,MATH 20B,A01,083756,Briones; Jor-el Thomas Caparas,3,0,36,33
1657237400585,MATH 20B,A02,083757,Briones; Jor-el Thomas Caparas,1,0,36,35
1657237400585,MATH 20B,A03,093475,Briones; Jor-el Thomas Caparas,2,0,36,34
1657237406609,MATH 20C,A01,083760,Briones; Jor-el Thomas Caparas,1,0,35,34
1657237406609,MATH 20C,A02,083761,Briones; Jor-el Thomas Caparas,8,0,35,27
1657237406609,MATH 20C,A03,093476,Briones; Jor-el Thomas Caparas,0,1,36,36
1657237406609,MATH 20C,B01,083762,Bach; Quang Tran,1,0,30,29
1657237412642,MATH 20D,A01,083765,Tran; Brian Kha,4,0,30,26
1657237412642,MATH 20D,A02,083766,Tran; Brian Kha,5,0,30,25
1657237412642,MATH 20D,A03,083767,Tran; Brian Kha,4,0,30,26
1657237418666,MATH 20E,A01,083771,Ganguly; Soumya,7,0,32,25
1657237418666,MATH 20E,A02,083772,Ganguly; Soumya,7,0,32,25
1657237418666,MATH 20E,B01,083773,Ciotti; Benjamin,19,0,35,16
1657237418666,MATH 20E,B02,083774,Ciotti; Benjamin,17,0,35,18
1657237424689,MATH 103A,A01,083777,Greenfeld; Be'Eri,3,0,36,33
1657237424689,MATH 103A,A02,083778,Greenfeld; Be'Eri,5,0,36,31
1657237424689,MATH 103A,A03,093561,Greenfeld; Be'Eri,4,0,36,32
1657237424689,MATH 103A,B01,083779,Greenfeld; Be'Eri,6,0,36,30
1657237424689,MATH 103A,B02,083780,Greenfeld; Be'Eri,3,0,36,33
1657237424689,MATH 103A,B03,093562,Greenfeld; Be'Eri,3,0,36,33
1657237430716,MATH 105,A01,085443,Carter; Anne Toulson,15,0,35,20
1657237430716,MATH 105,A02,093477,Carter; Anne Toulson,20,0,35,15
1657237436740,MATH 109,A01,083213,Ganzberger; Geoffrey Michael,2,0,34,32
1657237436740,MATH 109,A02,083214,Ganzberger; Geoffrey Michael,4,0,34,30
1657237436740,MATH 109,A03,093478,Ganzberger; Geoffrey Michael,2,0,34,32
1657237436740,MATH 109,B01,083215,Ganzberger; Geoffrey Michael,1,0,32,31
1657237436740,MATH 109,B02,083216,Ganzberger; Geoffrey Michael,1,0,32,31
1657237436740,MATH 109,B03,093479,Ganzberger; Geoffrey Michael,8,0,32,24
1657237442764,MATH 142A,A01,083219,Chow; Bennett,6,0,32,26
1657237442764,MATH 142A,A02,083220,Chow; Bennett,10,0,32,22
1657237442764,MATH 142A,A03,093480,Chow; Bennett,7,0,32,25
1657237442764,MATH 142A,B03,093481,Chow; Bennett,8,0,32,24
1657237442764,MATH 142A,B04,093558,Chow; Bennett,12,0,32,20
1657237442764,MATH 142A,B05,093559,Chow; Bennett,6,0,32,26
1657237448793,MATH 193A,A01,083224,Rotar; Vladimir,7,0,34,27
1657237448793,MATH 193A,A02,083225,Rotar; Vladimir,6,0,34,28
1657237448793,MATH 193A,A03,083781,Rotar; Vladimir,2,0,34,32
1657237448793,MATH 193A,A04,083782,Rotar; Vladimir,8,0,34,26
1657237448793,MATH 193A,A05,093482,Rotar; Vladimir,6,0,34,28
1657237454817,MATH 197,001,091859,McAuley; Julian John,9999,0,9999,0
1657237454817,MATH 197,002,095566,Kedlaya; Kiran S.,9997,0,9999,2
1657237454817,MATH 197,003,095567,Xiao; Ming,9999,0,9999,0
1657237454817,MATH 197,004,095571,Perols; Johan Lars,9998,0,9999,1
1657237461884,COGS 9,A01,083615,Shannon; Kyle Michael,8,0,75,67
1657237467905,COGS 11,A01,083617,Boyle; Mary E. T.,22,0,48,26
1657237473938,COGS 13,A01,083071,Bastos; Amalia Pinkusfeld,8,0,71,63
1657237479964,COGS 14A,A01,092681,Semenuks; Arturs,2,1,100,98
1657237485987,COGS 14B,A01,083073,Cheng; Tzu-Han,6,0,63,57
1657237492014,COGS 17,A01,092677,Semenuks; Arturs,5,0,81,76
1657237498048,COGS 100,A01,083619,Allen; Michael Gordon,16,0,70,54
1657237504076,COGS 101A,A01,083621,Davis; Joshua Daniel,9,0,68,59
1657237510101,COGS 101B,A01,091572,Allen; Michael Gordon,11,0,65,54
1657237516130,COGS 101C,A01,083625,Delgado; Tania,17,0,35,18
1657237522158,COGS 107A,A01,083627,Boyle; Mary E. T.,13,0,60,47
1657237528185,COGS 118A,A01,083075,Gupta; Anjum,16,0,76,60
1657237534209,CSE 3,A50,083646,Miranda; Gregory Joseph,24,0,50,26
1657237540244,CSE 8A,A50,083650,Miranda; Gregory Joseph,17,1,56,39
1657237546268,CSE 11,A01,083080,Cao; Yingjun,5,15,40,35
1657237552295,CSE 12,A01,083652,Krause-Levy; Sophia Louisa,26,1,120,94
1657237558317,CSE 15L,A01,083654,Morris; Justin Loren,9,0,50,41
1657237558317,CSE 15L,A02,083655,Morris; Justin Loren,9,0,50,41
1657237564341,CSE 20,A01,083657,Tran; Khoa Dang,38,0,80,42
1657237570364,CSE 21,A01,095574,Bach; Quang Tran,22,0,48,26
1657237576388,CSE 30,A01,083084,Eldon; John,4,0,80,76
1657237576388,CSE 30,B01,095061,Bhaskar; Nishant,8,0,50,42
1657237582414,CSE 100,A01,083659,Cao; Yingjun,4,4,70,66
1657237588437,CSE 134B,A01,083661,Powell; Thomas Allan,21,0,100,79
1657237594459,CSE 140,A01,083663,Gungor; Onat,13,0,85,72
1657237600486,CSE 140L,A01,083088,Eldon; John,17,0,100,83
1657237606512,CSE 175,A01,083665,Kumar; Rakesh,3,0,25,22
1657237612544,CSE 190,A00,092507,Dubnov; Shlomo,7,0,20,13
1657237618567,ECE 45,A01,083139,Congero; Spencer William,5,0,75,70
1657237624592,ECE 65,A50,083695,Saad; Andrew S,12,0,30,18
1657237624592,ECE 65,A51,095125,Saad; Andrew S,25,0,26,1
1657237630614,ECE 109,A01,091882,Touri; Behrouz,19,0,70,51
1657237636637,ECE 180,A00,083140,Abi Samra; Nicholas Camill,1,0,30,29
1657237636637,ECE 180,B00,083141,Abi Samra; Nicholas Camill,0,0,30,30
1657237642664,MATH 10A,A01,083735,Patchell; Gregory David,2,0,30,28
1657237642664,MATH 10A,A02,083736,Patchell; Gregory David,20,0,30,10
1657237642664,MATH 10A,A03,083737,Patchell; Gregory David,16,0,30,14
1657237648692,MATH 10B,A01,083207,Lim; Seonhee,7,0,34,27
1657237648692,MATH 10B,A02,083208,Lim; Seonhee,9,0,35,26
1657237648692,MATH 10B,A03,093472,Lim; Seonhee,5,0,34,29
1657237648692,MATH 10B,B01,083739,Sinha; Shubham,11,0,30,19
1657237654733,MATH 18,A01,083743,Cinel; Cameron Alexander,6,0,30,24
1657237654733,MATH 18,A02,083744,Cinel; Cameron Alexander,17,0,30,13
1657237654733,MATH 18,A03,083745,Cinel; Cameron Alexander,8,0,30,22
1657237654733,MATH 18,B01,083748,Rideout; David Porter,4,0,37,33
1657237654733,MATH 18,B02,083749,Rideout; David Porter,4,0,36,32
1657237654733,MATH 18,B03,083750,Rideout; David Porter,2,0,37,35
1657237654733,MATH 18,B04,083751,Rideout; David Porter,6,0,36,30
1657237654733,MATH 18,B05,093473,Rideout; David Porter,5,0,36,31
1657237654733,MATH 18,B06,093474,Rideout; David Porter,5,0,36,31
1657237660756,MATH 20A,A01,083754,Zheng; Zequn,14,0,40,26
1657237666778,MATH 20B,A01,083756,Briones; Jor-el Thomas Caparas,3,0,36,33
1657237666778,MATH 20B,A02,083757,Briones; Jor-el Thomas Caparas,1,0,36,35
1657237666778,MATH 20B,A03,093475,Briones; Jor-el Thomas Caparas,2,0,36,34
1657237672810,MATH 20C,A01,083760,Briones; Jor-el Thomas Caparas,1,0,35,34
1657237672810,MATH 20C,A02,083761,Briones; Jor-el Thomas Caparas,8,0,35,27
1657237672810,MATH 20C,A03,093476,Briones; Jor-el Thomas Caparas,0,1,36,36
1657237672810,MATH 20C,B01,083762,Bach; Quang Tran,1,0,30,29
1657237678834,MATH 20D,A01,083765,Tran; Brian Kha,4,0,30,26
1657237678834,MATH 20D,A02,083766,Tran; Brian Kha,5,0,30,25
1657237678834,MATH 20D,A03,083767,Tran; Brian Kha,4,0,30,26
1657237684859,MATH 20E,A01,083771,Ganguly; Soumya,7,0,32,25
1657237684859,MATH 20E,A02,083772,Ganguly; Soumya,7,0,32,25
1657237684859,MATH 20E,B01,083773,Ciotti; Benjamin,19,0,35,16
1657237684859,MATH 20E,B02,083774,Ciotti; Benjamin,17,0,35,18
1657237690900,MATH 103A,A01,083777,Greenfeld; Be'Eri,3,0,36,33
1657237690900,MATH 103A,A02,083778,Greenfeld; Be'Eri,5,0,36,31
1657237690900,MATH 103A,A03,093561,Greenfeld; Be'Eri,4,0,36,32
1657237690900,MATH 103A,B01,083779,Greenfeld; Be'Eri,6,0,36,30
1657237690900,MATH 103A,B02,083780,Greenfeld; Be'Eri,3,0,36,33
1657237690900,MATH 103A,B03,093562,Greenfeld; Be'Eri,3,0,36,33
1657237696923,MATH 105,A01,085443,Carter; Anne Toulson,15,0,35,20
1657237696923,MATH 105,A02,093477,Carter; Anne Toulson,20,0,35,15
1657237702948,MATH 109,A01,083213,Ganzberger; Geoffrey Michael,2,0,34,32
1657237702948,MATH 109,A02,083214,Ganzberger; Geoffrey Michael,4,0,34,30
1657237702948,MATH 109,A03,093478,Ganzberger; Geoffrey Michael,2,0,34,32
1657237702948,MATH 109,B01,083215,Ganzberger; Geoffrey Michael,1,0,32,31
1657237702948,MATH 109,B02,083216,Ganzberger; Geoffrey Michael,1,0,32,31
1657237702948,MATH 109,B03,093479,Ganzberger; Geoffrey Michael,8,0,32,24
1657237708977,MATH 142A,A01,083219,Chow; Bennett,6,0,32,26
1657237708977,MATH 142A,A02,083220,Chow; Bennett,10,0,32,22
1657237708977,MATH 142A,A03,093480,Chow; Bennett,7,0,32,25
1657237708977,MATH 142A,B03,093481,Chow; Bennett,8,0,32,24
1657237708977,MATH 142A,B04,093558,Chow; Bennett,12,0,32,20
1657237708977,MATH 142A,B05,093559,Chow; Bennett,6,0,32,26
1657237715014,MATH 193A,A01,083224,Rotar; Vladimir,7,0,34,27
1657237715014,MATH 193A,A02,083225,Rotar; Vladimir,6,0,34,28
1657237715014,MATH 193A,A03,083781,Rotar; Vladimir,2,0,34,32
1657237715014,MATH 193A,A04,083782,Rotar; Vladimir,8,0,34,26
1657237715014,MATH 193A,A05,093482,Rotar; Vladimir,6,0,34,28
1657237721038,MATH 197,001,091859,McAuley; Julian John,9999,0,9999,0
1657237721038,MATH 197,002,095566,Kedlaya; Kiran S.,9997,0,9999,2
1657237721038,MATH 197,003,095567,Xiao; Ming,9999,0,9999,0
1657237721038,MATH 197,004,095571,Perols; Johan Lars,9998,0,9999,1
1657237728096,COGS 9,A01,083615,Shannon; Kyle Michael,8,0,75,67
1657237734121,COGS 11,A01,083617,Boyle; Mary E. T.,22,0,48,26
1657237740145,COGS 13,A01,083071,Bastos; Amalia Pinkusfeld,8,0,71,63
1657237746173,COGS 14A,A01,092681,Semenuks; Arturs,2,1,100,98
1657237752196,COGS 14B,A01,083073,Cheng; Tzu-Han,6,0,63,57
1657237758222,COGS 17,A01,092677,Semenuks; Arturs,5,0,81,76
1657237764249,COGS 100,A01,083619,Allen; Michael Gordon,16,0,70,54
1657237770307,COGS 101A,A01,083621,Davis; Joshua Daniel,9,0,68,59
1657237776330,COGS 101B,A01,091572,Allen; Michael Gordon,11,0,65,54
1657237782355,COGS 101C,A01,083625,Delgado; Tania,17,0,35,18
1657237788379,COGS 107A,A01,083627,Boyle; Mary E. T.,13,0,60,47
1657237794473,COGS 118A,A01,083075,Gupta; Anjum,16,0,76,60
1657237800497,CSE 3,A50,083646,Miranda; Gregory Joseph,24,0,50,26
1657237806528,CSE 8A,A50,083650,Miranda; Gregory Joseph,17,1,56,39
1657237812555,CSE 11,A01,083080,Cao; Yingjun,5,15,40,35
1657237818578,CSE 12,A01,083652,Krause-Levy; Sophia Louisa,26,1,120,94
1657237824612,CSE 15L,A01,083654,Morris; Justin Loren,9,0,50,41
1657237824612,CSE 15L,A02,083655,Morris; Justin Loren,9,0,50,41
1657237830636,CSE 20,A01,083657,Tran; Khoa Dang,38,0,80,42
1657237836657,CSE 21,A01,095574,Bach; Quang Tran,22,0,48,26
1657237842692,CSE 30,A01,083084,Eldon; John,4,0,80,76
1657237842692,CSE 30,B01,095061,Bhaskar; Nishant,8,0,50,42
1657237848722,CSE 100,A01,083659,Cao; Yingjun,4,4,70,66
1657237854747,CSE 134B,A01,083661,Powell; Thomas Allan,21,0,100,79
1657237860768,CSE 140,A01,083663,Gungor; Onat,13,0,85,72
1657237866795,CSE 140L,A01,083088,Eldon; John,17,0,100,83
1657237872822,CSE 175,A01,083665,Kumar; Rakesh,3,0,25,22
1657237878845,CSE 190,A00,092507,Dubnov; Shlomo,7,0,20,13
1657237884869,ECE 45,A01,083139,Congero; Spencer William,5,0,75,70
1657237890893,ECE 65,A50,083695,Saad; Andrew S,12,0,30,18
1657237890893,ECE 65,A51,095125,Saad; Andrew S,25,0,26,1
1657237896916,ECE 109,A01,091882,Touri; Behrouz,19,0,70,51
1657237902955,ECE 180,A00,083140,Abi Samra; Nicholas Camill,1,0,30,29
1657237902955,ECE 180,B00,083141,Abi Samra; Nicholas Camill,0,0,30,30
1657237908982,MATH 10A,A01,083735,Patchell; Gregory David,2,0,30,28
1657237908982,MATH 10A,A02,083736,Patchell; Gregory David,20,0,30,10
1657237908982,MATH 10A,A03,083737,Patchell; Gregory David,16,0,30,14
1657237915006,MATH 10B,A01,083207,Lim; Seonhee,7,0,34,27
1657237915006,MATH 10B,A02,083208,Lim; Seonhee,9,0,35,26
1657237915006,MATH 10B,A03,093472,Lim; Seonhee,5,0,34,29
1657237915006,MATH 10B,B01,083739,Sinha; Shubham,11,0,30,19
1657237921037,MATH 18,A01,083743,Cinel; Cameron Alexander,6,0,30,24
1657237921037,MATH 18,A02,083744,Cinel; Cameron Alexander,17,0,30,13
1657237921037,MATH 18,A03,083745,Cinel; Cameron Alexander,8,0,30,22
1657237921037,MATH 18,B01,083748,Rideout; David Porter,4,0,37,33
1657237921037,MATH 18,B02,083749,Rideout; David Porter,4,0,36,32
1657237921037,MATH 18,B03,083750,Rideout; David Porter,2,0,37,35
1657237921037,MATH 18,B04,083751,Rideout; David Porter,6,0,36,30
1657237921037,MATH 18,B05,093473,Rideout; David Porter,5,0,36,31
1657237921037,MATH 18,B06,093474,Rideout; David Porter,5,0,36,31
1657237927064,MATH 20A,A01,083754,Zheng; Zequn,14,0,40,26
1657237933088,MATH 20B,A01,083756,Briones; Jor-el Thomas Caparas,3,0,36,33
1657237933088,MATH 20B,A02,083757,Briones; Jor-el Thomas Caparas,1,0,36,35
1657237933088,MATH 20B,A03,093475,Briones; Jor-el Thomas Caparas,2,0,36,34
1657237939112,MATH 20C,A01,083760,Briones; Jor-el Thomas Caparas,1,0,35,34
1657237939112,MATH 20C,A02,083761,Briones; Jor-el Thomas Caparas,8,0,35,27
1657237939112,MATH 20C,A03,093476,Briones; Jor-el Thomas Caparas,0,1,36,36
1657237939112,MATH 20C,B01,083762,Bach; Quang Tran,1,0,30,29
1657237945146,MATH 20D,A01,083765,Tran; Brian Kha,4,0,30,26
1657237945146,MATH 20D,A02,083766,Tran; Brian Kha,5,0,30,25
1657237945146,MATH 20D,A03,083767,Tran; Brian Kha,4,0,30,26
1657237951175,MATH 20E,A01,083771,Ganguly; Soumya,7,0,32,25
1657237951175,MATH 20E,A02,083772,Ganguly; Soumya,7,0,32,25
1657237951175,MATH 20E,B01,083773,Ciotti; Benjamin,19,0,35,16
1657237951175,MATH 20E,B02,083774,Ciotti; Benjamin,17,0,35,18
1657237957198,MATH 103A,A01,083777,Greenfeld; Be'Eri,3,0,36,33
1657237957198,MATH 103A,A02,083778,Greenfeld; Be'Eri,5,0,36,31
1657237957198,MATH 103A,A03,093561,Greenfeld; Be'Eri,4,0,36,32
1657237957198,MATH 103A,B01,083779,Greenfeld; Be'Eri,6,0,36,30
1657237957198,MATH 103A,B02,083780,Greenfeld; Be'Eri,3,0,36,33
1657237957198,MATH 103A,B03,093562,Greenfeld; Be'Eri,3,0,36,33
1657237963224,MATH 105,A01,085443,Carter; Anne Toulson,15,0,35,20
1657237963224,MATH 105,A02,093477,Carter; Anne Toulson,20,0,35,15
1657237969264,MATH 109,A01,083213,Ganzberger; Geoffrey Michael,2,0,34,32
1657237969264,MATH 109,A02,083214,Ganzberger; Geoffrey Michael,4,0,34,30
1657237969264,MATH 109,A03,093478,Ganzberger; Geoffrey Michael,2,0,34,32
1657237969264,MATH 109,B01,083215,Ganzberger; Geoffrey Michael,1,0,32,31
1657237969264,MATH 109,B02,083216,Ganzberger; Geoffrey Michael,1,0,32,31
1657237969264,MATH 109,B03,093479,Ganzberger; Geoffrey Michael,8,0,32,24
1657237975290,MATH 142A,A01,083219,Chow; Bennett,6,0,32,26
1657237975290,MATH 142A,A02,083220,Chow; Bennett,10,0,32,22
1657237975290,MATH 142A,A03,093480,Chow; Bennett,7,0,32,25
1657237975290,MATH 142A,B03,093481,Chow; Bennett,8,0,32,24
1657237975290,MATH 142A,B04,093558,Chow; Bennett,12,0,32,20
1657237975290,MATH 142A,B05,093559,Chow; Bennett,6,0,32,26
1657237981354,MATH 193A,A01,083224,Rotar; Vladimir,7,0,34,27
1657237981354,MATH 193A,A02,083225,Rotar; Vladimir,6,0,34,28
1657237981354,MATH 193A,A03,083781,Rotar; Vladimir,2,0,34,32
1657237981354,MATH 193A,A04,083782,Rotar; Vladimir,8,0,34,26
1657237981354,MATH 193A,A05,093482,Rotar; Vladimir,6,0,34,28
1657237987378,MATH 197,001,091859,McAuley; Julian John,9999,0,9999,0
1657237987378,MATH 197,002,095566,Kedlaya; Kiran S.,9997,0,9999,2
1657237987378,MATH 197,003,095567,Xiao; Ming,9999,0,9999,0
1657237987378,MATH 197,004,095571,Perols; Johan Lars,9998,0,9999,1
1657237994433,COGS 9,A01,083615,Shannon; Kyle Michael,8,0,75,67
1657238000455,COGS 11,A01,083617,Boyle; Mary E. T.,22,0,48,26
1657238006478,COGS 13,A01,083071,Bastos; Amalia Pinkusfeld,8,0,71,63
1657238012507,COGS 14A,A01,092681,Semenuks; Arturs,2,1,100,98
1657238018536,COGS 14B,A01,083073,Cheng; Tzu-Han,6,0,63,57
1657238024563,COGS 17,A01,092677,Semenuks; Arturs,5,0,81,76
1657238030589,COGS 100,A01,083619,Allen; Michael Gordon,16,0,70,54
1657238036612,COGS 101A,A01,083621,Davis; Joshua Daniel,9,0,68,59
1657238042645,COGS 101B,A01,091572,Allen; Michael Gordon,11,0,65,54
1657238048668,COGS 101C,A01,083625,Delgado; Tania,17,0,35,18
1657238054694,COGS 107A,A01,083627,Boyle; Mary E. T.,13,0,60,47
1657238060720,COGS 118A,A01,083075,Gupta; Anjum,16,0,76,60
1657238066744,CSE 3,A50,083646,Miranda; Gregory Joseph,24,0,50,26
1657238072769,CSE 8A,A50,083650,Miranda; Gregory Joseph,17,1,56,39
1657238078792,CSE 11,A01,083080,Cao; Yingjun,5,15,40,35
1657238084815,CSE 12,A01,083652,Krause-Levy; Sophia Louisa,26,1,120,94
1657238090843,CSE 15L,A01,083654,Morris; Justin Loren,9,0,50,41
1657238090843,CSE 15L,A02,083655,Morris; Justin Loren,9,0,50,41
1657238096880,CSE 20,A01,083657,Tran; Khoa Dang,38,0,80,42
1657238102903,CSE 21,A01,095574,Bach; Quang Tran,22,0,48,26
1657238108929,CSE 30,A01,083084,Eldon; John,4,0,80,76
1657238108929,CSE 30,B01,095061,Bhaskar; Nishant,8,0,50,42
1657238114965,CSE 100,A01,083659,Cao; Yingjun,4,4,70,66
1657238120990,CSE 134B,A01,083661,Powell; Thomas Allan,21,0,100,79
1657238127022,CSE 140,A01,083663,Gungor; Onat,13,0,85,72
1657238133045,CSE 140L,A01,083088,Eldon; John,17,0,100,83
1657238147367,CSE 175,A01,083665,Kumar; Rakesh,3,0,25,22
1657238153394,CSE 190,A00,092507,Dubnov; Shlomo,7,0,20,13
1657238159419,ECE 45,A01,083139,Congero; Spencer William,5,0,75,70
1657238165446,ECE 65,A50,083695,Saad; Andrew S,12,0,30,18
1657238165446,ECE 65,A51,095125,Saad; Andrew S,25,0,26,1
1657238171482,ECE 109,A01,091882,Touri; Behrouz,19,0,70,51
1657238177506,ECE 180,A00,083140,Abi Samra; Nicholas Camill,1,0,30,29
1657238177506,ECE 180,B00,083141,Abi Samra; Nicholas Camill,0,0,30,30
1657238183534,MATH 10A,A01,083735,Patchell; Gregory David,2,0,30,28
1657238183534,MATH 10A,A02,083736,Patchell; Gregory David,20,0,30,10
1657238183534,MATH 10A,A03,083737,Patchell; Gregory David,16,0,30,14
1657238189562,MATH 10B,A01,083207,Lim; Seonhee,7,0,34,27
1657238189562,MATH 10B,A02,083208,Lim; Seonhee,9,0,35,26
1657238189562,MATH 10B,A03,093472,Lim; Seonhee,5,0,34,29
1657238189562,MATH 10B,B01,083739,Sinha; Shubham,11,0,30,19
1657238195614,MATH 18,A01,083743,Cinel; Cameron Alexander,6,0,30,24
1657238195614,MATH 18,A02,083744,Cinel; Cameron Alexander,17,0,30,13
1657238195614,MATH 18,A03,083745,Cinel; Cameron Alexander,8,0,30,22
1657238195614,MATH 18,B01,083748,Rideout; David Porter,4,0,37,33
1657238195614,MATH 18,B02,083749,Rideout; David Porter,4,0,36,32
1657238195614,MATH 18,B03,083750,Rideout; David Porter,2,0,37,35
1657238195614,MATH 18,B04,083751,Rideout; David Porter,6,0,36,30
1657238195614,MATH 18,B05,093473,Rideout; David Porter,5,0,36,31
1657238195614,MATH 18,B06,093474,Rideout; David Porter,5,0,36,31
1657238201651,MATH 20A,A01,083754,Zheng; Zequn,14,0,40,26
1657238207675,MATH 20B,A01,083756,Briones; Jor-el Thomas Caparas,3,0,36,33
1657238207675,MATH 20B,A02,083757,Briones; Jor-el Thomas Caparas,1,0,36,35
1657238207675,MATH 20B,A03,093475,Briones; Jor-el Thomas Caparas,2,0,36,34
1657238213697,MATH 20C,A01,083760,Briones; Jor-el Thomas Caparas,1,0,35,34
1657238213697,MATH 20C,A02,083761,Briones; Jor-el Thomas Caparas,8,0,35,27
1657238213697,MATH 20C,A03,093476,Briones; Jor-el Thomas Caparas,0,1,36,36
1657238213697,MATH 20C,B01,083762,Bach; Quang Tran,1,0,30,29
1657238219720,MATH 20D,A01,083765,Tran; Brian Kha,4,0,30,26
1657238219720,MATH 20D,A02,083766,Tran; Brian Kha,5,0,30,25
1657238219720,MATH 20D,A03,083767,Tran; Brian Kha,4,0,30,26
1657238225743,MATH 20E,A01,083771,Ganguly; Soumya,7,0,32,25
1657238225743,MATH 20E,A02,083772,Ganguly; Soumya,7,0,32,25
1657238225743,MATH 20E,B01,083773,Ciotti; Benjamin,19,0,35,16
1657238225743,MATH 20E,B02,083774,Ciotti; Benjamin,17,0,35,18
1657238231768,MATH 103A,A01,083777,Greenfeld; Be'Eri,3,0,36,33
1657238231768,MATH 103A,A02,083778,Greenfeld; Be'Eri,5,0,36,31
1657238231768,MATH 103A,A03,093561,Greenfeld; Be'Eri,4,0,36,32
1657238231768,MATH 103A,B01,083779,Greenfeld; Be'Eri,6,0,36,30
1657238231768,MATH 103A,B02,083780,Greenfeld; Be'Eri,3,0,36,33
1657238231768,MATH 103A,B03,093562,Greenfeld; Be'Eri,3,0,36,33
1657238237792,MATH 105,A01,085443,Carter; Anne Toulson,15,0,35,20
1657238237792,MATH 105,A02,093477,Carter; Anne Toulson,20,0,35,15
1657238243819,MATH 109,A01,083213,Ganzberger; Geoffrey Michael,2,0,34,32
1657238243819,MATH 109,A02,083214,Ganzberger; Geoffrey Michael,4,0,34,30
1657238243819,MATH 109,A03,093478,Ganzberger; Geoffrey Michael,2,0,34,32
1657238243819,MATH 109,B01,083215,Ganzberger; Geoffrey Michael,1,0,32,31
1657238243819,MATH 109,B02,083216,Ganzberger; Geoffrey Michael,1,0,32,31
1657238243819,MATH 109,B03,093479,Ganzberger; Geoffrey Michael,8,0,32,24
1657238249845,MATH 142A,A01,083219,Chow; Bennett,6,0,32,26
1657238249845,MATH 142A,A02,083220,Chow; Bennett,10,0,32,22
1657238249845,MATH 142A,A03,093480,Chow; Bennett,7,0,32,25
1657238249845,MATH 142A,B03,093481,Chow; Bennett,8,0,32,24
1657238249845,MATH 142A,B04,093558,Chow; Bennett,12,0,32,20
1657238249845,MATH 142A,B05,093559,Chow; Bennett,6,0,32,26
1657238255878,MATH 193A,A01,083224,Rotar; Vladimir,7,0,34,27
1657238255878,MATH 193A,A02,083225,Rotar; Vladimir,6,0,34,28
1657238255878,MATH 193A,A03,083781,Rotar; Vladimir,2,0,34,32
1657238255878,MATH 193A,A04,083782,Rotar; Vladimir,8,0,34,26
1657238255878,MATH 193A,A05,093482,Rotar; Vladimir,6,0,34,28
1657238261902,MATH 197,001,091859,McAuley; Julian John,9999,0,9999,0
1657238261902,MATH 197,002,095566,Kedlaya; Kiran S.,9997,0,9999,2
1657238261902,MATH 197,003,095567,Xiao; Ming,9999,0,9999,0
1657238261902,MATH 197,004,095571,Perols; Johan Lars,9998,0,9999,1
1657238268998,COGS 9,A01,083615,Shannon; Kyle Michael,8,0,75,67
1657238275020,COGS 11,A01,083617,Boyle; Mary E. T.,22,0,48,26
1657238281050,COGS 13,A01,083071,Bastos; Amalia Pinkusfeld,8,0,71,63
1657238287073,COGS 14A,A01,092681,Semenuks; Arturs,2,1,100,98
1657238293095,COGS 14B,A01,083073,Cheng; Tzu-Han,6,0,63,57
1657238299117,COGS 17,A01,092677,Semenuks; Arturs,5,0,81,76
1657238305151,COGS 100,A01,083619,Allen; Michael Gordon,16,0,70,54
1657238311179,COGS 101A,A01,083621,Davis; Joshua Daniel,9,0,68,59
1657238317202,COGS 101B,A01,091572,Allen; Michael Gordon,11,0,65,54
1657238323225,COGS 101C,A01,083625,Delgado; Tania,17,0,35,18
1657238329253,COGS 107A,A01,083627,Boyle; Mary E. T.,13,0,60,47
1657238335276,COGS 118A,A01,083075,Gupta; Anjum,16,0,76,60
1657238341302,CSE 3,A50,083646,Miranda; Gregory Joseph,24,0,50,26
1657238347327,CSE 8A,A50,083650,Miranda; Gregory Joseph,17,1,56,39
1657238353353,CSE 11,A01,083080,Cao; Yingjun,5,15,40,35
1657238359380,CSE 12,A01,083652,Krause-Levy; Sophia Louisa,26,1,120,94
1657238365404,CSE 15L,A01,083654,Morris; Justin Loren,9,0,50,41
1657238365404,CSE 15L,A02,083655,Morris; Justin Loren,9,0,50,41
1657238371430,CSE 20,A01,083657,Tran; Khoa Dang,38,0,80,42
1657238377454,CSE 21,A01,095574,Bach; Quang Tran,22,0,48,26
1657238383478,CSE 30,A01,083084,Eldon; John,4,0,80,76
1657238383478,CSE 30,B01,095061,Bhaskar; Nishant,8,0,50,42
1657238389503,CSE 100,A01,083659,Cao; Yingjun,4,4,70,66
1657238395531,CSE 134B,A01,083661,Powell; Thomas Allan,21,0,100,79
1657238401627,CSE 140,A01,083663,Gungor; Onat,13,0,85,72
1657238407650,CSE 140L,A01,083088,Eldon; John,17,0,100,83
1657238413679,CSE 175,A01,083665,Kumar; Rakesh,3,0,25,22
1657238419703,CSE 190,A00,092507,Dubnov; Shlomo,7,0,20,13
1657238425726,ECE 45,A01,083139,Congero; Spencer William,5,0,75,70
1657238431749,ECE 65,A50,083695,Saad; Andrew S,12,0,30,18
1657238431749,ECE 65,A51,095125,Saad; Andrew S,25,0,26,1
1657238437770,ECE 109,A01,091882,Touri; Behrouz,19,0,70,51
1657238443796,ECE 180,A00,083140,Abi Samra; Nicholas Camill,1,0,30,29
1657238443796,ECE 180,B00,083141,Abi Samra; Nicholas Camill,0,0,30,30
1657238449818,MATH 10A,A01,083735,Patchell; Gregory David,2,0,30,28
1657238449818,MATH 10A,A02,083736,Patchell; Gregory David,20,0,30,10
1657238449818,MATH 10A,A03,083737,Patchell; Gregory David,16,0,30,14
1657238455842,MATH 10B,A01,083207,Lim; Seonhee,7,0,34,27
1657238455842,MATH 10B,A02,083208,Lim; Seonhee,9,0,35,26
1657238455842,MATH 10B,A03,093472,Lim; Seonhee,5,0,34,29
1657238455842,MATH 10B,B01,083739,Sinha; Shubham,11,0,30,19
1657238461865,MATH 18,A01,083743,Cinel; Cameron Alexander,6,0,30,24
1657238461865,MATH 18,A02,083744,Cinel; Cameron Alexander,17,0,30,13
1657238461865,MATH 18,A03,083745,Cinel; Cameron Alexander,8,0,30,22
1657238461865,MATH 18,B01,083748,Rideout; David Porter,4,0,37,33
1657238461865,MATH 18,B02,083749,Rideout; David Porter,4,0,36,32
1657238461865,MATH 18,B03,083750,Rideout; David Porter,2,0,37,35
1657238461865,MATH 18,B04,083751,Rideout; David Porter,6,0,36,30
1657238461865,MATH 18,B05,093473,Rideout; David Porter,5,0,36,31
1657238461865,MATH 18,B06,093474,Rideout; David Porter,5,0,36,31
1657238467896,MATH 20A,A01,083754,Zheng; Zequn,14,0,40,26
1657238473918,MATH 20B,A01,083756,Briones; Jor-el Thomas Caparas,3,0,36,33
1657238473918,MATH 20B,A02,083757,Briones; Jor-el Thomas Caparas,1,0,36,35
1657238473918,MATH 20B,A03,093475,Briones; Jor-el Thomas Caparas,2,0,36,34
1657238479946,MATH 20C,A01,083760,Briones; Jor-el Thomas Caparas,1,0,35,34
1657238479946,MATH 20C,A02,083761,Briones; Jor-el Thomas Caparas,8,0,35,27
1657238479946,MATH 20C,A03,093476,Briones; Jor-el Thomas Caparas,0,1,36,36
1657238479946,MATH 20C,B01,083762,Bach; Quang Tran,1,0,30,29
1657238485969,MATH 20D,A01,083765,Tran; Brian Kha,4,0,30,26
1657238485969,MATH 20D,A02,083766,Tran; Brian Kha,5,0,30,25
1657238485969,MATH 20D,A03,083767,Tran; Brian Kha,4,0,30,26
1657238491993,MATH 20E,A01,083771,Ganguly; Soumya,7,0,32,25
1657238491993,MATH 20E,A02,083772,Ganguly; Soumya,7,0,32,25
1657238491993,MATH 20E,B01,083773,Ciotti; Benjamin,19,0,35,16
1657238491993,MATH 20E,B02,083774,Ciotti; Benjamin,17,0,35,18
1657238498026,MATH 103A,A01,083777,Greenfeld; Be'Eri,3,0,36,33
1657238498026,MATH 103A,A02,083778,Greenfeld; Be'Eri,5,0,36,31
1657238498026,MATH 103A,A03,093561,Greenfeld; Be'Eri,4,0,36,32
1657238498026,MATH 103A,B01,083779,Greenfeld; Be'Eri,6,0,36,30
1657238498026,MATH 103A,B02,083780,Greenfeld; Be'Eri,3,0,36,33
1657238498026,MATH 103A,B03,093562,Greenfeld; Be'Eri,3,0,36,33
1657238504053,MATH 105,A01,085443,Carter; Anne Toulson,15,0,35,20
1657238504053,MATH 105,A02,093477,Carter; Anne Toulson,20,0,35,15
1657238510078,MATH 109,A01,083213,Ganzberger; Geoffrey Michael,2,0,34,32
1657238510078,MATH 109,A02,083214,Ganzberger; Geoffrey Michael,4,0,34,30
1657238510078,MATH 109,A03,093478,Ganzberger; Geoffrey Michael,2,0,34,32
1657238510078,MATH 109,B01,083215,Ganzberger; Geoffrey Michael,1,0,32,31
1657238510078,MATH 109,B02,083216,Ganzberger; Geoffrey Michael,1,0,32,31
1657238510078,MATH 109,B03,093479,Ganzberger; Geoffrey Michael,8,0,32,24
1657238516102,MATH 142A,A01,083219,Chow; Bennett,6,0,32,26
1657238516102,MATH 142A,A02,083220,Chow; Bennett,10,0,32,22
1657238516102,MATH 142A,A03,093480,Chow; Bennett,7,0,32,25
1657238516102,MATH 142A,B03,093481,Chow; Bennett,8,0,32,24
1657238516102,MATH 142A,B04,093558,Chow; Bennett,12,0,32,20
1657238516102,MATH 142A,B05,093559,Chow; Bennett,6,0,32,26
1657238522131,MATH 193A,A01,083224,Rotar; Vladimir,7,0,34,27
1657238522131,MATH 193A,A02,083225,Rotar; Vladimir,6,0,34,28
1657238522131,MATH 193A,A03,083781,Rotar; Vladimir,2,0,34,32
1657238522131,MATH 193A,A04,083782,Rotar; Vladimir,8,0,34,26
1657238522131,MATH 193A,A05,093482,Rotar; Vladimir,6,0,34,28
1657238528158,MATH 197,001,091859,McAuley; Julian John,9999,0,9999,0
1657238528158,MATH 197,002,095566,Kedlaya; Kiran S.,9997,0,9999,2
1657238528158,MATH 197,003,095567,Xiao; Ming,9999,0,9999,0
1657238528158,MATH 197,004,095571,Perols; Johan Lars,9998,0,9999,1
1657238535226,COGS 9,A01,083615,Shannon; Kyle Michael,8,0,75,67
1657238541257,COGS 11,A01,083617,Boyle; Mary E. T.,22,0,48,26
1657238547281,COGS 13,A01,083071,Bastos; Amalia Pinkusfeld,8,0,71,63
1657238553313,COGS 14A,A01,092681,Semenuks; Arturs,2,1,100,98
1657238559337,COGS 14B,A01,083073,Cheng; Tzu-Han,6,0,63,57
1657238565366,COGS 17,A01,092677,Semenuks; Arturs,5,0,81,76
1657238571402,COGS 100,A01,083619,Allen; Michael Gordon,16,0,70,54
1657238577433,COGS 101A,A01,083621,Davis; Joshua Daniel,9,0,68,59
1657238583456,COGS 101B,A01,091572,Allen; Michael Gordon,11,0,65,54
1657238589486,COGS 101C,A01,083625,Delgado; Tania,17,0,35,18
1657238595513,COGS 107A,A01,083627,Boyle; Mary E. T.,13,0,60,47
1657238601539,COGS 118A,A01,083075,Gupta; Anjum,16,0,76,60
1657238607572,CSE 3,A50,083646,Miranda; Gregory Joseph,24,0,50,26
1657238613594,CSE 8A,A50,083650,Miranda; Gregory Joseph,17,1,56,39
1657238619618,CSE 11,A01,083080,Cao; Yingjun,5,15,40,35
1657238625645,CSE 12,A01,083652,Krause-Levy; Sophia Louisa,26,1,120,94
1657238631681,CSE 15L,A01,083654,Morris; Justin Loren,9,0,50,41
1657238631681,CSE 15L,A02,083655,Morris; Justin Loren,9,0,50,41
1657238637709,CSE 20,A01,083657,Tran; Khoa Dang,38,0,80,42
1657238643737,CSE 21,A01,095574,Bach; Quang Tran,22,0,48,26
1657238649762,CSE 30,A01,083084,Eldon; John,4,0,80,76
1657238649762,CSE 30,B01,095061,Bhaskar; Nishant,8,0,50,42
1657238655796,CSE 100,A01,083659,Cao; Yingjun,4,4,70,66
1657238661821,CSE 134B,A01,083661,Powell; Thomas Allan,21,0,100,79
1657238667850,CSE 140,A01,083663,Gungor; Onat,13,0,85,72
1657238673873,CSE 140L,A01,083088,Eldon; John,17,0,100,83
1657238679899,CSE 175,A01,083665,Kumar; Rakesh,3,0,25,22
1657238685923,CSE 190,A00,092507,Dubnov; Shlomo,7,0,20,13
1657238691950,ECE 45,A01,083139,Congero; Spencer William,5,0,75,70
1657238697975,ECE 65,A50,083695,Saad; Andrew S,12,0,30,18
1657238697975,ECE 65,A51,095125,Saad; Andrew S,25,0,26,1
1657238704001,ECE 109,A01,091882,Touri; Behrouz,19,0,70,51
1657238710025,ECE 180,A00,083140,Abi Samra; Nicholas Camill,1,0,30,29
1657238710025,ECE 180,B00,083141,Abi Samra; Nicholas Camill,0,0,30,30
1657238716048,MATH 10A,A01,083735,Patchell; Gregory David,2,0,30,28
1657238716048,MATH 10A,A02,083736,Patchell; Gregory David,20,0,30,10
1657238716048,MATH 10A,A03,083737,Patchell; Gregory David,16,0,30,14
1657238722072,MATH 10B,A01,083207,Lim; Seonhee,7,0,34,27
1657238722072,MATH 10B,A02,083208,Lim; Seonhee,9,0,35,26
1657238722072,MATH 10B,A03,093472,Lim; Seonhee,5,0,34,29
1657238722072,MATH 10B,B01,083739,Sinha; Shubham,11,0,30,19
1657238728097,MATH 18,A01,083743,Cinel; Cameron Alexander,6,0,30,24
1657238728097,MATH 18,A02,083744,Cinel; Cameron Alexander,17,0,30,13
1657238728097,MATH 18,A03,083745,Cinel; Cameron Alexander,8,0,30,22
1657238728097,MATH 18,B01,083748,Rideout; David Porter,4,0,37,33
1657238728097,MATH 18,B02,083749,Rideout; David Porter,4,0,36,32
1657238728097,MATH 18,B03,083750,Rideout; David Porter,2,0,37,35
1657238728097,MATH 18,B04,083751,Rideout; David Porter,6,0,36,30
1657238728097,MATH 18,B05,093473,Rideout; David Porter,5,0,36,31
1657238728097,MATH 18,B06,093474,Rideout; David Porter,5,0,36,31
1657238734125,MATH 20A,A01,083754,Zheng; Zequn,14,0,40,26
1657238740159,MATH 20B,A01,083756,Briones; Jor-el Thomas Caparas,3,0,36,33
1657238740159,MATH 20B,A02,083757,Briones; Jor-el Thomas Caparas,1,0,36,35
1657238740159,MATH 20B,A03,093475,Briones; Jor-el Thomas Caparas,2,0,36,34
1657238746182,MATH 20C,A01,083760,Briones; Jor-el Thomas Caparas,1,0,35,34
1657238746182,MATH 20C,A02,083761,Briones; Jor-el Thomas Caparas,8,0,35,27
1657238746182,MATH 20C,A03,093476,Briones; Jor-el Thomas Caparas,0,1,36,36
1657238746182,MATH 20C,B01,083762,Bach; Quang Tran,1,0,30,29
1657238752206,MATH 20D,A01,083765,Tran; Brian Kha,4,0,30,26
1657238752206,MATH 20D,A02,083766,Tran; Brian Kha,5,0,30,25
1657238752206,MATH 20D,A03,083767,Tran; Brian Kha,4,0,30,26
1657238758236,MATH 20E,A01,083771,Ganguly; Soumya,7,0,32,25
1657238758236,MATH 20E,A02,083772,Ganguly; Soumya,7,0,32,25
1657238758236,MATH 20E,B01,083773,Ciotti; Benjamin,19,0,35,16
1657238758236,MATH 20E,B02,083774,Ciotti; Benjamin,17,0,35,18
1657238764260,MATH 103A,A01,083777,Greenfeld; Be'Eri,3,0,36,33
1657238764260,MATH 103A,A02,083778,Greenfeld; Be'Eri,5,0,36,31
1657238764260,MATH 103A,A03,093561,Greenfeld; Be'Eri,4,0,36,32
1657238764260,MATH 103A,B01,083779,Greenfeld; Be'Eri,6,0,36,30
1657238764260,MATH 103A,B02,083780,Greenfeld; Be'Eri,3,0,36,33
1657238764260,MATH 103A,B03,093562,Greenfeld; Be'Eri,3,0,36,33
1657238770284,MATH 105,A01,085443,Carter; Anne Toulson,15,0,35,20
1657238770284,MATH 105,A02,093477,Carter; Anne Toulson,20,0,35,15
1657238776312,MATH 109,A01,083213,Ganzberger; Geoffrey Michael,2,0,34,32
1657238776312,MATH 109,A02,083214,Ganzberger; Geoffrey Michael,4,0,34,30
1657238776312,MATH 109,A03,093478,Ganzberger; Geoffrey Michael,2,0,34,32
1657238776312,MATH 109,B01,083215,Ganzberger; Geoffrey Michael,1,0,32,31
1657238776312,MATH 109,B02,083216,Ganzberger; Geoffrey Michael,1,0,32,31
1657238776312,MATH 109,B03,093479,Ganzberger; Geoffrey Michael,8,0,32,24
1657238782338,MATH 142A,A01,083219,Chow; Bennett,6,0,32,26
1657238782338,MATH 142A,A02,083220,Chow; Bennett,10,0,32,22
1657238782338,MATH 142A,A03,093480,Chow; Bennett,7,0,32,25
1657238782338,MATH 142A,B03,093481,Chow; Bennett,8,0,32,24
1657238782338,MATH 142A,B04,093558,Chow; Bennett,12,0,32,20
1657238782338,MATH 142A,B05,093559,Chow; Bennett,6,0,32,26
1657238788365,MATH 193A,A01,083224,Rotar; Vladimir,7,0,34,27
1657238788365,MATH 193A,A02,083225,Rotar; Vladimir,6,0,34,28
1657238788365,MATH 193A,A03,083781,Rotar; Vladimir,2,0,34,32
1657238788365,MATH 193A,A04,083782,Rotar; Vladimir,8,0,34,26
1657238788365,MATH 193A,A05,093482,Rotar; Vladimir,6,0,34,28
1657238794395,MATH 197,001,091859,McAuley; Julian John,9999,0,9999,0
1657238794395,MATH 197,002,095566,Kedlaya; Kiran S.,9997,0,9999,2
1657238794395,MATH 197,003,095567,Xiao; Ming,9999,0,9999,0
1657238794395,MATH 197,004,095571,Perols; Johan Lars,9998,0,9999,1
1657238801471,COGS 9,A01,083615,Shannon; Kyle Michael,8,0,75,67
1657238807494,COGS 11,A01,083617,Boyle; Mary E. T.,22,0,48,26
1657238813521,COGS 13,A01,083071,Bastos; Amalia Pinkusfeld,8,0,71,63
1657238819546,COGS 14A,A01,092681,Semenuks; Arturs,2,1,100,98
1657238825578,COGS 14B,A01,083073,Cheng; Tzu-Han,6,0,63,57
1657238831610,COGS 17,A01,092677,Semenuks; Arturs,5,0,81,76
1657238837634,COGS 100,A01,083619,Allen; Michael Gordon,16,0,70,54
1657238843658,COGS 101A,A01,083621,Davis; Joshua Daniel,9,0,68,59
1657238849684,COGS 101B,A01,091572,Allen; Michael Gordon,11,0,65,54
1657238855706,COGS 101C,A01,083625,Delgado; Tania,17,0,35,18
1657238861730,COGS 107A,A01,083627,Boyle; Mary E. T.,13,0,60,47
1657238867754,COGS 118A,A01,083075,Gupta; Anjum,16,0,76,60
1657238873778,CSE 3,A50,083646,Miranda; Gregory Joseph,24,0,50,26
1657238879801,CSE 8A,A50,083650,Miranda; Gregory Joseph,17,1,56,39
1657238885828,CSE 11,A01,083080,Cao; Yingjun,5,15,40,35
1657238891855,CSE 12,A01,083652,Krause-Levy; Sophia Louisa,26,1,120,94
1657238897878,CSE 15L,A01,083654,Morris; Justin Loren,9,0,50,41
1657238897878,CSE 15L,A02,083655,Morris; Justin Loren,9,0,50,41
1657238903906,CSE 20,A01,083657,Tran; Khoa Dang,38,0,80,42
1657238909934,CSE 21,A01,095574,Bach; Quang Tran,22,0,48,26
1657238915968,CSE 30,A01,083084,Eldon; John,4,0,80,76
1657238915968,CSE 30,B01,095061,Bhaskar; Nishant,8,0,50,42
1657238921995,CSE 100,A01,083659,Cao; Yingjun,4,4,70,66
1657238928021,CSE 134B,A01,083661,Powell; Thomas Allan,21,0,100,79
1657238934044,CSE 140,A01,083663,Gungor; Onat,13,0,85,72
1657238940068,CSE 140L,A01,083088,Eldon; John,17,0,100,83
1657238946091,CSE 175,A01,083665,Kumar; Rakesh,3,0,25,22
1657238952119,CSE 190,A00,092507,Dubnov; Shlomo,7,0,20,13
1657238958147,ECE 45,A01,083139,Congero; Spencer William,5,0,75,70
1657238964175,ECE 65,A50,083695,Saad; Andrew S,12,0,30,18
1657238964175,ECE 65,A51,095125,Saad; Andrew S,25,0,26,1
1657238970201,ECE 109,A01,091882,Touri; Behrouz,19,0,70,51
1657238976224,ECE 180,A00,083140,Abi Samra; Nicholas Camill,1,0,30,29
1657238976224,ECE 180,B00,083141,Abi Samra; Nicholas Camill,0,0,30,30
1657238982249,MATH 10A,A01,083735,Patchell; Gregory David,2,0,30,28
1657238982249,MATH 10A,A02,083736,Patchell; Gregory David,20,0,30,10
1657238982249,MATH 10A,A03,083737,Patchell; Gregory David,16,0,30,14
1657238988273,MATH 10B,A01,083207,Lim; Seonhee,7,0,34,27
1657238988273,MATH 10B,A02,083208,Lim; Seonhee,9,0,35,26
1657238988273,MATH 10B,A03,093472,Lim; Seonhee,5,0,34,29
1657238988273,MATH 10B,B01,083739,Sinha; Shubham,11,0,30,19
1657238994298,MATH 18,A01,083743,Cinel; Cameron Alexander,6,0,30,24
1657238994298,MATH 18,A02,083744,Cinel; Cameron Alexander,17,0,30,13
1657238994298,MATH 18,A03,083745,Cinel; Cameron Alexander,8,0,30,22
1657238994298,MATH 18,B01,083748,Rideout; David Porter,4,0,37,33
1657238994298,MATH 18,B02,083749,Rideout; David Porter,4,0,36,32
1657238994298,MATH 18,B03,083750,Rideout; David Porter,2,0,37,35
1657238994298,MATH 18,B04,083751,Rideout; David Porter,6,0,36,30
1657238994298,MATH 18,B05,093473,Rideout; David Porter,5,0,36,31
1657238994298,MATH 18,B06,093474,Rideout; David Porter,5,0,36,31
1657239000393,MATH 20A,A01,083754,Zheng; Zequn,14,0,40,26
1657239006422,MATH 20B,A01,083756,Briones; Jor-el Thomas Caparas,3,0,36,33
1657239006422,MATH 20B,A02,083757,Briones; Jor-el Thomas Caparas,1,0,36,35
1657239006422,MATH 20B,A03,093475,Briones; Jor-el Thomas Caparas,2,0,36,34
1657239012446,MATH 20C,A01,083760,Briones; Jor-el Thomas Caparas,1,0,35,34
1657239012446,MATH 20C,A02,083761,Briones; Jor-el Thomas Caparas,8,0,35,27
1657239012446,MATH 20C,A03,093476,Briones; Jor-el Thomas Caparas,0,1,36,36
1657239012446,MATH 20C,B01,083762,Bach; Quang Tran,1,0,30,29
1657239018474,MATH 20D,A01,083765,Tran; Brian Kha,4,0,30,26
1657239018474,MATH 20D,A02,083766,Tran; Brian Kha,5,0,30,25
1657239018474,MATH 20D,A03,083767,Tran; Brian Kha,4,0,30,26
1657239024502,MATH 20E,A01,083771,Ganguly; Soumya,7,0,32,25
1657239024502,MATH 20E,A02,083772,Ganguly; Soumya,7,0,32,25
1657239024502,MATH 20E,B01,083773,Ciotti; Benjamin,19,0,35,16
1657239024502,MATH 20E,B02,083774,Ciotti; Benjamin,17,0,35,18
1657239030530,MATH 103A,A01,083777,Greenfeld; Be'Eri,3,0,36,33
1657239030530,MATH 103A,A02,083778,Greenfeld; Be'Eri,5,0,36,31
1657239030530,MATH 103A,A03,093561,Greenfeld; Be'Eri,4,0,36,32
1657239030530,MATH 103A,B01,083779,Greenfeld; Be'Eri,6,0,36,30
1657239030530,MATH 103A,B02,083780,Greenfeld; Be'Eri,3,0,36,33
1657239030530,MATH 103A,B03,093562,Greenfeld; Be'Eri,3,0,36,33
1657239036557,MATH 105,A01,085443,Carter; Anne Toulson,15,0,35,20
1657239036557,MATH 105,A02,093477,Carter; Anne Toulson,20,0,35,15
1657239042581,MATH 109,A01,083213,Ganzberger; Geoffrey Michael,2,0,34,32
1657239042581,MATH 109,A02,083214,Ganzberger; Geoffrey Michael,4,0,34,30
1657239042581,MATH 109,A03,093478,Ganzberger; Geoffrey Michael,2,0,34,32
1657239042581,MATH 109,B01,083215,Ganzberger; Geoffrey Michael,1,0,32,31
1657239042581,MATH 109,B02,083216,Ganzberger; Geoffrey Michael,1,0,32,31
1657239042581,MATH 109,B03,093479,Ganzberger; Geoffrey Michael,8,0,32,24
1657239048608,MATH 142A,A01,083219,Chow; Bennett,6,0,32,26
1657239048608,MATH 142A,A02,083220,Chow; Bennett,10,0,32,22
1657239048608,MATH 142A,A03,093480,Chow; Bennett,7,0,32,25
1657239048608,MATH 142A,B03,093481,Chow; Bennett,8,0,32,24
1657239048608,MATH 142A,B04,093558,Chow; Bennett,12,0,32,20
1657239048608,MATH 142A,B05,093559,Chow; Bennett,6,0,32,26
1657239054637,MATH 193A,A01,083224,Rotar; Vladimir,7,0,34,27
1657239054637,MATH 193A,A02,083225,Rotar; Vladimir,6,0,34,28
1657239054637,MATH 193A,A03,083781,Rotar; Vladimir,2,0,34,32
1657239054637,MATH 193A,A04,083782,Rotar; Vladimir,8,0,34,26
1657239054637,MATH 193A,A05,093482,Rotar; Vladimir,6,0,34,28
1657239060664,MATH 197,001,091859,McAuley; Julian John,9999,0,9999,0
1657239060664,MATH 197,002,095566,Kedlaya; Kiran S.,9997,0,9999,2
1657239060664,MATH 197,003,095567,Xiao; Ming,9999,0,9999,0
1657239060664,MATH 197,004,095571,Perols; Johan Lars,9998,0,9999,1
1657239067722,COGS 9,A01,083615,Shannon; Kyle Michael,8,0,75,67
1657239073748,COGS 11,A01,083617,Boyle; Mary E. T.,22,0,48,26
1657239079771,COGS 13,A01,083071,Bastos; Amalia Pinkusfeld,8,0,71,63
1657239085801,COGS 14A,A01,092681,Semenuks; Arturs,2,1,100,98
1657239091824,COGS 14B,A01,083073,Cheng; Tzu-Han,6,0,63,57
1657239097846,COGS 17,A01,092677,Semenuks; Arturs,5,0,81,76
1657239103876,COGS 100,A01,083619,Allen; Michael Gordon,16,0,70,54
1657239109900,COGS 101A,A01,083621,Davis; Joshua Daniel,9,0,68,59
1657239115926,COGS 101B,A01,091572,Allen; Michael Gordon,11,0,65,54
1657239121951,COGS 101C,A01,083625,Delgado; Tania,17,0,35,18
1657239127975,COGS 107A,A01,083627,Boyle; Mary E. T.,13,0,60,47
1657239133998,COGS 118A,A01,083075,Gupta; Anjum,16,0,76,60
1657239140027,CSE 3,A50,083646,Miranda; Gregory Joseph,24,0,50,26
1657239146057,CSE 8A,A50,083650,Miranda; Gregory Joseph,17,1,56,39
1657239152086,CSE 11,A01,083080,Cao; Yingjun,5,15,40,35
1657239158120,CSE 12,A01,083652,Krause-Levy; Sophia Louisa,26,1,120,94
1657239164144,CSE 15L,A01,083654,Morris; Justin Loren,9,0,50,41
1657239164144,CSE 15L,A02,083655,Morris; Justin Loren,9,0,50,41
1657239170167,CSE 20,A01,083657,Tran; Khoa Dang,38,0,80,42
1657239176189,CSE 21,A01,095574,Bach; Quang Tran,22,0,48,26
1657239182221,CSE 30,A01,083084,Eldon; John,4,0,80,76
1657239182221,CSE 30,B01,095061,Bhaskar; Nishant,8,0,50,42
1657239188254,CSE 100,A01,083659,Cao; Yingjun,4,4,70,66
1657239194282,CSE 134B,A01,083661,Powell; Thomas Allan,21,0,100,79
1657239200309,CSE 140,A01,083663,Gungor; Onat,13,0,85,72
1657239206333,CSE 140L,A01,083088,Eldon; John,17,0,100,83
1657239212357,CSE 175,A01,083665,Kumar; Rakesh,3,0,25,22
1657239218379,CSE 190,A00,092507,Dubnov; Shlomo,7,0,20,13
1657239224402,ECE 45,A01,083139,Congero; Spencer William,5,0,75,70
1657239230429,ECE 65,A50,083695,Saad; Andrew S,12,0,30,18
1657239230429,ECE 65,A51,095125,Saad; Andrew S,25,0,26,1
1657239236455,ECE 109,A01,091882,Touri; Behrouz,19,0,70,51
1657239242484,ECE 180,A00,083140,Abi Samra; Nicholas Camill,1,0,30,29
1657239242484,ECE 180,B00,083141,Abi Samra; Nicholas Camill,0,0,30,30
1657239248508,MATH 10A,A01,083735,Patchell; Gregory David,2,0,30,28
1657239248508,MATH 10A,A02,083736,Patchell; Gregory David,20,0,30,10
1657239248508,MATH 10A,A03,083737,Patchell; Gregory David,16,0,30,14
1657239254535,MATH 10B,A01,083207,Lim; Seonhee,7,0,34,27
1657239254535,MATH 10B,A02,083208,Lim; Seonhee,9,0,35,26
1657239254535,MATH 10B,A03,093472,Lim; Seonhee,5,0,34,29
1657239254535,MATH 10B,B01,083739,Sinha; Shubham,11,0,30,19
1657239260560,MATH 18,A01,083743,Cinel; Cameron Alexander,6,0,30,24
1657239260560,MATH 18,A02,083744,Cinel; Cameron Alexander,17,0,30,13
1657239260560,MATH 18,A03,083745,Cinel; Cameron Alexander,8,0,30,22
1657239260560,MATH 18,B01,083748,Rideout; David Porter,4,0,37,33
1657239260560,MATH 18,B02,083749,Rideout; David Porter,4,0,36,32
1657239260560,MATH 18,B03,083750,Rideout; David Porter,2,0,37,35
1657239260560,MATH 18,B04,083751,Rideout; David Porter,6,0,36,30
1657239260560,MATH 18,B05,093473,Rideout; David Porter,5,0,36,31
1657239260560,MATH 18,B06,093474,Rideout; David Porter,5,0,36,31
1657239266587,MATH 20A,A01,083754,Zheng; Zequn,14,0,40,26
1657239272616,MATH 20B,A01,083756,Briones; Jor-el Thomas Caparas,3,0,36,33
1657239272616,MATH 20B,A02,083757,Briones; Jor-el Thomas Caparas,1,0,36,35
1657239272616,MATH 20B,A03,093475,Briones; Jor-el Thomas Caparas,2,0,36,34
1657239278639,MATH 20C,A01,083760,Briones; Jor-el Thomas Caparas,1,0,35,34
1657239278639,MATH 20C,A02,083761,Briones; Jor-el Thomas Caparas,8,0,35,27
1657239278639,MATH 20C,A03,093476,Briones; Jor-el Thomas Caparas,0,1,36,36
1657239278639,MATH 20C,B01,083762,Bach; Quang Tran,1,0,30,29
1657239284665,MATH 20D,A01,083765,Tran; Brian Kha,4,0,30,26
1657239284665,MATH 20D,A02,083766,Tran; Brian Kha,5,0,30,25
1657239284665,MATH 20D,A03,083767,Tran; Brian Kha,4,0,30,26
1657239290693,MATH 20E,A01,083771,Ganguly; Soumya,7,0,32,25
1657239290693,MATH 20E,A02,083772,Ganguly; Soumya,7,0,32,25
1657239290693,MATH 20E,B01,083773,Ciotti; Benjamin,19,0,35,16
1657239290693,MATH 20E,B02,083774,Ciotti; Benjamin,17,0,35,18
1657239296716,MATH 103A,A01,083777,Greenfeld; Be'Eri,3,0,36,33
1657239296716,MATH 103A,A02,083778,Greenfeld; Be'Eri,5,0,36,31
1657239296716,MATH 103A,A03,093561,Greenfeld; Be'Eri,4,0,36,32
1657239296716,MATH 103A,B01,083779,Greenfeld; Be'Eri,6,0,36,30
1657239296716,MATH 103A,B02,083780,Greenfeld; Be'Eri,3,0,36,33
1657239296716,MATH 103A,B03,093562,Greenfeld; Be'Eri,3,0,36,33
1657239302741,MATH 105,A01,085443,Carter; Anne Toulson,15,0,35,20
1657239302741,MATH 105,A02,093477,Carter; Anne Toulson,20,0,35,15
1657239308768,MATH 109,A01,083213,Ganzberger; Geoffrey Michael,2,0,34,32
1657239308768,MATH 109,A02,083214,Ganzberger; Geoffrey Michael,4,0,34,30
1657239308768,MATH 109,A03,093478,Ganzberger; Geoffrey Michael,2,0,34,32
1657239308768,MATH 109,B01,083215,Ganzberger; Geoffrey Michael,1,0,32,31
1657239308768,MATH 109,B02,083216,Ganzberger; Geoffrey Michael,1,0,32,31
1657239308768,MATH 109,B03,093479,Ganzberger; Geoffrey Michael,8,0,32,24
1657239314796,MATH 142A,A01,083219,Chow; Bennett,6,0,32,26
1657239314796,MATH 142A,A02,083220,Chow; Bennett,10,0,32,22
1657239314796,MATH 142A,A03,093480,Chow; Bennett,7,0,32,25
1657239314796,MATH 142A,B03,093481,Chow; Bennett,8,0,32,24
1657239314796,MATH 142A,B04,093558,Chow; Bennett,12,0,32,20
1657239314796,MATH 142A,B05,093559,Chow; Bennett,6,0,32,26
1657239320842,MATH 193A,A01,083224,Rotar; Vladimir,7,0,34,27
1657239320842,MATH 193A,A02,083225,Rotar; Vladimir,6,0,34,28
1657239320842,MATH 193A,A03,083781,Rotar; Vladimir,2,0,34,32
1657239320842,MATH 193A,A04,083782,Rotar; Vladimir,8,0,34,26
1657239320842,MATH 193A,A05,093482,Rotar; Vladimir,6,0,34,28
1657239326864,MATH 197,001,091859,McAuley; Julian John,9999,0,9999,0
1657239326864,MATH 197,002,095566,Kedlaya; Kiran S.,9997,0,9999,2
1657239326864,MATH 197,003,095567,Xiao; Ming,9999,0,9999,0
1657239326864,MATH 197,004,095571,Perols; Johan Lars,9998,0,9999,1
1657239333923,COGS 9,A01,083615,Shannon; Kyle Michael,8,0,75,67
1657239339945,COGS 11,A01,083617,Boyle; Mary E. T.,22,0,48,26
1657239345970,COGS 13,A01,083071,Bastos; Amalia Pinkusfeld,8,0,71,63
1657239351996,COGS 14A,A01,092681,Semenuks; Arturs,2,1,100,98
1657239358023,COGS 14B,A01,083073,Cheng; Tzu-Han,6,0,63,57
1657239364045,COGS 17,A01,092677,Semenuks; Arturs,5,0,81,76
1657239370072,COGS 100,A01,083619,Allen; Michael Gordon,16,0,70,54
1657239376130,COGS 101A,A01,083621,Davis; Joshua Daniel,9,0,68,59
1657239382153,COGS 101B,A01,091572,Allen; Michael Gordon,11,0,65,54
1657239388178,COGS 101C,A01,083625,Delgado; Tania,17,0,35,18
1657239394200,COGS 107A,A01,083627,Boyle; Mary E. T.,13,0,60,47
1657239400223,COGS 118A,A01,083075,Gupta; Anjum,16,0,76,60
1657239406247,CSE 3,A50,083646,Miranda; Gregory Joseph,24,0,50,26
1657239412279,CSE 8A,A50,083650,Miranda; Gregory Joseph,17,1,56,39
1657239418304,CSE 11,A01,083080,Cao; Yingjun,5,15,40,35
1657239424337,CSE 12,A01,083652,Krause-Levy; Sophia Louisa,26,1,120,94
1657239430368,CSE 15L,A01,083654,Morris; Justin Loren,9,0,50,41
1657239430368,CSE 15L,A02,083655,Morris; Justin Loren,9,0,50,41
1657239436399,CSE 20,A01,083657,Tran; Khoa Dang,38,0,80,42
1657239442428,CSE 21,A01,095574,Bach; Quang Tran,22,0,48,26
1657239448453,CSE 30,A01,083084,Eldon; John,4,0,80,76
1657239448453,CSE 30,B01,095061,Bhaskar; Nishant,8,0,50,42
1657239454479,CSE 100,A01,083659,Cao; Yingjun,4,4,70,66
1657239460503,CSE 134B,A01,083661,Powell; Thomas Allan,21,0,100,79
1657239466530,CSE 140,A01,083663,Gungor; Onat,13,0,85,72
1657239472555,CSE 140L,A01,083088,Eldon; John,17,0,100,83
1657239478578,CSE 175,A01,083665,Kumar; Rakesh,3,0,25,22
1657239484605,CSE 190,A00,092507,Dubnov; Shlomo,7,0,20,13
1657239490631,ECE 45,A01,083139,Congero; Spencer William,5,0,75,70
1657239496657,ECE 65,A50,083695,Saad; Andrew S,12,0,30,18
1657239496657,ECE 65,A51,095125,Saad; Andrew S,25,0,26,1
1657239502687,ECE 109,A01,091882,Touri; Behrouz,19,0,70,51
1657239508709,ECE 180,A00,083140,Abi Samra; Nicholas Camill,1,0,30,29
1657239508709,ECE 180,B00,083141,Abi Samra; Nicholas Camill,0,0,30,30
1657239514737,MATH 10A,A01,083735,Patchell; Gregory David,2,0,30,28
1657239514737,MATH 10A,A02,083736,Patchell; Gregory David,20,0,30,10
1657239514737,MATH 10A,A03,083737,Patchell; Gregory David,16,0,30,14
1657239520759,MATH 10B,A01,083207,Lim; Seonhee,7,0,34,27
1657239520759,MATH 10B,A02,083208,Lim; Seonhee,9,0,35,26
1657239520759,MATH 10B,A03,093472,Lim; Seonhee,5,0,34,29
1657239520759,MATH 10B,B01,083739,Sinha; Shubham,11,0,30,19
1657239526789,MATH 18,A01,083743,Cinel; Cameron Alexander,6,0,30,24
1657239526789,MATH 18,A02,083744,Cinel; Cameron Alexander,17,0,30,13
1657239526789,MATH 18,A03,083745,Cinel; Cameron Alexander,8,0,30,22
1657239526789,MATH 18,B01,083748,Rideout; David Porter,4,0,37,33
1657239526789,MATH 18,B02,083749,Rideout; David Porter,4,0,36,32
1657239526789,MATH 18,B03,083750,Rideout; David Porter,2,0,37,35
1657239526789,MATH 18,B04,083751,Rideout; David Porter,6,0,36,30
1657239526789,MATH 18,B05,093473,Rideout; David Porter,5,0,36,31
1657239526789,MATH 18,B06,093474,Rideout; David Porter,5,0,36,31
1657239532812,MATH 20A,A01,083754,Zheng; Zequn,14,0,40,26
1657239538834,MATH 20B,A01,083756,Briones; Jor-el Thomas Caparas,3,0,36,33
1657239538834,MATH 20B,A02,083757,Briones; Jor-el Thomas Caparas,1,0,36,35
1657239538834,MATH 20B,A03,093475,Briones; Jor-el Thomas Caparas,2,0,36,34
1657239544858,MATH 20C,A01,083760,Briones; Jor-el Thomas Caparas,1,0,35,34
1657239544858,MATH 20C,A02,083761,Briones; Jor-el Thomas Caparas,8,0,35,27
1657239544858,MATH 20C,A03,093476,Briones; Jor-el Thomas Caparas,0,1,36,36
1657239544858,MATH 20C,B01,083762,Bach; Quang Tran,1,0,30,29
1657239550882,MATH 20D,A01,083765,Tran; Brian Kha,4,0,30,26
1657239550882,MATH 20D,A02,083766,Tran; Brian Kha,5,0,30,25
1657239550882,MATH 20D,A03,083767,Tran; Brian Kha,4,0,30,26
1657239556906,MATH 20E,A01,083771,Ganguly; Soumya,7,0,32,25
1657239556906,MATH 20E,A02,083772,Ganguly; Soumya,7,0,32,25
1657239556906,MATH 20E,B01,083773,Ciotti; Benjamin,19,0,35,16
1657239556906,MATH 20E,B02,083774,Ciotti; Benjamin,17,0,35,18
1657239562945,MATH 103A,A01,083777,Greenfeld; Be'Eri,3,0,36,33
1657239562945,MATH 103A,A02,083778,Greenfeld; Be'Eri,5,0,36,31
1657239562945,MATH 103A,A03,093561,Greenfeld; Be'Eri,4,0,36,32
1657239562945,MATH 103A,B01,083779,Greenfeld; Be'Eri,6,0,36,30
1657239562945,MATH 103A,B02,083780,Greenfeld; Be'Eri,3,0,36,33
1657239562945,MATH 103A,B03,093562,Greenfeld; Be'Eri,3,0,36,33
1657239568967,MATH 105,A01,085443,Carter; Anne Toulson,15,0,35,20
1657239568967,MATH 105,A02,093477,Carter; Anne Toulson,20,0,35,15
1657239575007,MATH 109,A01,083213,Ganzberger; Geoffrey Michael,2,0,34,32
1657239575007,MATH 109,A02,083214,Ganzberger; Geoffrey Michael,4,0,34,30
1657239575007,MATH 109,A03,093478,Ganzberger; Geoffrey Michael,2,0,34,32
1657239575007,MATH 109,B01,083215,Ganzberger; Geoffrey Michael,1,0,32,31
1657239575007,MATH 109,B02,083216,Ganzberger; Geoffrey Michael,1,0,32,31
1657239575007,MATH 109,B03,093479,Ganzberger; Geoffrey Michael,8,0,32,24
1657239581055,MATH 142A,A01,083219,Chow; Bennett,6,0,32,26
1657239581055,MATH 142A,A02,083220,Chow; Bennett,10,0,32,22
1657239581055,MATH 142A,A03,093480,Chow; Bennett,7,0,32,25
1657239581055,MATH 142A,B03,093481,Chow; Bennett,8,0,32,24
1657239581055,MATH 142A,B04,093558,Chow; Bennett,12,0,32,20
1657239581055,MATH 142A,B05,093559,Chow; Bennett,6,0,32,26
1657239587084,MATH 193A,A01,083224,Rotar; Vladimir,7,0,34,27
1657239587084,MATH 193A,A02,083225,Rotar; Vladimir,6,0,34,28
1657239587084,MATH 193A,A03,083781,Rotar; Vladimir,2,0,34,32
1657239587084,MATH 193A,A04,083782,Rotar; Vladimir,8,0,34,26
1657239587084,MATH 193A,A05,093482,Rotar; Vladimir,6,0,34,28
1657239593112,MATH 197,001,091859,McAuley; Julian John,9999,0,9999,0
1657239593112,MATH 197,002,095566,Kedlaya; Kiran S.,9997,0,9999,2
1657239593112,MATH 197,003,095567,Xiao; Ming,9999,0,9999,0
1657239593112,MATH 197,004,095571,Perols; Johan Lars,9998,0,9999,1
1657239600239,COGS 9,A01,083615,Shannon; Kyle Michael,8,0,75,67
1657239606266,COGS 11,A01,083617,Boyle; Mary E. T.,22,0,48,26
1657239612297,COGS 13,A01,083071,Bastos; Amalia Pinkusfeld,8,0,71,63
1657239618322,COGS 14A,A01,092681,Semenuks; Arturs,2,1,100,98
1657239624344,COGS 14B,A01,083073,Cheng; Tzu-Han,6,0,63,57
1657239630371,COGS 17,A01,092677,Semenuks; Arturs,5,0,81,76
1657239636395,COGS 100,A01,083619,Allen; Michael Gordon,16,0,70,54
1657239642422,COGS 101A,A01,083621,Davis; Joshua Daniel,9,0,68,59
1657239648448,COGS 101B,A01,091572,Allen; Michael Gordon,11,0,65,54
1657239654478,COGS 101C,A01,083625,Delgado; Tania,17,0,35,18
1657239660502,COGS 107A,A01,083627,Boyle; Mary E. T.,13,0,60,47
1657239666525,COGS 118A,A01,083075,Gupta; Anjum,16,0,76,60
1657239672549,CSE 3,A50,083646,Miranda; Gregory Joseph,24,0,50,26
1657239678573,CSE 8A,A50,083650,Miranda; Gregory Joseph,17,1,56,39
1657239684596,CSE 11,A01,083080,Cao; Yingjun,5,15,40,35
1657239690620,CSE 12,A01,083652,Krause-Levy; Sophia Louisa,26,1,120,94
1657239696648,CSE 15L,A01,083654,Morris; Justin Loren,9,0,50,41
1657239696648,CSE 15L,A02,083655,Morris; Justin Loren,9,0,50,41
1657239702673,CSE 20,A01,083657,Tran; Khoa Dang,38,0,80,42
1657239708699,CSE 21,A01,095574,Bach; Quang Tran,22,0,48,26
1657239714722,CSE 30,A01,083084,Eldon; John,4,0,80,76
1657239714722,CSE 30,B01,095061,Bhaskar; Nishant,8,0,50,42
1657239720745,CSE 100,A01,083659,Cao; Yingjun,4,4,70,66
1657239726769,CSE 134B,A01,083661,Powell; Thomas Allan,21,0,100,79
1657239732794,CSE 140,A01,083663,Gungor; Onat,13,0,85,72
1657239738825,CSE 140L,A01,083088,Eldon; John,17,0,100,83
1657239744852,CSE 175,A01,083665,Kumar; Rakesh,3,0,25,22
1657239750875,CSE 190,A00,092507,Dubnov; Shlomo,7,0,20,13
1657239756904,ECE 45,A01,083139,Congero; Spencer William,5,0,75,70
1657239762933,ECE 65,A50,083695,Saad; Andrew S,12,0,30,18
1657239762933,ECE 65,A51,095125,Saad; Andrew S,25,0,26,1
1657239768963,ECE 109,A01,091882,Touri; Behrouz,19,0,70,51
1657239774998,ECE 180,A00,083140,Abi Samra; Nicholas Camill,1,0,30,29
1657239774998,ECE 180,B00,083141,Abi Samra; Nicholas Camill,0,0,30,30
1657239781023,MATH 10A,A01,083735,Patchell; Gregory David,2,0,30,28
1657239781023,MATH 10A,A02,083736,Patchell; Gregory David,20,0,30,10
1657239781023,MATH 10A,A03,083737,Patchell; Gregory David,16,0,30,14
1657239787046,MATH 10B,A01,083207,Lim; Seonhee,7,0,34,27
1657239787046,MATH 10B,A02,083208,Lim; Seonhee,9,0,35,26
1657239787046,MATH 10B,A03,093472,Lim; Seonhee,5,0,34,29
1657239787046,MATH 10B,B01,083739,Sinha; Shubham,11,0,30,19
1657239793077,MATH 18,A01,083743,Cinel; Cameron Alexander,6,0,30,24
1657239793077,MATH 18,A02,083744,Cinel; Cameron Alexander,17,0,30,13
1657239793077,MATH 18,A03,083745,Cinel; Cameron Alexander,8,0,30,22
1657239793077,MATH 18,B01,083748,Rideout; David Porter,4,0,37,33
1657239793077,MATH 18,B02,083749,Rideout; David Porter,4,0,36,32
1657239793077,MATH 18,B03,083750,Rideout; David Porter,2,0,37,35
1657239793077,MATH 18,B04,083751,Rideout; David Porter,6,0,36,30
1657239793077,MATH 18,B05,093473,Rideout; David Porter,5,0,36,31
1657239793077,MATH 18,B06,093474,Rideout; David Porter,5,0,36,31
1657239799102,MATH 20A,A01,083754,Zheng; Zequn,14,0,40,26
1657239805136,MATH 20B,A01,083756,Briones; Jor-el Thomas Caparas,3,0,36,33
1657239805136,MATH 20B,A02,083757,Briones; Jor-el Thomas Caparas,1,0,36,35
1657239805136,MATH 20B,A03,093475,Briones; Jor-el Thomas Caparas,2,0,36,34
1657239811159,MATH 20C,A01,083760,Briones; Jor-el Thomas Caparas,1,0,35,34
1657239811159,MATH 20C,A02,083761,Briones; Jor-el Thomas Caparas,8,0,35,27
1657239811159,MATH 20C,A03,093476,Briones; Jor-el Thomas Caparas,0,1,36,36
1657239811159,MATH 20C,B01,083762,Bach; Quang Tran,1,0,30,29
1657239817182,MATH 20D,A01,083765,Tran; Brian Kha,4,0,30,26
1657239817182,MATH 20D,A02,083766,Tran; Brian Kha,5,0,30,25
1657239817182,MATH 20D,A03,083767,Tran; Brian Kha,4,0,30,26
1657239823211,MATH 20E,A01,083771,Ganguly; Soumya,7,0,32,25
1657239823211,MATH 20E,A02,083772,Ganguly; Soumya,7,0,32,25
1657239823211,MATH 20E,B01,083773,Ciotti; Benjamin,19,0,35,16
1657239823211,MATH 20E,B02,083774,Ciotti; Benjamin,17,0,35,18
1657239829241,MATH 103A,A01,083777,Greenfeld; Be'Eri,3,0,36,33
1657239829241,MATH 103A,A02,083778,Greenfeld; Be'Eri,5,0,36,31
1657239829241,MATH 103A,A03,093561,Greenfeld; Be'Eri,4,0,36,32
1657239829241,MATH 103A,B01,083779,Greenfeld; Be'Eri,6,0,36,30
1657239829241,MATH 103A,B02,083780,Greenfeld; Be'Eri,3,0,36,33
1657239829241,MATH 103A,B03,093562,Greenfeld; Be'Eri,3,0,36,33
1657239835263,MATH 105,A01,085443,Carter; Anne Toulson,15,0,35,20
1657239835263,MATH 105,A02,093477,Carter; Anne Toulson,20,0,35,15
1657239841287,MATH 109,A01,083213,Ganzberger; Geoffrey Michael,2,0,34,32
1657239841287,MATH 109,A02,083214,Ganzberger; Geoffrey Michael,4,0,34,30
1657239841287,MATH 109,A03,093478,Ganzberger; Geoffrey Michael,2,0,34,32
1657239841287,MATH 109,B01,083215,Ganzberger; Geoffrey Michael,1,0,32,31
1657239841287,MATH 109,B02,083216,Ganzberger; Geoffrey Michael,1,0,32,31
1657239841287,MATH 109,B03,093479,Ganzberger; Geoffrey Michael,8,0,32,24
1657239847310,MATH 142A,A01,083219,Chow; Bennett,6,0,32,26
1657239847310,MATH 142A,A02,083220,Chow; Bennett,10,0,32,22
1657239847310,MATH 142A,A03,093480,Chow; Bennett,7,0,32,25
1657239847310,MATH 142A,B03,093481,Chow; Bennett,8,0,32,24
1657239847310,MATH 142A,B04,093558,Chow; Bennett,12,0,32,20
1657239847310,MATH 142A,B05,093559,Chow; Bennett,6,0,32,26
1657239853341,MATH 193A,A01,083224,Rotar; Vladimir,7,0,34,27
1657239853341,MATH 193A,A02,083225,Rotar; Vladimir,6,0,34,28
1657239853341,MATH 193A,A03,083781,Rotar; Vladimir,2,0,34,32
1657239853341,MATH 193A,A04,083782,Rotar; Vladimir,8,0,34,26
1657239853341,MATH 193A,A05,093482,Rotar; Vladimir,6,0,34,28
1657239859367,MATH 197,001,091859,McAuley; Julian John,9999,0,9999,0
1657239859367,MATH 197,002,095566,Kedlaya; Kiran S.,9997,0,9999,2
1657239859367,MATH 197,003,095567,Xiao; Ming,9999,0,9999,0
1657239859367,MATH 197,004,095571,Perols; Johan Lars,9998,0,9999,1
1657239866418,COGS 9,A01,083615,Shannon; Kyle Michael,8,0,75,67
1657239872441,COGS 11,A01,083617,Boyle; Mary E. T.,22,0,48,26
1657239878465,COGS 13,A01,083071,Bastos; Amalia Pinkusfeld,8,0,71,63
1657239884488,COGS 14A,A01,092681,Semenuks; Arturs,2,1,100,98
1657239890515,COGS 14B,A01,083073,Cheng; Tzu-Han,6,0,63,57
1657239896556,COGS 17,A01,092677,Semenuks; Arturs,5,0,81,76
1657239902577,COGS 100,A01,083619,Allen; Michael Gordon,16,0,70,54
1657239908599,COGS 101A,A01,083621,Davis; Joshua Daniel,9,0,68,59
1657239914624,COGS 101B,A01,091572,Allen; Michael Gordon,11,0,65,54
1657239920656,COGS 101C,A01,083625,Delgado; Tania,17,0,35,18
1657239926682,COGS 107A,A01,083627,Boyle; Mary E. T.,13,0,60,47
1657239932709,COGS 118A,A01,083075,Gupta; Anjum,16,0,76,60
1657239938737,CSE 3,A50,083646,Miranda; Gregory Joseph,24,0,50,26
1657239944762,CSE 8A,A50,083650,Miranda; Gregory Joseph,17,1,56,39
1657239950789,CSE 11,A01,083080,Cao; Yingjun,5,15,40,35
1657239956817,CSE 12,A01,083652,Krause-Levy; Sophia Louisa,26,1,120,94
1657239962842,CSE 15L,A01,083654,Morris; Justin Loren,9,0,50,41
1657239962842,CSE 15L,A02,083655,Morris; Justin Loren,9,0,50,41
1657239968869,CSE 20,A01,083657,Tran; Khoa Dang,38,0,80,42
1657239974893,CSE 21,A01,095574,Bach; Quang Tran,22,0,48,26
1657239980926,CSE 30,A01,083084,Eldon; John,4,0,80,76
1657239980926,CSE 30,B01,095061,Bhaskar; Nishant,8,0,50,42
1657239986949,CSE 100,A01,083659,Cao; Yingjun,4,4,70,66
1657239992997,CSE 134B,A01,083661,Powell; Thomas Allan,21,0,100,79
1657239999019,CSE 140,A01,083663,Gungor; Onat,13,0,85,72
1657240005046,CSE 140L,A01,083088,Eldon; John,17,0,100,83
1657240011069,CSE 175,A01,083665,Kumar; Rakesh,3,0,25,22
1657240017096,CSE 190,A00,092507,Dubnov; Shlomo,7,0,20,13
1657240023118,ECE 45,A01,083139,Congero; Spencer William,5,0,75,70
1657240029146,ECE 65,A50,083695,Saad; Andrew S,12,0,30,18
1657240029146,ECE 65,A51,095125,Saad; Andrew S,25,0,26,1
1657240035169,ECE 109,A01,091882,Touri; Behrouz,19,0,70,51
1657240041197,ECE 180,A00,083140,Abi Samra; Nicholas Camill,1,0,30,29
1657240041197,ECE 180,B00,083141,Abi Samra; Nicholas Camill,0,0,30,30
1657240047221,MATH 10A,A01,083735,Patchell; Gregory David,2,0,30,28
1657240047221,MATH 10A,A02,083736,Patchell; Gregory David,20,0,30,10
1657240047221,MATH 10A,A03,083737,Patchell; Gregory David,16,0,30,14
1657240053249,MATH 10B,A01,083207,Lim; Seonhee,7,0,34,27
1657240053249,MATH 10B,A02,083208,Lim; Seonhee,9,0,35,26
1657240053249,MATH 10B,A03,093472,Lim; Seonhee,5,0,34,29
1657240053249,MATH 10B,B01,083739,Sinha; Shubham,11,0,30,19
1657240059274,MATH 18,A01,083743,Cinel; Cameron Alexander,6,0,30,24
1657240059274,MATH 18,A02,083744,Cinel; Cameron Alexander,17,0,30,13
1657240059274,MATH 18,A03,083745,Cinel; Cameron Alexander,8,0,30,22
1657240059274,MATH 18,B01,083748,Rideout; David Porter,4,0,37,33
1657240059274,MATH 18,B02,083749,Rideout; David Porter,4,0,36,32
1657240059274,MATH 18,B03,083750,Rideout; David Porter,2,0,37,35
1657240059274,MATH 18,B04,083751,Rideout; David Porter,6,0,36,30
1657240059274,MATH 18,B05,093473,Rideout; David Porter,5,0,36,31
1657240059274,MATH 18,B06,093474,Rideout; David Porter,5,0,36,31
1657240065298,MATH 20A,A01,083754,Zheng; Zequn,14,0,40,26
1657240071322,MATH 20B,A01,083756,Briones; Jor-el Thomas Caparas,3,0,36,33
1657240071322,MATH 20B,A02,083757,Briones; Jor-el Thomas Caparas,1,0,36,35
1657240071322,MATH 20B,A03,093475,Briones; Jor-el Thomas Caparas,2,0,36,34
1657240077344,MATH 20C,A01,083760,Briones; Jor-el Thomas Caparas,1,0,35,34
1657240077344,MATH 20C,A02,083761,Briones; Jor-el Thomas Caparas,8,0,35,27
1657240077344,MATH 20C,A03,093476,Briones; Jor-el Thomas Caparas,0,1,36,36
1657240077344,MATH 20C,B01,083762,Bach; Quang Tran,1,0,30,29
1657240083368,MATH 20D,A01,083765,Tran; Brian Kha,4,0,30,26
1657240083368,MATH 20D,A02,083766,Tran; Brian Kha,5,0,30,25
1657240083368,MATH 20D,A03,083767,Tran; Brian Kha,4,0,30,26
1657240089394,MATH 20E,A01,083771,Ganguly; Soumya,7,0,32,25
1657240089394,MATH 20E,A02,083772,Ganguly; Soumya,7,0,32,25
1657240089394,MATH 20E,B01,083773,Ciotti; Benjamin,19,0,35,16
1657240089394,MATH 20E,B02,083774,Ciotti; Benjamin,17,0,35,18
1657240095418,MATH 103A,A01,083777,Greenfeld; Be'Eri,3,0,36,33
1657240095418,MATH 103A,A02,083778,Greenfeld; Be'Eri,5,0,36,31
1657240095418,MATH 103A,A03,093561,Greenfeld; Be'Eri,4,0,36,32
1657240095418,MATH 103A,B01,083779,Greenfeld; Be'Eri,6,0,36,30
1657240095418,MATH 103A,B02,083780,Greenfeld; Be'Eri,3,0,36,33
1657240095418,MATH 103A,B03,093562,Greenfeld; Be'Eri,3,0,36,33
1657240101445,MATH 105,A01,085443,Carter; Anne Toulson,15,0,35,20
1657240101445,MATH 105,A02,093477,Carter; Anne Toulson,20,0,35,15
1657240107469,MATH 109,A01,083213,Ganzberger; Geoffrey Michael,2,0,34,32
1657240107469,MATH 109,A02,083214,Ganzberger; Geoffrey Michael,4,0,34,30
1657240107469,MATH 109,A03,093478,Ganzberger; Geoffrey Michael,2,0,34,32
1657240107469,MATH 109,B01,083215,Ganzberger; Geoffrey Michael,1,0,32,31
1657240107469,MATH 109,B02,083216,Ganzberger; Geoffrey Michael,1,0,32,31
1657240107469,MATH 109,B03,093479,Ganzberger; Geoffrey Michael,8,0,32,24
1657240113499,MATH 142A,A01,083219,Chow; Bennett,6,0,32,26
1657240113499,MATH 142A,A02,083220,Chow; Bennett,10,0,32,22
1657240113499,MATH 142A,A03,093480,Chow; Bennett,7,0,32,25
1657240113499,MATH 142A,B03,093481,Chow; Bennett,8,0,32,24
1657240113499,MATH 142A,B04,093558,Chow; Bennett,12,0,32,20
1657240113499,MATH 142A,B05,093559,Chow; Bennett,6,0,32,26
1657240119524,MATH 193A,A01,083224,Rotar; Vladimir,7,0,34,27
1657240119524,MATH 193A,A02,083225,Rotar; Vladimir,6,0,34,28
1657240119524,MATH 193A,A03,083781,Rotar; Vladimir,2,0,34,32
1657240119524,MATH 193A,A04,083782,Rotar; Vladimir,8,0,34,26
1657240119524,MATH 193A,A05,093482,Rotar; Vladimir,6,0,34,28
1657240125550,MATH 197,001,091859,McAuley; Julian John,9999,0,9999,0
1657240125550,MATH 197,002,095566,Kedlaya; Kiran S.,9997,0,9999,2
1657240125550,MATH 197,003,095567,Xiao; Ming,9999,0,9999,0
1657240125550,MATH 197,004,095571,Perols; Johan Lars,9998,0,9999,1
1657240132611,COGS 9,A01,083615,Shannon; Kyle Michael,8,0,75,67
1657240138645,COGS 11,A01,083617,Boyle; Mary E. T.,22,0,48,26
1657240144667,COGS 13,A01,083071,Bastos; Amalia Pinkusfeld,8,0,71,63
1657240150689,COGS 14A,A01,092681,Semenuks; Arturs,2,1,100,98
1657240156715,COGS 14B,A01,083073,Cheng; Tzu-Han,6,0,63,57
1657240162741,COGS 17,A01,092677,Semenuks; Arturs,5,0,81,76
1657240168763,COGS 100,A01,083619,Allen; Michael Gordon,16,0,70,54
1657240174786,COGS 101A,A01,083621,Davis; Joshua Daniel,9,0,68,59
1657240180812,COGS 101B,A01,091572,Allen; Michael Gordon,11,0,65,54
1657240186838,COGS 101C,A01,083625,Delgado; Tania,17,0,35,18
1657240192936,COGS 107A,A01,083627,Boyle; Mary E. T.,13,0,60,47
1657240198959,COGS 118A,A01,083075,Gupta; Anjum,16,0,76,60
1657240204982,CSE 3,A50,083646,Miranda; Gregory Joseph,24,0,50,26
1657240211009,CSE 8A,A50,083650,Miranda; Gregory Joseph,17,1,56,39
1657240217042,CSE 11,A01,083080,Cao; Yingjun,5,15,40,35
1657240223065,CSE 12,A01,083652,Krause-Levy; Sophia Louisa,26,1,120,94
1657240229097,CSE 15L,A01,083654,Morris; Justin Loren,9,0,50,41
1657240229097,CSE 15L,A02,083655,Morris; Justin Loren,9,0,50,41
1657240235124,CSE 20,A01,083657,Tran; Khoa Dang,38,0,80,42
1657240241150,CSE 21,A01,095574,Bach; Quang Tran,22,0,48,26
1657240247176,CSE 30,A01,083084,Eldon; John,4,0,80,76
1657240247176,CSE 30,B01,095061,Bhaskar; Nishant,8,0,50,42
1657240253204,CSE 100,A01,083659,Cao; Yingjun,4,4,70,66
1657240259239,CSE 134B,A01,083661,Powell; Thomas Allan,21,0,100,79
1657240265262,CSE 140,A01,083663,Gungor; Onat,13,0,85,72
1657240271294,CSE 140L,A01,083088,Eldon; John,17,0,100,83
1657240277319,CSE 175,A01,083665,Kumar; Rakesh,3,0,25,22
1657240283342,CSE 190,A00,092507,Dubnov; Shlomo,7,0,20,13
1657240289366,ECE 45,A01,083139,Congero; Spencer William,5,0,75,70
1657240295395,ECE 65,A50,083695,Saad; Andrew S,12,0,30,18
1657240295395,ECE 65,A51,095125,Saad; Andrew S,25,0,26,1
1657240301429,ECE 109,A01,091882,Touri; Behrouz,19,0,70,51
1657240307457,ECE 180,A00,083140,Abi Samra; Nicholas Camill,1,0,30,29
1657240307457,ECE 180,B00,083141,Abi Samra; Nicholas Camill,0,0,30,30
1657240313482,MATH 10A,A01,083735,Patchell; Gregory David,2,0,30,28
1657240313482,MATH 10A,A02,083736,Patchell; Gregory David,20,0,30,10
1657240313482,MATH 10A,A03,083737,Patchell; Gregory David,16,0,30,14
1657240319510,MATH 10B,A01,083207,Lim; Seonhee,7,0,34,27
1657240319510,MATH 10B,A02,083208,Lim; Seonhee,9,0,35,26
1657240319510,MATH 10B,A03,093472,Lim; Seonhee,5,0,34,29
1657240319510,MATH 10B,B01,083739,Sinha; Shubham,11,0,30,19
1657240325539,MATH 18,A01,083743,Cinel; Cameron Alexander,6,0,30,24
1657240325539,MATH 18,A02,083744,Cinel; Cameron Alexander,17,0,30,13
1657240325539,MATH 18,A03,083745,Cinel; Cameron Alexander,8,0,30,22
1657240325539,MATH 18,B01,083748,Rideout; David Porter,4,0,37,33
1657240325539,MATH 18,B02,083749,Rideout; David Porter,4,0,36,32
1657240325539,MATH 18,B03,083750,Rideout; David Porter,2,0,37,35
1657240325539,MATH 18,B04,083751,Rideout; David Porter,6,0,36,30
1657240325539,MATH 18,B05,093473,Rideout; David Porter,5,0,36,31
1657240325539,MATH 18,B06,093474,Rideout; David Porter,5,0,36,31
1657240331562,MATH 20A,A01,083754,Zheng; Zequn,14,0,40,26
1657240337592,MATH 20B,A01,083756,Briones; Jor-el Thomas Caparas,3,0,36,33
1657240337592,MATH 20B,A02,083757,Briones; Jor-el Thomas Caparas,1,0,36,35
1657240337592,MATH 20B,A03,093475,Briones; Jor-el Thomas Caparas,2,0,36,34
1657240343615,MATH 20C,A01,083760,Briones; Jor-el Thomas Caparas,1,0,35,34
1657240343615,MATH 20C,A02,083761,Briones; Jor-el Thomas Caparas,8,0,35,27
1657240343615,MATH 20C,A03,093476,Briones; Jor-el Thomas Caparas,0,1,36,36
1657240343615,MATH 20C,B01,083762,Bach; Quang Tran,1,0,30,29
1657240349640,MATH 20D,A01,083765,Tran; Brian Kha,4,0,30,26
1657240349640,MATH 20D,A02,083766,Tran; Brian Kha,5,0,30,25
1657240349640,MATH 20D,A03,083767,Tran; Brian Kha,4,0,30,26
1657240355668,MATH 20E,A01,083771,Ganguly; Soumya,7,0,32,25
1657240355668,MATH 20E,A02,083772,Ganguly; Soumya,7,0,32,25
1657240355668,MATH 20E,B01,083773,Ciotti; Benjamin,19,0,35,16
1657240355668,MATH 20E,B02,083774,Ciotti; Benjamin,17,0,35,18
1657240361692,MATH 103A,A01,083777,Greenfeld; Be'Eri,3,0,36,33
1657240361692,MATH 103A,A02,083778,Greenfeld; Be'Eri,5,0,36,31
1657240361692,MATH 103A,A03,093561,Greenfeld; Be'Eri,4,0,36,32
1657240361692,MATH 103A,B01,083779,Greenfeld; Be'Eri,6,0,36,30
1657240361692,MATH 103A,B02,083780,Greenfeld; Be'Eri,3,0,36,33
1657240361692,MATH 103A,B03,093562,Greenfeld; Be'Eri,3,0,36,33
1657240367715,MATH 105,A01,085443,Carter; Anne Toulson,15,0,35,20
1657240367715,MATH 105,A02,093477,Carter; Anne Toulson,20,0,35,15
1657240373744,MATH 109,A01,083213,Ganzberger; Geoffrey Michael,2,0,34,32
1657240373744,MATH 109,A02,083214,Ganzberger; Geoffrey Michael,4,0,34,30
1657240373744,MATH 109,A03,093478,Ganzberger; Geoffrey Michael,2,0,34,32
1657240373744,MATH 109,B01,083215,Ganzberger; Geoffrey Michael,1,0,32,31
1657240373744,MATH 109,B02,083216,Ganzberger; Geoffrey Michael,1,0,32,31
1657240373744,MATH 109,B03,093479,Ganzberger; Geoffrey Michael,8,0,32,24
1657240379770,MATH 142A,A01,083219,Chow; Bennett,6,0,32,26
1657240379770,MATH 142A,A02,083220,Chow; Bennett,10,0,32,22
1657240379770,MATH 142A,A03,093480,Chow; Bennett,7,0,32,25
1657240379770,MATH 142A,B03,093481,Chow; Bennett,8,0,32,24
1657240379770,MATH 142A,B04,093558,Chow; Bennett,12,0,32,20
1657240379770,MATH 142A,B05,093559,Chow; Bennett,6,0,32,26
1657240385797,MATH 193A,A01,083224,Rotar; Vladimir,7,0,34,27
1657240385797,MATH 193A,A02,083225,Rotar; Vladimir,6,0,34,28
1657240385797,MATH 193A,A03,083781,Rotar; Vladimir,2,0,34,32
1657240385797,MATH 193A,A04,083782,Rotar; Vladimir,8,0,34,26
1657240385797,MATH 193A,A05,093482,Rotar; Vladimir,6,0,34,28
1657240391821,MATH 197,001,091859,McAuley; Julian John,9999,0,9999,0
1657240391821,MATH 197,002,095566,Kedlaya; Kiran S.,9997,0,9999,2
1657240391821,MATH 197,003,095567,Xiao; Ming,9999,0,9999,0
1657240391821,MATH 197,004,095571,Perols; Johan Lars,9998,0,9999,1
1657240398889,COGS 9,A01,083615,Shannon; Kyle Michael,8,0,75,67
1657240404915,COGS 11,A01,083617,Boyle; Mary E. T.,22,0,48,26
1657240410937,COGS 13,A01,083071,Bastos; Amalia Pinkusfeld,8,0,71,63
1657240416959,COGS 14A,A01,092681,Semenuks; Arturs,2,1,100,98
1657240422989,COGS 14B,A01,083073,Cheng; Tzu-Han,6,0,63,57
1657240429024,COGS 17,A01,092677,Semenuks; Arturs,5,0,81,76
1657240435049,COGS 100,A01,083619,Allen; Michael Gordon,16,0,70,54
1657240441071,COGS 101A,A01,083621,Davis; Joshua Daniel,9,0,68,59
1657240447095,COGS 101B,A01,091572,Allen; Michael Gordon,11,0,65,54
1657240453121,COGS 101C,A01,083625,Delgado; Tania,17,0,35,18
1657240459151,COGS 107A,A01,083627,Boyle; Mary E. T.,13,0,60,47
1657240465174,COGS 118A,A01,083075,Gupta; Anjum,16,0,76,60
1657240471201,CSE 3,A50,083646,Miranda; Gregory Joseph,24,0,50,26
1657240477228,CSE 8A,A50,083650,Miranda; Gregory Joseph,17,1,56,39
1657240483253,CSE 11,A01,083080,Cao; Yingjun,5,15,40,35
1657240489281,CSE 12,A01,083652,Krause-Levy; Sophia Louisa,26,1,120,94
1657240495307,CSE 15L,A01,083654,Morris; Justin Loren,9,0,50,41
1657240495307,CSE 15L,A02,083655,Morris; Justin Loren,9,0,50,41
1657240501335,CSE 20,A01,083657,Tran; Khoa Dang,38,0,80,42
1657240507368,CSE 21,A01,095574,Bach; Quang Tran,22,0,48,26
1657240513402,CSE 30,A01,083084,Eldon; John,4,0,80,76
1657240513402,CSE 30,B01,095061,Bhaskar; Nishant,8,0,50,42
1657240519457,CSE 100,A01,083659,Cao; Yingjun,4,4,70,66
1657240525482,CSE 134B,A01,083661,Powell; Thomas Allan,21,0,100,79
1657240531503,CSE 140,A01,083663,Gungor; Onat,13,0,85,72
1657240537529,CSE 140L,A01,083088,Eldon; John,17,0,100,83
1657240543553,CSE 175,A01,083665,Kumar; Rakesh,3,0,25,22
1657240549584,CSE 190,A00,092507,Dubnov; Shlomo,7,0,20,13
1657240555609,ECE 45,A01,083139,Congero; Spencer William,5,0,75,70
1657240561640,ECE 65,A50,083695,Saad; Andrew S,12,0,30,18
1657240561640,ECE 65,A51,095125,Saad; Andrew S,25,0,26,1
1657240567664,ECE 109,A01,091882,Touri; Behrouz,19,0,70,51
1657240573691,ECE 180,A00,083140,Abi Samra; Nicholas Camill,1,0,30,29
1657240573691,ECE 180,B00,083141,Abi Samra; Nicholas Camill,0,0,30,30
1657240579715,MATH 10A,A01,083735,Patchell; Gregory David,2,0,30,28
1657240579715,MATH 10A,A02,083736,Patchell; Gregory David,20,0,30,10
1657240579715,MATH 10A,A03,083737,Patchell; Gregory David,16,0,30,14
1657240585742,MATH 10B,A01,083207,Lim; Seonhee,7,0,34,27
1657240585742,MATH 10B,A02,083208,Lim; Seonhee,9,0,35,26
1657240585742,MATH 10B,A03,093472,Lim; Seonhee,5,0,34,29
1657240585742,MATH 10B,B01,083739,Sinha; Shubham,11,0,30,19
1657240591782,MATH 18,A01,083743,Cinel; Cameron Alexander,6,0,30,24
1657240591782,MATH 18,A02,083744,Cinel; Cameron Alexander,17,0,30,13
1657240591782,MATH 18,A03,083745,Cinel; Cameron Alexander,8,0,30,22
1657240591782,MATH 18,B01,083748,Rideout; David Porter,4,0,37,33
1657240591782,MATH 18,B02,083749,Rideout; David Porter,4,0,36,32
1657240591782,MATH 18,B03,083750,Rideout; David Porter,2,0,37,35
1657240591782,MATH 18,B04,083751,Rideout; David Porter,6,0,36,30
1657240591782,MATH 18,B05,093473,Rideout; David Porter,5,0,36,31
1657240591782,MATH 18,B06,093474,Rideout; David Porter,5,0,36,31
1657240597812,MATH 20A,A01,083754,Zheng; Zequn,14,0,40,26
1657240603839,MATH 20B,A01,083756,Briones; Jor-el Thomas Caparas,3,0,36,33
1657240603839,MATH 20B,A02,083757,Briones; Jor-el Thomas Caparas,1,0,36,35
1657240603839,MATH 20B,A03,093475,Briones; Jor-el Thomas Caparas,2,0,36,34
1657240609863,MATH 20C,A01,083760,Briones; Jor-el Thomas Caparas,1,0,35,34
1657240609863,MATH 20C,A02,083761,Briones; Jor-el Thomas Caparas,8,0,35,27
1657240609863,MATH 20C,A03,093476,Briones; Jor-el Thomas Caparas,0,1,36,36
1657240609863,MATH 20C,B01,083762,Bach; Quang Tran,1,0,30,29
1657240615887,MATH 20D,A01,083765,Tran; Brian Kha,4,0,30,26
1657240615887,MATH 20D,A02,083766,Tran; Brian Kha,5,0,30,25
1657240615887,MATH 20D,A03,083767,Tran; Brian Kha,4,0,30,26
1657240621914,MATH 20E,A01,083771,Ganguly; Soumya,7,0,32,25
1657240621914,MATH 20E,A02,083772,Ganguly; Soumya,7,0,32,25
1657240621914,MATH 20E,B01,083773,Ciotti; Benjamin,19,0,35,16
1657240621914,MATH 20E,B02,083774,Ciotti; Benjamin,17,0,35,18
1657240627946,MATH 103A,A01,083777,Greenfeld; Be'Eri,3,0,36,33
1657240627946,MATH 103A,A02,083778,Greenfeld; Be'Eri,5,0,36,31
1657240627946,MATH 103A,A03,093561,Greenfeld; Be'Eri,4,0,36,32
1657240627946,MATH 103A,B01,083779,Greenfeld; Be'Eri,6,0,36,30
1657240627946,MATH 103A,B02,083780,Greenfeld; Be'Eri,3,0,36,33
1657240627946,MATH 103A,B03,093562,Greenfeld; Be'Eri,3,0,36,33
1657240633975,MATH 105,A01,085443,Carter; Anne Toulson,15,0,35,20
1657240633975,MATH 105,A02,093477,Carter; Anne Toulson,20,0,35,15
1657240639997,MATH 109,A01,083213,Ganzberger; Geoffrey Michael,2,0,34,32
1657240639997,MATH 109,A02,083214,Ganzberger; Geoffrey Michael,4,0,34,30
1657240639997,MATH 109,A03,093478,Ganzberger; Geoffrey Michael,2,0,34,32
1657240639997,MATH 109,B01,083215,Ganzberger; Geoffrey Michael,1,0,32,31
1657240639997,MATH 109,B02,083216,Ganzberger; Geoffrey Michael,1,0,32,31
1657240639997,MATH 109,B03,093479,Ganzberger; Geoffrey Michael,8,0,32,24
1657240646024,MATH 142A,A01,083219,Chow; Bennett,6,0,32,26
1657240646024,MATH 142A,A02,083220,Chow; Bennett,10,0,32,22
1657240646024,MATH 142A,A03,093480,Chow; Bennett,7,0,32,25
1657240646024,MATH 142A,B03,093481,Chow; Bennett,8,0,32,24
1657240646024,MATH 142A,B04,093558,Chow; Bennett,12,0,32,20
1657240646024,MATH 142A,B05,093559,Chow; Bennett,6,0,32,26
1657240652062,MATH 193A,A01,083224,Rotar; Vladimir,7,0,34,27
1657240652062,MATH 193A,A02,083225,Rotar; Vladimir,6,0,34,28
1657240652062,MATH 193A,A03,083781,Rotar; Vladimir,2,0,34,32
1657240652062,MATH 193A,A04,083782,Rotar; Vladimir,8,0,34,26
1657240652062,MATH 193A,A05,093482,Rotar; Vladimir,6,0,34,28
1657240658097,MATH 197,001,091859,McAuley; Julian John,9999,0,9999,0
1657240658097,MATH 197,002,095566,Kedlaya; Kiran S.,9997,0,9999,2
1657240658097,MATH 197,003,095567,Xiao; Ming,9999,0,9999,0
1657240658097,MATH 197,004,095571,Perols; Johan Lars,9998,0,9999,1
1657240665149,COGS 9,A01,083615,Shannon; Kyle Michael,8,0,75,67
1657240671179,COGS 11,A01,083617,Boyle; Mary E. T.,22,0,48,26
1657240677201,COGS 13,A01,083071,Bastos; Amalia Pinkusfeld,8,0,71,63
1657240683228,COGS 14A,A01,092681,Semenuks; Arturs,2,1,100,98
1657240689255,COGS 14B,A01,083073,Cheng; Tzu-Han,6,0,63,57
1657240695287,COGS 17,A01,092677,Semenuks; Arturs,5,0,81,76
1657240701309,COGS 100,A01,083619,Allen; Michael Gordon,16,0,70,54
1657240707339,COGS 101A,A01,083621,Davis; Joshua Daniel,9,0,68,59
1657240713364,COGS 101B,A01,091572,Allen; Michael Gordon,11,0,65,54
1657240719388,COGS 101C,A01,083625,Delgado; Tania,17,0,35,18
1657240725410,COGS 107A,A01,083627,Boyle; Mary E. T.,13,0,60,47
1657240731438,COGS 118A,A01,083075,Gupta; Anjum,16,0,76,60
1657240737463,CSE 3,A50,083646,Miranda; Gregory Joseph,24,0,50,26
1657240743490,CSE 8A,A50,083650,Miranda; Gregory Joseph,17,1,56,39
1657240749518,CSE 11,A01,083080,Cao; Yingjun,5,15,40,35
1657240755547,CSE 12,A01,083652,Krause-Levy; Sophia Louisa,26,1,120,94
1657240761579,CSE 15L,A01,083654,Morris; Justin Loren,9,0,50,41
1657240761579,CSE 15L,A02,083655,Morris; Justin Loren,9,0,50,41
1657240767606,CSE 20,A01,083657,Tran; Khoa Dang,38,0,80,42
1657240773633,CSE 21,A01,095574,Bach; Quang Tran,22,0,48,26
1657240779657,CSE 30,A01,083084,Eldon; John,4,0,80,76
1657240779657,CSE 30,B01,095061,Bhaskar; Nishant,8,0,50,42
1657240785678,CSE 100,A01,083659,Cao; Yingjun,4,4,70,66
1657240791799,CSE 134B,A01,083661,Powell; Thomas Allan,21,0,100,79
1657240797820,CSE 140,A01,083663,Gungor; Onat,13,0,85,72
1657240803845,CSE 140L,A01,083088,Eldon; John,18,0,100,82
1657240809871,CSE 175,A01,083665,Kumar; Rakesh,3,0,25,22
1657240815906,CSE 190,A00,092507,Dubnov; Shlomo,7,0,20,13
1657240821930,ECE 45,A01,083139,Congero; Spencer William,5,0,75,70
1657240827955,ECE 65,A50,083695,Saad; Andrew S,12,0,30,18
1657240827955,ECE 65,A51,095125,Saad; Andrew S,25,0,26,1
1657240833985,ECE 109,A01,091882,Touri; Behrouz,19,0,70,51
1657240840008,ECE 180,A00,083140,Abi Samra; Nicholas Camill,1,0,30,29
1657240840008,ECE 180,B00,083141,Abi Samra; Nicholas Camill,0,0,30,30
1657240846031,MATH 10A,A01,083735,Patchell; Gregory David,2,0,30,28
1657240846031,MATH 10A,A02,083736,Patchell; Gregory David,20,0,30,10
1657240846031,MATH 10A,A03,083737,Patchell; Gregory David,16,0,30,14
1657240852054,MATH 10B,A01,083207,Lim; Seonhee,7,0,34,27
1657240852054,MATH 10B,A02,083208,Lim; Seonhee,9,0,35,26
1657240852054,MATH 10B,A03,093472,Lim; Seonhee,5,0,34,29
1657240852054,MATH 10B,B01,083739,Sinha; Shubham,11,0,30,19
1657240858086,MATH 18,A01,083743,Cinel; Cameron Alexander,6,0,30,24
1657240858086,MATH 18,A02,083744,Cinel; Cameron Alexander,17,0,30,13
1657240858086,MATH 18,A03,083745,Cinel; Cameron Alexander,8,0,30,22
1657240858086,MATH 18,B01,083748,Rideout; David Porter,4,0,37,33
1657240858086,MATH 18,B02,083749,Rideout; David Porter,4,0,36,32
1657240858086,MATH 18,B03,083750,Rideout; David Porter,2,0,37,35
1657240858086,MATH 18,B04,083751,Rideout; David Porter,6,0,36,30
1657240858086,MATH 18,B05,093473,Rideout; David Porter,5,0,36,31
1657240858086,MATH 18,B06,093474,Rideout; David Porter,5,0,36,31
1657240864112,MATH 20A,A01,083754,Zheng; Zequn,14,0,40,26
1657240870136,MATH 20B,A01,083756,Briones; Jor-el Thomas Caparas,3,0,36,33
1657240870136,MATH 20B,A02,083757,Briones; Jor-el Thomas Caparas,1,0,36,35
1657240870136,MATH 20B,A03,093475,Briones; Jor-el Thomas Caparas,2,0,36,34
1657240876158,MATH 20C,A01,083760,Briones; Jor-el Thomas Caparas,1,0,35,34
1657240876158,MATH 20C,A02,083761,Briones; Jor-el Thomas Caparas,8,0,35,27
1657240876158,MATH 20C,A03,093476,Briones; Jor-el Thomas Caparas,0,1,36,36
1657240876158,MATH 20C,B01,083762,Bach; Quang Tran,1,0,30,29
1657240882182,MATH 20D,A01,083765,Tran; Brian Kha,4,0,30,26
1657240882182,MATH 20D,A02,083766,Tran; Brian Kha,5,0,30,25
1657240882182,MATH 20D,A03,083767,Tran; Brian Kha,4,0,30,26
1657240888211,MATH 20E,A01,083771,Ganguly; Soumya,7,0,32,25
1657240888211,MATH 20E,A02,083772,Ganguly; Soumya,7,0,32,25
1657240888211,MATH 20E,B01,083773,Ciotti; Benjamin,19,0,35,16
1657240888211,MATH 20E,B02,083774,Ciotti; Benjamin,17,0,35,18
1657240894233,MATH 103A,A01,083777,Greenfeld; Be'Eri,3,0,36,33
1657240894233,MATH 103A,A02,083778,Greenfeld; Be'Eri,5,0,36,31
1657240894233,MATH 103A,A03,093561,Greenfeld; Be'Eri,4,0,36,32
1657240894233,MATH 103A,B01,083779,Greenfeld; Be'Eri,6,0,36,30
1657240894233,MATH 103A,B02,083780,Greenfeld; Be'Eri,3,0,36,33
1657240894233,MATH 103A,B03,093562,Greenfeld; Be'Eri,3,0,36,33
1657240900256,MATH 105,A01,085443,Carter; Anne Toulson,15,0,35,20
1657240900256,MATH 105,A02,093477,Carter; Anne Toulson,20,0,35,15
1657240906281,MATH 109,A01,083213,Ganzberger; Geoffrey Michael,2,0,34,32
1657240906281,MATH 109,A02,083214,Ganzberger; Geoffrey Michael,4,0,34,30
1657240906281,MATH 109,A03,093478,Ganzberger; Geoffrey Michael,2,0,34,32
1657240906281,MATH 109,B01,083215,Ganzberger; Geoffrey Michael,1,0,32,31
1657240906281,MATH 109,B02,083216,Ganzberger; Geoffrey Michael,1,0,32,31
1657240906281,MATH 109,B03,093479,Ganzberger; Geoffrey Michael,8,0,32,24
1657240912311,MATH 142A,A01,083219,Chow; Bennett,6,0,32,26
1657240912311,MATH 142A,A02,083220,Chow; Bennett,10,0,32,22
1657240912311,MATH 142A,A03,093480,Chow; Bennett,7,0,32,25
1657240912311,MATH 142A,B03,093481,Chow; Bennett,8,0,32,24
1657240912311,MATH 142A,B04,093558,Chow; Bennett,12,0,32,20
1657240912311,MATH 142A,B05,093559,Chow; Bennett,6,0,32,26
1657240918335,MATH 193A,A01,083224,Rotar; Vladimir,7,0,34,27
1657240918335,MATH 193A,A02,083225,Rotar; Vladimir,6,0,34,28
1657240918335,MATH 193A,A03,083781,Rotar; Vladimir,2,0,34,32
1657240918335,MATH 193A,A04,083782,Rotar; Vladimir,8,0,34,26
1657240918335,MATH 193A,A05,093482,Rotar; Vladimir,6,0,34,28
1657240924361,MATH 197,001,091859,McAuley; Julian John,9999,0,9999,0
1657240924361,MATH 197,002,095566,Kedlaya; Kiran S.,9997,0,9999,2
1657240924361,MATH 197,003,095567,Xiao; Ming,9999,0,9999,0
1657240924361,MATH 197,004,095571,Perols; Johan Lars,9998,0,9999,1
1657240931428,COGS 9,A01,083615,Shannon; Kyle Michael,8,0,75,67
1657240937453,COGS 11,A01,083617,Boyle; Mary E. T.,22,0,48,26
1657240943476,COGS 13,A01,083071,Bastos; Amalia Pinkusfeld,8,0,71,63
1657240949503,COGS 14A,A01,092681,Semenuks; Arturs,2,1,100,98
1657240955535,COGS 14B,A01,083073,Cheng; Tzu-Han,6,0,63,57
1657240961570,COGS 17,A01,092677,Semenuks; Arturs,5,0,81,76
1657240967603,COGS 100,A01,083619,Allen; Michael Gordon,16,0,70,54
1657240973625,COGS 101A,A01,083621,Davis; Joshua Daniel,9,0,68,59
1657240979650,COGS 101B,A01,091572,Allen; Michael Gordon,11,0,65,54
1657240985676,COGS 101C,A01,083625,Delgado; Tania,17,0,35,18
1657240991711,COGS 107A,A01,083627,Boyle; Mary E. T.,13,0,60,47
1657240997738,COGS 118A,A01,083075,Gupta; Anjum,16,0,76,60
1657241003763,CSE 3,A50,083646,Miranda; Gregory Joseph,24,0,50,26
1657241009803,CSE 8A,A50,083650,Miranda; Gregory Joseph,17,1,56,39
1657241015829,CSE 11,A01,083080,Cao; Yingjun,5,15,40,35
1657241021853,CSE 12,A01,083652,Krause-Levy; Sophia Louisa,26,1,120,94
1657241027876,CSE 15L,A01,083654,Morris; Justin Loren,9,0,50,41
1657241027876,CSE 15L,A02,083655,Morris; Justin Loren,9,0,50,41
1657241033898,CSE 20,A01,083657,Tran; Khoa Dang,38,0,80,42
1657241039920,CSE 21,A01,095574,Bach; Quang Tran,22,0,48,26
1657241045947,CSE 30,A01,083084,Eldon; John,4,0,80,76
1657241045947,CSE 30,B01,095061,Bhaskar; Nishant,8,0,50,42
1657241051980,CSE 100,A01,083659,Cao; Yingjun,4,4,70,66
1657241058005,CSE 134B,A01,083661,Powell; Thomas Allan,21,0,100,79
1657241064031,CSE 140,A01,083663,Gungor; Onat,13,0,85,72
1657241070055,CSE 140L,A01,083088,Eldon; John,18,0,100,82
1657241076078,CSE 175,A01,083665,Kumar; Rakesh,3,0,25,22
1657241082108,CSE 190,A00,092507,Dubnov; Shlomo,7,0,20,13
1657241088135,ECE 45,A01,083139,Congero; Spencer William,5,0,75,70
1657241094161,ECE 65,A50,083695,Saad; Andrew S,12,0,30,18
1657241094161,ECE 65,A51,095125,Saad; Andrew S,25,0,26,1
1657241100185,ECE 109,A01,091882,Touri; Behrouz,19,0,70,51
1657241106207,ECE 180,A00,083140,Abi Samra; Nicholas Camill,1,0,30,29
1657241106207,ECE 180,B00,083141,Abi Samra; Nicholas Camill,0,0,30,30
1657241112234,MATH 10A,A01,083735,Patchell; Gregory David,2,0,30,28
1657241112234,MATH 10A,A02,083736,Patchell; Gregory David,20,0,30,10
1657241112234,MATH 10A,A03,083737,Patchell; Gregory David,16,0,30,14
1657241118261,MATH 10B,A01,083207,Lim; Seonhee,7,0,34,27
1657241118261,MATH 10B,A02,083208,Lim; Seonhee,9,0,35,26
1657241118261,MATH 10B,A03,093472,Lim; Seonhee,5,0,34,29
1657241118261,MATH 10B,B01,083739,Sinha; Shubham,11,0,30,19
1657241124287,MATH 18,A01,083743,Cinel; Cameron Alexander,6,0,30,24
1657241124287,MATH 18,A02,083744,Cinel; Cameron Alexander,17,0,30,13
1657241124287,MATH 18,A03,083745,Cinel; Cameron Alexander,8,0,30,22
1657241124287,MATH 18,B01,083748,Rideout; David Porter,4,0,37,33
1657241124287,MATH 18,B02,083749,Rideout; David Porter,4,0,36,32
1657241124287,MATH 18,B03,083750,Rideout; David Porter,2,0,37,35
1657241124287,MATH 18,B04,083751,Rideout; David Porter,6,0,36,30
1657241124287,MATH 18,B05,093473,Rideout; David Porter,5,0,36,31
1657241124287,MATH 18,B06,093474,Rideout; David Porter,5,0,36,31
1657241130310,MATH 20A,A01,083754,Zheng; Zequn,14,0,40,26
1657241136337,MATH 20B,A01,083756,Briones; Jor-el Thomas Caparas,3,0,36,33
1657241136337,MATH 20B,A02,083757,Briones; Jor-el Thomas Caparas,1,0,36,35
1657241136337,MATH 20B,A03,093475,Briones; Jor-el Thomas Caparas,2,0,36,34
1657241142362,MATH 20C,A01,083760,Briones; Jor-el Thomas Caparas,1,0,35,34
1657241142362,MATH 20C,A02,083761,Briones; Jor-el Thomas Caparas,8,0,35,27
1657241142362,MATH 20C,A03,093476,Briones; Jor-el Thomas Caparas,0,1,36,36
1657241142362,MATH 20C,B01,083762,Bach; Quang Tran,1,0,30,29
1657241148388,MATH 20D,A01,083765,Tran; Brian Kha,4,0,30,26
1657241148388,MATH 20D,A02,083766,Tran; Brian Kha,5,0,30,25
1657241148388,MATH 20D,A03,083767,Tran; Brian Kha,4,0,30,26
1657241154413,MATH 20E,A01,083771,Ganguly; Soumya,7,0,32,25
1657241154413,MATH 20E,A02,083772,Ganguly; Soumya,7,0,32,25
1657241154413,MATH 20E,B01,083773,Ciotti; Benjamin,19,0,35,16
1657241154413,MATH 20E,B02,083774,Ciotti; Benjamin,17,0,35,18
1657241160443,MATH 103A,A01,083777,Greenfeld; Be'Eri,3,0,36,33
1657241160443,MATH 103A,A02,083778,Greenfeld; Be'Eri,5,0,36,31
1657241160443,MATH 103A,A03,093561,Greenfeld; Be'Eri,4,0,36,32
1657241160443,MATH 103A,B01,083779,Greenfeld; Be'Eri,6,0,36,30
1657241160443,MATH 103A,B02,083780,Greenfeld; Be'Eri,3,0,36,33
1657241160443,MATH 103A,B03,093562,Greenfeld; Be'Eri,3,0,36,33
1657241166469,MATH 105,A01,085443,Carter; Anne Toulson,15,0,35,20
1657241166469,MATH 105,A02,093477,Carter; Anne Toulson,20,0,35,15
1657241172491,MATH 109,A01,083213,Ganzberger; Geoffrey Michael,2,0,34,32
1657241172491,MATH 109,A02,083214,Ganzberger; Geoffrey Michael,4,0,34,30
1657241172491,MATH 109,A03,093478,Ganzberger; Geoffrey Michael,2,0,34,32
1657241172491,MATH 109,B01,083215,Ganzberger; Geoffrey Michael,1,0,32,31
1657241172491,MATH 109,B02,083216,Ganzberger; Geoffrey Michael,1,0,32,31
1657241172491,MATH 109,B03,093479,Ganzberger; Geoffrey Michael,8,0,32,24
1657241178521,MATH 142A,A01,083219,Chow; Bennett,6,0,32,26
1657241178521,MATH 142A,A02,083220,Chow; Bennett,10,0,32,22
1657241178521,MATH 142A,A03,093480,Chow; Bennett,7,0,32,25
1657241178521,MATH 142A,B03,093481,Chow; Bennett,8,0,32,24
1657241178521,MATH 142A,B04,093558,Chow; Bennett,12,0,32,20
1657241178521,MATH 142A,B05,093559,Chow; Bennett,6,0,32,26
1657241184543,MATH 193A,A01,083224,Rotar; Vladimir,7,0,34,27
1657241184543,MATH 193A,A02,083225,Rotar; Vladimir,6,0,34,28
1657241184543,MATH 193A,A03,083781,Rotar; Vladimir,2,0,34,32
1657241184543,MATH 193A,A04,083782,Rotar; Vladimir,8,0,34,26
1657241184543,MATH 193A,A05,093482,Rotar; Vladimir,6,0,34,28
1657241190567,MATH 197,001,091859,McAuley; Julian John,9999,0,9999,0
1657241190567,MATH 197,002,095566,Kedlaya; Kiran S.,9997,0,9999,2
1657241190567,MATH 197,003,095567,Xiao; Ming,9999,0,9999,0
1657241190567,MATH 197,004,095571,Perols; Johan Lars,9998,0,9999,1
1657241197639,COGS 9,A01,083615,Shannon; Kyle Michael,8,0,75,67
1657241203671,COGS 11,A01,083617,Boyle; Mary E. T.,22,0,48,26
1657241209692,COGS 13,A01,083071,Bastos; Amalia Pinkusfeld,8,0,71,63
1657241215715,COGS 14A,A01,092681,Semenuks; Arturs,2,1,100,98
1657241221738,COGS 14B,A01,083073,Cheng; Tzu-Han,6,0,63,57
1657241227760,COGS 17,A01,092677,Semenuks; Arturs,5,0,81,76
1657241233786,COGS 100,A01,083619,Allen; Michael Gordon,16,0,70,54
1657241239809,COGS 101A,A01,083621,Davis; Joshua Daniel,9,0,68,59
1657241245844,COGS 101B,A01,091572,Allen; Michael Gordon,11,0,65,54
1657241251867,COGS 101C,A01,083625,Delgado; Tania,17,0,35,18
1657241257893,COGS 107A,A01,083627,Boyle; Mary E. T.,13,0,60,47
1657241263921,COGS 118A,A01,083075,Gupta; Anjum,16,0,76,60
1657241269950,CSE 3,A50,083646,Miranda; Gregory Joseph,24,0,50,26
1657241275976,CSE 8A,A50,083650,Miranda; Gregory Joseph,17,1,56,39
1657241281997,CSE 11,A01,083080,Cao; Yingjun,5,15,40,35
1657241288020,CSE 12,A01,083652,Krause-Levy; Sophia Louisa,26,1,120,94
1657241294046,CSE 15L,A01,083654,Morris; Justin Loren,9,0,50,41
1657241294046,CSE 15L,A02,083655,Morris; Justin Loren,9,0,50,41
1657241300068,CSE 20,A01,083657,Tran; Khoa Dang,38,0,80,42
1657241306095,CSE 21,A01,095574,Bach; Quang Tran,22,0,48,26
1657241312124,CSE 30,A01,083084,Eldon; John,4,0,80,76
1657241312124,CSE 30,B01,095061,Bhaskar; Nishant,8,0,50,42
1657241318165,CSE 100,A01,083659,Cao; Yingjun,4,4,70,66
1657241324194,CSE 134B,A01,083661,Powell; Thomas Allan,21,0,100,79
1657241330220,CSE 140,A01,083663,Gungor; Onat,13,0,85,72
1657241336242,CSE 140L,A01,083088,Eldon; John,18,0,100,82
1657241342281,CSE 175,A01,083665,Kumar; Rakesh,3,0,25,22
1657241348308,CSE 190,A00,092507,Dubnov; Shlomo,7,0,20,13
1657241354331,ECE 45,A01,083139,Congero; Spencer William,5,0,75,70
1657241360358,ECE 65,A50,083695,Saad; Andrew S,12,0,30,18
1657241360358,ECE 65,A51,095125,Saad; Andrew S,25,0,26,1
1657241366386,ECE 109,A01,091882,Touri; Behrouz,19,0,70,51
1657241372408,ECE 180,A00,083140,Abi Samra; Nicholas Camill,1,0,30,29
1657241372408,ECE 180,B00,083141,Abi Samra; Nicholas Camill,0,0,30,30
1657241378437,MATH 10A,A01,083735,Patchell; Gregory David,2,0,30,28
1657241378437,MATH 10A,A02,083736,Patchell; Gregory David,20,0,30,10
1657241378437,MATH 10A,A03,083737,Patchell; Gregory David,16,0,30,14
1657241384465,MATH 10B,A01,083207,Lim; Seonhee,7,0,34,27
1657241384465,MATH 10B,A02,083208,Lim; Seonhee,9,0,35,26
1657241384465,MATH 10B,A03,093472,Lim; Seonhee,5,0,34,29
1657241384465,MATH 10B,B01,083739,Sinha; Shubham,11,0,30,19
1657241390571,MATH 18,A01,083743,Cinel; Cameron Alexander,6,0,30,24
1657241390571,MATH 18,A02,083744,Cinel; Cameron Alexander,17,0,30,13
1657241390571,MATH 18,A03,083745,Cinel; Cameron Alexander,8,0,30,22
1657241390571,MATH 18,B01,083748,Rideout; David Porter,4,0,37,33
1657241390571,MATH 18,B02,083749,Rideout; David Porter,4,0,36,32
1657241390571,MATH 18,B03,083750,Rideout; David Porter,2,0,37,35
1657241390571,MATH 18,B04,083751,Rideout; David Porter,6,0,36,30
1657241390571,MATH 18,B05,093473,Rideout; David Porter,5,0,36,31
1657241390571,MATH 18,B06,093474,Rideout; David Porter,5,0,36,31
1657241396598,MATH 20A,A01,083754,Zheng; Zequn,14,0,40,26
1657241402625,MATH 20B,A01,083756,Briones; Jor-el Thomas Caparas,3,0,36,33
1657241402625,MATH 20B,A02,083757,Briones; Jor-el Thomas Caparas,1,0,36,35
1657241402625,MATH 20B,A03,093475,Briones; Jor-el Thomas Caparas,2,0,36,34
1657241408652,MATH 20C,A01,083760,Briones; Jor-el Thomas Caparas,1,0,35,34
1657241408652,MATH 20C,A02,083761,Briones; Jor-el Thomas Caparas,8,0,35,27
1657241408652,MATH 20C,A03,093476,Briones; Jor-el Thomas Caparas,0,1,36,36
1657241408652,MATH 20C,B01,083762,Bach; Quang Tran,1,0,30,29
1657241414683,MATH 20D,A01,083765,Tran; Brian Kha,4,0,30,26
1657241414683,MATH 20D,A02,083766,Tran; Brian Kha,5,0,30,25
1657241414683,MATH 20D,A03,083767,Tran; Brian Kha,4,0,30,26
1657241420711,MATH 20E,A01,083771,Ganguly; Soumya,7,0,32,25
1657241420711,MATH 20E,A02,083772,Ganguly; Soumya,7,0,32,25
1657241420711,MATH 20E,B01,083773,Ciotti; Benjamin,19,0,35,16
1657241420711,MATH 20E,B02,083774,Ciotti; Benjamin,17,0,35,18
1657241426740,MATH 103A,A01,083777,Greenfeld; Be'Eri,3,0,36,33
1657241426740,MATH 103A,A02,083778,Greenfeld; Be'Eri,5,0,36,31
1657241426740,MATH 103A,A03,093561,Greenfeld; Be'Eri,4,0,36,32
1657241426740,MATH 103A,B01,083779,Greenfeld; Be'Eri,6,0,36,30
1657241426740,MATH 103A,B02,083780,Greenfeld; Be'Eri,3,0,36,33
1657241426740,MATH 103A,B03,093562,Greenfeld; Be'Eri,3,0,36,33
1657241432763,MATH 105,A01,085443,Carter; Anne Toulson,15,0,35,20
1657241432763,MATH 105,A02,093477,Carter; Anne Toulson,20,0,35,15
1657241438791,MATH 109,A01,083213,Ganzberger; Geoffrey Michael,2,0,34,32
1657241438791,MATH 109,A02,083214,Ganzberger; Geoffrey Michael,4,0,34,30
1657241438791,MATH 109,A03,093478,Ganzberger; Geoffrey Michael,2,0,34,32
1657241438791,MATH 109,B01,083215,Ganzberger; Geoffrey Michael,1,0,32,31
1657241438791,MATH 109,B02,083216,Ganzberger; Geoffrey Michael,1,0,32,31
1657241438791,MATH 109,B03,093479,Ganzberger; Geoffrey Michael,8,0,32,24
1657241444815,MATH 142A,A01,083219,Chow; Bennett,6,0,32,26
1657241444815,MATH 142A,A02,083220,Chow; Bennett,10,0,32,22
1657241444815,MATH 142A,A03,093480,Chow; Bennett,7,0,32,25
1657241444815,MATH 142A,B03,093481,Chow; Bennett,8,0,32,24
1657241444815,MATH 142A,B04,093558,Chow; Bennett,12,0,32,20
1657241444815,MATH 142A,B05,093559,Chow; Bennett,6,0,32,26
1657241450841,MATH 193A,A01,083224,Rotar; Vladimir,7,0,34,27
1657241450841,MATH 193A,A02,083225,Rotar; Vladimir,6,0,34,28
1657241450841,MATH 193A,A03,083781,Rotar; Vladimir,2,0,34,32
1657241450841,MATH 193A,A04,083782,Rotar; Vladimir,8,0,34,26
1657241450841,MATH 193A,A05,093482,Rotar; Vladimir,6,0,34,28
1657241456868,MATH 197,001,091859,McAuley; Julian John,9999,0,9999,0
1657241456868,MATH 197,002,095566,Kedlaya; Kiran S.,9997,0,9999,2
1657241456868,MATH 197,003,095567,Xiao; Ming,9999,0,9999,0
1657241456868,MATH 197,004,095571,Perols; Johan Lars,9998,0,9999,1
1657241463917,COGS 9,A01,083615,Shannon; Kyle Michael,8,0,75,67
1657241469955,COGS 11,A01,083617,Boyle; Mary E. T.,22,0,48,26
1657241475983,COGS 13,A01,083071,Bastos; Amalia Pinkusfeld,8,0,71,63
1657241482008,COGS 14A,A01,092681,Semenuks; Arturs,2,1,100,98
1657241488038,COGS 14B,A01,083073,Cheng; Tzu-Han,6,0,63,57
1657241494070,COGS 17,A01,092677,Semenuks; Arturs,5,0,81,76
1657241500095,COGS 100,A01,083619,Allen; Michael Gordon,16,0,70,54
1657241506120,COGS 101A,A01,083621,Davis; Joshua Daniel,9,0,68,59
1657241512144,COGS 101B,A01,091572,Allen; Michael Gordon,11,0,65,54
1657241518172,COGS 101C,A01,083625,Delgado; Tania,17,0,35,18
1657241524199,COGS 107A,A01,083627,Boyle; Mary E. T.,13,0,60,47
1657241530223,COGS 118A,A01,083075,Gupta; Anjum,16,0,76,60
1657241536246,CSE 3,A50,083646,Miranda; Gregory Joseph,24,0,50,26
1657241542269,CSE 8A,A50,083650,Miranda; Gregory Joseph,17,1,56,39
1657241548301,CSE 11,A01,083080,Cao; Yingjun,5,15,40,35
1657241554324,CSE 12,A01,083652,Krause-Levy; Sophia Louisa,26,1,120,94
1657241560347,CSE 15L,A01,083654,Morris; Justin Loren,9,0,50,41
1657241560347,CSE 15L,A02,083655,Morris; Justin Loren,9,0,50,41
1657241566369,CSE 20,A01,083657,Tran; Khoa Dang,38,0,80,42
1657241572396,CSE 21,A01,095574,Bach; Quang Tran,22,0,48,26
1657241578420,CSE 30,A01,083084,Eldon; John,4,0,80,76
1657241578420,CSE 30,B01,095061,Bhaskar; Nishant,8,0,50,42
1657241584443,CSE 100,A01,083659,Cao; Yingjun,4,4,70,66
1657241590467,CSE 134B,A01,083661,Powell; Thomas Allan,21,0,100,79
1657241596490,CSE 140,A01,083663,Gungor; Onat,13,0,85,72
1657241602512,CSE 140L,A01,083088,Eldon; John,18,0,100,82
1657241608539,CSE 175,A01,083665,Kumar; Rakesh,3,0,25,22
1657241614564,CSE 190,A00,092507,Dubnov; Shlomo,7,0,20,13
1657241620596,ECE 45,A01,083139,Congero; Spencer William,5,0,75,70
1657241626620,ECE 65,A50,083695,Saad; Andrew S,12,0,30,18
1657241626620,ECE 65,A51,095125,Saad; Andrew S,25,0,26,1
1657241632646,ECE 109,A01,091882,Touri; Behrouz,19,0,70,51
1657241638672,ECE 180,A00,083140,Abi Samra; Nicholas Camill,1,0,30,29
1657241638672,ECE 180,B00,083141,Abi Samra; Nicholas Camill,0,0,30,30
1657241644700,MATH 10A,A01,083735,Patchell; Gregory David,2,0,30,28
1657241644700,MATH 10A,A02,083736,Patchell; Gregory David,20,0,30,10
1657241644700,MATH 10A,A03,083737,Patchell; Gregory David,16,0,30,14
1657241650727,MATH 10B,A01,083207,Lim; Seonhee,7,0,34,27
1657241650727,MATH 10B,A02,083208,Lim; Seonhee,9,0,35,26
1657241650727,MATH 10B,A03,093472,Lim; Seonhee,5,0,34,29
1657241650727,MATH 10B,B01,083739,Sinha; Shubham,11,0,30,19
1657241656750,MATH 18,A01,083743,Cinel; Cameron Alexander,6,0,30,24
1657241656750,MATH 18,A02,083744,Cinel; Cameron Alexander,17,0,30,13
1657241656750,MATH 18,A03,083745,Cinel; Cameron Alexander,8,0,30,22
1657241656750,MATH 18,B01,083748,Rideout; David Porter,4,0,37,33
1657241656750,MATH 18,B02,083749,Rideout; David Porter,4,0,36,32
1657241656750,MATH 18,B03,083750,Rideout; David Porter,2,0,37,35
1657241656750,MATH 18,B04,083751,Rideout; David Porter,6,0,36,30
1657241656750,MATH 18,B05,093473,Rideout; David Porter,5,0,36,31
1657241656750,MATH 18,B06,093474,Rideout; David Porter,5,0,36,31
1657241662781,MATH 20A,A01,083754,Zheng; Zequn,14,0,40,26
1657241668804,MATH 20B,A01,083756,Briones; Jor-el Thomas Caparas,3,0,36,33
1657241668804,MATH 20B,A02,083757,Briones; Jor-el Thomas Caparas,1,0,36,35
1657241668804,MATH 20B,A03,093475,Briones; Jor-el Thomas Caparas,2,0,36,34
1657241674830,MATH 20C,A01,083760,Briones; Jor-el Thomas Caparas,1,0,35,34
1657241674830,MATH 20C,A02,083761,Briones; Jor-el Thomas Caparas,8,0,35,27
1657241674830,MATH 20C,A03,093476,Briones; Jor-el Thomas Caparas,0,1,36,36
1657241674830,MATH 20C,B01,083762,Bach; Quang Tran,1,0,30,29
1657241680851,MATH 20D,A01,083765,Tran; Brian Kha,4,0,30,26
1657241680851,MATH 20D,A02,083766,Tran; Brian Kha,5,0,30,25
1657241680851,MATH 20D,A03,083767,Tran; Brian Kha,4,0,30,26
1657241686875,MATH 20E,A01,083771,Ganguly; Soumya,7,0,32,25
1657241686875,MATH 20E,A02,083772,Ganguly; Soumya,7,0,32,25
1657241686875,MATH 20E,B01,083773,Ciotti; Benjamin,19,0,35,16
1657241686875,MATH 20E,B02,083774,Ciotti; Benjamin,17,0,35,18
1657241692908,MATH 103A,A01,083777,Greenfeld; Be'Eri,3,0,36,33
1657241692908,MATH 103A,A02,083778,Greenfeld; Be'Eri,5,0,36,31
1657241692908,MATH 103A,A03,093561,Greenfeld; Be'Eri,4,0,36,32
1657241692908,MATH 103A,B01,083779,Greenfeld; Be'Eri,6,0,36,30
1657241692908,MATH 103A,B02,083780,Greenfeld; Be'Eri,3,0,36,33
1657241692908,MATH 103A,B03,093562,Greenfeld; Be'Eri,3,0,36,33
1657241698935,MATH 105,A01,085443,Carter; Anne Toulson,15,0,35,20
1657241698935,MATH 105,A02,093477,Carter; Anne Toulson,20,0,35,15
1657241704969,MATH 109,A01,083213,Ganzberger; Geoffrey Michael,2,0,34,32
1657241704969,MATH 109,A02,083214,Ganzberger; Geoffrey Michael,4,0,34,30
1657241704969,MATH 109,A03,093478,Ganzberger; Geoffrey Michael,2,0,34,32
1657241704969,MATH 109,B01,083215,Ganzberger; Geoffrey Michael,1,0,32,31
1657241704969,MATH 109,B02,083216,Ganzberger; Geoffrey Michael,1,0,32,31
1657241704969,MATH 109,B03,093479,Ganzberger; Geoffrey Michael,8,0,32,24
1657241710992,MATH 142A,A01,083219,Chow; Bennett,6,0,32,26
1657241710992,MATH 142A,A02,083220,Chow; Bennett,10,0,32,22
1657241710992,MATH 142A,A03,093480,Chow; Bennett,7,0,32,25
1657241710992,MATH 142A,B03,093481,Chow; Bennett,8,0,32,24
1657241710992,MATH 142A,B04,093558,Chow; Bennett,12,0,32,20
1657241710992,MATH 142A,B05,093559,Chow; Bennett,6,0,32,26
1657241717015,MATH 193A,A01,083224,Rotar; Vladimir,7,0,34,27
1657241717015,MATH 193A,A02,083225,Rotar; Vladimir,6,0,34,28
1657241717015,MATH 193A,A03,083781,Rotar; Vladimir,2,0,34,32
1657241717015,MATH 193A,A04,083782,Rotar; Vladimir,8,0,34,26
1657241717015,MATH 193A,A05,093482,Rotar; Vladimir,6,0,34,28
1657241723038,MATH 197,001,091859,McAuley; Julian John,9999,0,9999,0
1657241723038,MATH 197,002,095566,Kedlaya; Kiran S.,9997,0,9999,2
1657241723038,MATH 197,003,095567,Xiao; Ming,9999,0,9999,0
1657241723038,MATH 197,004,095571,Perols; Johan Lars,9998,0,9999,1
1657241730107,COGS 9,A01,083615,Shannon; Kyle Michael,8,0,75,67
1657241736133,COGS 11,A01,083617,Boyle; Mary E. T.,22,0,48,26
1657241742170,COGS 13,A01,083071,Bastos; Amalia Pinkusfeld,8,0,71,63
1657241748198,COGS 14A,A01,092681,Semenuks; Arturs,2,1,100,98
1657241754224,COGS 14B,A01,083073,Cheng; Tzu-Han,6,0,63,57
1657241760253,COGS 17,A01,092677,Semenuks; Arturs,5,0,81,76
1657241766278,COGS 100,A01,083619,Allen; Michael Gordon,16,0,70,54
1657241772299,COGS 101A,A01,083621,Davis; Joshua Daniel,9,0,68,59
1657241778321,COGS 101B,A01,091572,Allen; Michael Gordon,11,0,65,54
1657241784345,COGS 101C,A01,083625,Delgado; Tania,17,0,35,18
1657241790369,COGS 107A,A01,083627,Boyle; Mary E. T.,13,0,60,47
1657241796392,COGS 118A,A01,083075,Gupta; Anjum,16,0,76,60
1657241802428,CSE 3,A50,083646,Miranda; Gregory Joseph,24,0,50,26
1657241808453,CSE 8A,A50,083650,Miranda; Gregory Joseph,17,1,56,39
1657241814476,CSE 11,A01,083080,Cao; Yingjun,5,15,40,35
1657241820499,CSE 12,A01,083652,Krause-Levy; Sophia Louisa,26,1,120,94
1657241826526,CSE 15L,A01,083654,Morris; Justin Loren,9,0,50,41
1657241826526,CSE 15L,A02,083655,Morris; Justin Loren,9,0,50,41
1657241832560,CSE 20,A01,083657,Tran; Khoa Dang,38,0,80,42
1657241838588,CSE 21,A01,095574,Bach; Quang Tran,22,0,48,26
1657241844616,CSE 30,A01,083084,Eldon; John,4,0,80,76
1657241844616,CSE 30,B01,095061,Bhaskar; Nishant,8,0,50,42
1657241850642,CSE 100,A01,083659,Cao; Yingjun,4,4,70,66
1657241856669,CSE 134B,A01,083661,Powell; Thomas Allan,21,0,100,79
1657241862695,CSE 140,A01,083663,Gungor; Onat,13,0,85,72
1657241868718,CSE 140L,A01,083088,Eldon; John,18,0,100,82
1657241874747,CSE 175,A01,083665,Kumar; Rakesh,3,0,25,22
1657241880769,CSE 190,A00,092507,Dubnov; Shlomo,7,0,20,13
1657241886804,ECE 45,A01,083139,Congero; Spencer William,5,0,75,70
1657241892843,ECE 65,A50,083695,Saad; Andrew S,12,0,30,18
1657241892843,ECE 65,A51,095125,Saad; Andrew S,25,0,26,1
1657241898869,ECE 109,A01,091882,Touri; Behrouz,19,0,70,51
1657241904901,ECE 180,A00,083140,Abi Samra; Nicholas Camill,1,0,30,29
1657241904901,ECE 180,B00,083141,Abi Samra; Nicholas Camill,0,0,30,30
1657241910923,MATH 10A,A01,083735,Patchell; Gregory David,2,0,30,28
1657241910923,MATH 10A,A02,083736,Patchell; Gregory David,20,0,30,10
1657241910923,MATH 10A,A03,083737,Patchell; Gregory David,16,0,30,14
1657241916946,MATH 10B,A01,083207,Lim; Seonhee,7,0,34,27
1657241916946,MATH 10B,A02,083208,Lim; Seonhee,9,0,35,26
1657241916946,MATH 10B,A03,093472,Lim; Seonhee,5,0,34,29
1657241916946,MATH 10B,B01,083739,Sinha; Shubham,11,0,30,19
1657241922976,MATH 18,A01,083743,Cinel; Cameron Alexander,6,0,30,24
1657241922976,MATH 18,A02,083744,Cinel; Cameron Alexander,17,0,30,13
1657241922976,MATH 18,A03,083745,Cinel; Cameron Alexander,8,0,30,22
1657241922976,MATH 18,B01,083748,Rideout; David Porter,4,0,37,33
1657241922976,MATH 18,B02,083749,Rideout; David Porter,4,0,36,32
1657241922976,MATH 18,B03,083750,Rideout; David Porter,2,0,37,35
1657241922976,MATH 18,B04,083751,Rideout; David Porter,6,0,36,30
1657241922976,MATH 18,B05,093473,Rideout; David Porter,5,0,36,31
1657241922976,MATH 18,B06,093474,Rideout; David Porter,5,0,36,31
1657241929000,MATH 20A,A01,083754,Zheng; Zequn,14,0,40,26
1657241935022,MATH 20B,A01,083756,Briones; Jor-el Thomas Caparas,3,0,36,33
1657241935022,MATH 20B,A02,083757,Briones; Jor-el Thomas Caparas,1,0,36,35
1657241935022,MATH 20B,A03,093475,Briones; Jor-el Thomas Caparas,2,0,36,34
1657241941045,MATH 20C,A01,083760,Briones; Jor-el Thomas Caparas,1,0,35,34
1657241941045,MATH 20C,A02,083761,Briones; Jor-el Thomas Caparas,8,0,35,27
1657241941045,MATH 20C,A03,093476,Briones; Jor-el Thomas Caparas,0,1,36,36
1657241941045,MATH 20C,B01,083762,Bach; Quang Tran,1,0,30,29
1657241947074,MATH 20D,A01,083765,Tran; Brian Kha,4,0,30,26
1657241947074,MATH 20D,A02,083766,Tran; Brian Kha,5,0,30,25
1657241947074,MATH 20D,A03,083767,Tran; Brian Kha,4,0,30,26
1657241953100,MATH 20E,A01,083771,Ganguly; Soumya,7,0,32,25
1657241953100,MATH 20E,A02,083772,Ganguly; Soumya,7,0,32,25
1657241953100,MATH 20E,B01,083773,Ciotti; Benjamin,19,0,35,16
1657241953100,MATH 20E,B02,083774,Ciotti; Benjamin,17,0,35,18
1657241959123,MATH 103A,A01,083777,Greenfeld; Be'Eri,3,0,36,33
1657241959123,MATH 103A,A02,083778,Greenfeld; Be'Eri,5,0,36,31
1657241959123,MATH 103A,A03,093561,Greenfeld; Be'Eri,4,0,36,32
1657241959123,MATH 103A,B01,083779,Greenfeld; Be'Eri,6,0,36,30
1657241959123,MATH 103A,B02,083780,Greenfeld; Be'Eri,3,0,36,33
1657241959123,MATH 103A,B03,093562,Greenfeld; Be'Eri,3,0,36,33
1657241965151,MATH 105,A01,085443,Carter; Anne Toulson,15,0,35,20
1657241965151,MATH 105,A02,093477,Carter; Anne Toulson,20,0,35,15
1657241971180,MATH 109,A01,083213,Ganzberger; Geoffrey Michael,2,0,34,32
1657241971180,MATH 109,A02,083214,Ganzberger; Geoffrey Michael,4,0,34,30
1657241971180,MATH 109,A03,093478,Ganzberger; Geoffrey Michael,2,0,34,32
1657241971180,MATH 109,B01,083215,Ganzberger; Geoffrey Michael,1,0,32,31
1657241971180,MATH 109,B02,083216,Ganzberger; Geoffrey Michael,1,0,32,31
1657241971180,MATH 109,B03,093479,Ganzberger; Geoffrey Michael,8,0,32,24
1657241977223,MATH 142A,A01,083219,Chow; Bennett,6,0,32,26
1657241977223,MATH 142A,A02,083220,Chow; Bennett,10,0,32,22
1657241977223,MATH 142A,A03,093480,Chow; Bennett,7,0,32,25
1657241977223,MATH 142A,B03,093481,Chow; Bennett,8,0,32,24
1657241977223,MATH 142A,B04,093558,Chow; Bennett,12,0,32,20
1657241977223,MATH 142A,B05,093559,Chow; Bennett,6,0,32,26
1657241983247,MATH 193A,A01,083224,Rotar; Vladimir,7,0,34,27
1657241983247,MATH 193A,A02,083225,Rotar; Vladimir,6,0,34,28
1657241983247,MATH 193A,A03,083781,Rotar; Vladimir,2,0,34,32
1657241983247,MATH 193A,A04,083782,Rotar; Vladimir,8,0,34,26
1657241983247,MATH 193A,A05,093482,Rotar; Vladimir,6,0,34,28
1657241989363,MATH 197,001,091859,McAuley; Julian John,9999,0,9999,0
1657241989363,MATH 197,002,095566,Kedlaya; Kiran S.,9997,0,9999,2
1657241989363,MATH 197,003,095567,Xiao; Ming,9999,0,9999,0
1657241989363,MATH 197,004,095571,Perols; Johan Lars,9998,0,9999,1
1657241996412,COGS 9,A01,083615,Shannon; Kyle Michael,8,0,75,67
1657242002439,COGS 11,A01,083617,Boyle; Mary E. T.,22,0,48,26
1657242008465,COGS 13,A01,083071,Bastos; Amalia Pinkusfeld,8,0,71,63
1657242014489,COGS 14A,A01,092681,Semenuks; Arturs,2,1,100,98
1657242020510,COGS 14B,A01,083073,Cheng; Tzu-Han,6,0,63,57
1657242026532,COGS 17,A01,092677,Semenuks; Arturs,5,0,81,76
1657242032559,COGS 100,A01,083619,Allen; Michael Gordon,16,0,70,54
1657242038592,COGS 101A,A01,083621,Davis; Joshua Daniel,9,0,68,59
1657242044619,COGS 101B,A01,091572,Allen; Michael Gordon,11,0,65,54
1657242050642,COGS 101C,A01,083625,Delgado; Tania,17,0,35,18
1657242056668,COGS 107A,A01,083627,Boyle; Mary E. T.,13,0,60,47
1657242062696,COGS 118A,A01,083075,Gupta; Anjum,16,0,76,60
1657242068727,CSE 3,A50,083646,Miranda; Gregory Joseph,24,0,50,26
1657242074753,CSE 8A,A50,083650,Miranda; Gregory Joseph,17,1,56,39
1657242080780,CSE 11,A01,083080,Cao; Yingjun,5,15,40,35
1657242086804,CSE 12,A01,083652,Krause-Levy; Sophia Louisa,26,1,120,94
1657242092827,CSE 15L,A01,083654,Morris; Justin Loren,9,0,50,41
1657242092827,CSE 15L,A02,083655,Morris; Justin Loren,9,0,50,41
1657242098855,CSE 20,A01,083657,Tran; Khoa Dang,38,0,80,42
1657242104877,CSE 21,A01,095574,Bach; Quang Tran,22,0,48,26
1657242110904,CSE 30,A01,083084,Eldon; John,4,0,80,76
1657242110904,CSE 30,B01,095061,Bhaskar; Nishant,8,0,50,42
1657242116928,CSE 100,A01,083659,Cao; Yingjun,4,4,70,66
1657242122955,CSE 134B,A01,083661,Powell; Thomas Allan,21,0,100,79
1657242128981,CSE 140,A01,083663,Gungor; Onat,13,0,85,72
1657242135007,CSE 140L,A01,083088,Eldon; John,18,0,100,82
1657242141029,CSE 175,A01,083665,Kumar; Rakesh,3,0,25,22
1657242147053,CSE 190,A00,092507,Dubnov; Shlomo,7,0,20,13
1657242153077,ECE 45,A01,083139,Congero; Spencer William,5,0,75,70
1657242159101,ECE 65,A50,083695,Saad; Andrew S,12,0,30,18
1657242159101,ECE 65,A51,095125,Saad; Andrew S,25,0,26,1
1657242165124,ECE 109,A01,091882,Touri; Behrouz,19,0,70,51
1657242171147,ECE 180,A00,083140,Abi Samra; Nicholas Camill,1,0,30,29
1657242171147,ECE 180,B00,083141,Abi Samra; Nicholas Camill,0,0,30,30
1657242177171,MATH 10A,A01,083735,Patchell; Gregory David,2,0,30,28
1657242177171,MATH 10A,A02,083736,Patchell; Gregory David,20,0,30,10
1657242177171,MATH 10A,A03,083737,Patchell; Gregory David,16,0,30,14
1657242183194,MATH 10B,A01,083207,Lim; Seonhee,7,0,34,27
1657242183194,MATH 10B,A02,083208,Lim; Seonhee,9,0,35,26
1657242183194,MATH 10B,A03,093472,Lim; Seonhee,5,0,34,29
1657242183194,MATH 10B,B01,083739,Sinha; Shubham,11,0,30,19
1657242189219,MATH 18,A01,083743,Cinel; Cameron Alexander,6,0,30,24
1657242189219,MATH 18,A02,083744,Cinel; Cameron Alexander,17,0,30,13
1657242189219,MATH 18,A03,083745,Cinel; Cameron Alexander,8,0,30,22
1657242189219,MATH 18,B01,083748,Rideout; David Porter,4,0,37,33
1657242189219,MATH 18,B02,083749,Rideout; David Porter,4,0,36,32
1657242189219,MATH 18,B03,083750,Rideout; David Porter,2,0,37,35
1657242189219,MATH 18,B04,083751,Rideout; David Porter,6,0,36,30
1657242189219,MATH 18,B05,093473,Rideout; David Porter,5,0,36,31
1657242189219,MATH 18,B06,093474,Rideout; David Porter,5,0,36,31
1657242195245,MATH 20A,A01,083754,Zheng; Zequn,14,0,40,26
1657242201272,MATH 20B,A01,083756,Briones; Jor-el Thomas Caparas,3,0,36,33
1657242201272,MATH 20B,A02,083757,Briones; Jor-el Thomas Caparas,1,0,36,35
1657242201272,MATH 20B,A03,093475,Briones; Jor-el Thomas Caparas,2,0,36,34
1657242207304,MATH 20C,A01,083760,Briones; Jor-el Thomas Caparas,1,0,35,34
1657242207304,MATH 20C,A02,083761,Briones; Jor-el Thomas Caparas,8,0,35,27
1657242207304,MATH 20C,A03,093476,Briones; Jor-el Thomas Caparas,0,1,36,36
1657242207304,MATH 20C,B01,083762,Bach; Quang Tran,1,0,30,29
1657242213343,MATH 20D,A01,083765,Tran; Brian Kha,4,0,30,26
1657242213343,MATH 20D,A02,083766,Tran; Brian Kha,5,0,30,25
1657242213343,MATH 20D,A03,083767,Tran; Brian Kha,4,0,30,26
1657242219367,MATH 20E,A01,083771,Ganguly; Soumya,7,0,32,25
1657242219367,MATH 20E,A02,083772,Ganguly; Soumya,7,0,32,25
1657242219367,MATH 20E,B01,083773,Ciotti; Benjamin,19,0,35,16
1657242219367,MATH 20E,B02,083774,Ciotti; Benjamin,17,0,35,18
1657242225392,MATH 103A,A01,083777,Greenfeld; Be'Eri,3,0,36,33
1657242225392,MATH 103A,A02,083778,Greenfeld; Be'Eri,5,0,36,31
1657242225392,MATH 103A,A03,093561,Greenfeld; Be'Eri,4,0,36,32
1657242225392,MATH 103A,B01,083779,Greenfeld; Be'Eri,6,0,36,30
1657242225392,MATH 103A,B02,083780,Greenfeld; Be'Eri,3,0,36,33
1657242225392,MATH 103A,B03,093562,Greenfeld; Be'Eri,3,0,36,33
1657242231415,MATH 105,A01,085443,Carter; Anne Toulson,15,0,35,20
1657242231415,MATH 105,A02,093477,Carter; Anne Toulson,20,0,35,15
1657242237439,MATH 109,A01,083213,Ganzberger; Geoffrey Michael,2,0,34,32
1657242237439,MATH 109,A02,083214,Ganzberger; Geoffrey Michael,4,0,34,30
1657242237439,MATH 109,A03,093478,Ganzberger; Geoffrey Michael,2,0,34,32
1657242237439,MATH 109,B01,083215,Ganzberger; Geoffrey Michael,1,0,32,31
1657242237439,MATH 109,B02,083216,Ganzberger; Geoffrey Michael,1,0,32,31
1657242237439,MATH 109,B03,093479,Ganzberger; Geoffrey Michael,8,0,32,24
1657242243472,MATH 142A,A01,083219,Chow; Bennett,6,0,32,26
1657242243472,MATH 142A,A02,083220,Chow; Bennett,10,0,32,22
1657242243472,MATH 142A,A03,093480,Chow; Bennett,7,0,32,25
1657242243472,MATH 142A,B03,093481,Chow; Bennett,8,0,32,24
1657242243472,MATH 142A,B04,093558,Chow; Bennett,12,0,32,20
1657242243472,MATH 142A,B05,093559,Chow; Bennett,6,0,32,26
1657242249500,MATH 193A,A01,083224,Rotar; Vladimir,7,0,34,27
1657242249500,MATH 193A,A02,083225,Rotar; Vladimir,6,0,34,28
1657242249500,MATH 193A,A03,083781,Rotar; Vladimir,2,0,34,32
1657242249500,MATH 193A,A04,083782,Rotar; Vladimir,8,0,34,26
1657242249500,MATH 193A,A05,093482,Rotar; Vladimir,6,0,34,28
1657242255522,MATH 197,001,091859,McAuley; Julian John,9999,0,9999,0
1657242255522,MATH 197,002,095566,Kedlaya; Kiran S.,9997,0,9999,2
1657242255522,MATH 197,003,095567,Xiao; Ming,9999,0,9999,0
1657242255522,MATH 197,004,095571,Perols; Johan Lars,9998,0,9999,1
1657242262579,COGS 9,A01,083615,Shannon; Kyle Michael,8,0,75,67
1657242268607,COGS 11,A01,083617,Boyle; Mary E. T.,22,0,48,26
1657242274630,COGS 13,A01,083071,Bastos; Amalia Pinkusfeld,8,0,71,63
1657242280652,COGS 14A,A01,092681,Semenuks; Arturs,2,1,100,98
1657242286680,COGS 14B,A01,083073,Cheng; Tzu-Han,6,0,63,57
1657242292702,COGS 17,A01,092677,Semenuks; Arturs,5,0,81,76
1657242298737,COGS 100,A01,083619,Allen; Michael Gordon,16,0,70,54
1657242304759,COGS 101A,A01,083621,Davis; Joshua Daniel,9,0,68,59
1657242310780,COGS 101B,A01,091572,Allen; Michael Gordon,11,0,65,54
1657242316807,COGS 101C,A01,083625,Delgado; Tania,17,0,35,18
1657242322830,COGS 107A,A01,083627,Boyle; Mary E. T.,13,0,60,47
1657242328859,COGS 118A,A01,083075,Gupta; Anjum,16,0,76,60
1657242334883,CSE 3,A50,083646,Miranda; Gregory Joseph,24,0,50,26
1657242340907,CSE 8A,A50,083650,Miranda; Gregory Joseph,17,1,56,39
1657242346931,CSE 11,A01,083080,Cao; Yingjun,5,15,40,35
1657242352959,CSE 12,A01,083652,Krause-Levy; Sophia Louisa,26,1,120,94
1657242358982,CSE 15L,A01,083654,Morris; Justin Loren,9,0,50,41
1657242358982,CSE 15L,A02,083655,Morris; Justin Loren,9,0,50,41
1657242365008,CSE 20,A01,083657,Tran; Khoa Dang,38,0,80,42
1657242371029,CSE 21,A01,095574,Bach; Quang Tran,22,0,48,26
1657242377054,CSE 30,A01,083084,Eldon; John,4,0,80,76
1657242377054,CSE 30,B01,095061,Bhaskar; Nishant,8,0,50,42
1657242383080,CSE 100,A01,083659,Cao; Yingjun,4,4,70,66
1657242389104,CSE 134B,A01,083661,Powell; Thomas Allan,21,0,100,79
1657242395131,CSE 140,A01,083663,Gungor; Onat,13,0,85,72
1657242401159,CSE 140L,A01,083088,Eldon; John,18,0,100,82
1657242407190,CSE 175,A01,083665,Kumar; Rakesh,3,0,25,22
1657242413215,CSE 190,A00,092507,Dubnov; Shlomo,7,0,20,13
1657242419242,ECE 45,A01,083139,Congero; Spencer William,5,0,75,70
1657242425270,ECE 65,A50,083695,Saad; Andrew S,12,0,30,18
1657242425270,ECE 65,A51,095125,Saad; Andrew S,25,0,26,1
1657242431296,ECE 109,A01,091882,Touri; Behrouz,19,0,70,51
1657242437319,ECE 180,A00,083140,Abi Samra; Nicholas Camill,1,0,30,29
1657242437319,ECE 180,B00,083141,Abi Samra; Nicholas Camill,0,0,30,30
1657242443347,MATH 10A,A01,083735,Patchell; Gregory David,2,0,30,28
1657242443347,MATH 10A,A02,083736,Patchell; Gregory David,20,0,30,10
1657242443347,MATH 10A,A03,083737,Patchell; Gregory David,16,0,30,14
1657242449375,MATH 10B,A01,083207,Lim; Seonhee,7,0,34,27
1657242449375,MATH 10B,A02,083208,Lim; Seonhee,9,0,35,26
1657242449375,MATH 10B,A03,093472,Lim; Seonhee,5,0,34,29
1657242449375,MATH 10B,B01,083739,Sinha; Shubham,11,0,30,19
1657242455407,MATH 18,A01,083743,Cinel; Cameron Alexander,6,0,30,24
1657242455407,MATH 18,A02,083744,Cinel; Cameron Alexander,17,0,30,13
1657242455407,MATH 18,A03,083745,Cinel; Cameron Alexander,8,0,30,22
1657242455407,MATH 18,B01,083748,Rideout; David Porter,4,0,37,33
1657242455407,MATH 18,B02,083749,Rideout; David Porter,4,0,36,32
1657242455407,MATH 18,B03,083750,Rideout; David Porter,2,0,37,35
1657242455407,MATH 18,B04,083751,Rideout; David Porter,6,0,36,30
1657242455407,MATH 18,B05,093473,Rideout; David Porter,5,0,36,31
1657242455407,MATH 18,B06,093474,Rideout; David Porter,5,0,36,31
1657242461434,MATH 20A,A01,083754,Zheng; Zequn,14,0,40,26
1657242467457,MATH 20B,A01,083756,Briones; Jor-el Thomas Caparas,3,0,36,33
1657242467457,MATH 20B,A02,083757,Briones; Jor-el Thomas Caparas,1,0,36,35
1657242467457,MATH 20B,A03,093475,Briones; Jor-el Thomas Caparas,2,0,36,34
1657242473493,MATH 20C,A01,083760,Briones; Jor-el Thomas Caparas,1,0,35,34
1657242473493,MATH 20C,A02,083761,Briones; Jor-el Thomas Caparas,8,0,35,27
1657242473493,MATH 20C,A03,093476,Briones; Jor-el Thomas Caparas,0,1,36,36
1657242473493,MATH 20C,B01,083762,Bach; Quang Tran,1,0,30,29
1657242479521,MATH 20D,A01,083765,Tran; Brian Kha,4,0,30,26
1657242479521,MATH 20D,A02,083766,Tran; Brian Kha,5,0,30,25
1657242479521,MATH 20D,A03,083767,Tran; Brian Kha,4,0,30,26
1657242485545,MATH 20E,A01,083771,Ganguly; Soumya,7,0,32,25
1657242485545,MATH 20E,A02,083772,Ganguly; Soumya,7,0,32,25
1657242485545,MATH 20E,B01,083773,Ciotti; Benjamin,19,0,35,16
1657242485545,MATH 20E,B02,083774,Ciotti; Benjamin,17,0,35,18
1657242491572,MATH 103A,A01,083777,Greenfeld; Be'Eri,3,0,36,33
1657242491572,MATH 103A,A02,083778,Greenfeld; Be'Eri,5,0,36,31
1657242491572,MATH 103A,A03,093561,Greenfeld; Be'Eri,4,0,36,32
1657242491572,MATH 103A,B01,083779,Greenfeld; Be'Eri,6,0,36,30
1657242491572,MATH 103A,B02,083780,Greenfeld; Be'Eri,3,0,36,33
1657242491572,MATH 103A,B03,093562,Greenfeld; Be'Eri,3,0,36,33
1657242497595,MATH 105,A01,085443,Carter; Anne Toulson,15,0,35,20
1657242497595,MATH 105,A02,093477,Carter; Anne Toulson,20,0,35,15
1657242503628,MATH 109,A01,083213,Ganzberger; Geoffrey Michael,2,0,34,32
1657242503628,MATH 109,A02,083214,Ganzberger; Geoffrey Michael,4,0,34,30
1657242503628,MATH 109,A03,093478,Ganzberger; Geoffrey Michael,2,0,34,32
1657242503628,MATH 109,B01,083215,Ganzberger; Geoffrey Michael,1,0,32,31
1657242503628,MATH 109,B02,083216,Ganzberger; Geoffrey Michael,1,0,32,31
1657242503628,MATH 109,B03,093479,Ganzberger; Geoffrey Michael,8,0,32,24
1657242509652,MATH 142A,A01,083219,Chow; Bennett,6,0,32,26
1657242509652,MATH 142A,A02,083220,Chow; Bennett,10,0,32,22
1657242509652,MATH 142A,A03,093480,Chow; Bennett,7,0,32,25
1657242509652,MATH 142A,B03,093481,Chow; Bennett,8,0,32,24
1657242509652,MATH 142A,B04,093558,Chow; Bennett,12,0,32,20
1657242509652,MATH 142A,B05,093559,Chow; Bennett,6,0,32,26
1657242515678,MATH 193A,A01,083224,Rotar; Vladimir,7,0,34,27
1657242515678,MATH 193A,A02,083225,Rotar; Vladimir,6,0,34,28
1657242515678,MATH 193A,A03,083781,Rotar; Vladimir,2,0,34,32
1657242515678,MATH 193A,A04,083782,Rotar; Vladimir,8,0,34,26
1657242515678,MATH 193A,A05,093482,Rotar; Vladimir,6,0,34,28
1657242521703,MATH 197,001,091859,McAuley; Julian John,9999,0,9999,0
1657242521703,MATH 197,002,095566,Kedlaya; Kiran S.,9997,0,9999,2
1657242521703,MATH 197,003,095567,Xiao; Ming,9999,0,9999,0
1657242521703,MATH 197,004,095571,Perols; Johan Lars,9998,0,9999,1
1657242528797,COGS 9,A01,083615,Shannon; Kyle Michael,8,0,75,67
1657242534834,COGS 11,A01,083617,Boyle; Mary E. T.,22,0,48,26
1657242540861,COGS 13,A01,083071,Bastos; Amalia Pinkusfeld,8,0,71,63
1657242546891,COGS 14A,A01,092681,Semenuks; Arturs,2,1,100,98
1657242552914,COGS 14B,A01,083073,Cheng; Tzu-Han,6,0,63,57
1657242558943,COGS 17,A01,092677,Semenuks; Arturs,5,0,81,76
1657242564970,COGS 100,A01,083619,Allen; Michael Gordon,16,0,70,54
1657242570998,COGS 101A,A01,083621,Davis; Joshua Daniel,9,0,68,59
1657242577029,COGS 101B,A01,091572,Allen; Michael Gordon,11,0,65,54
1657242583126,COGS 101C,A01,083625,Delgado; Tania,17,0,35,18
1657242589162,COGS 107A,A01,083627,Boyle; Mary E. T.,13,0,60,47
1657242595188,COGS 118A,A01,083075,Gupta; Anjum,16,0,76,60
1657242601216,CSE 3,A50,083646,Miranda; Gregory Joseph,24,0,50,26
1657242607241,CSE 8A,A50,083650,Miranda; Gregory Joseph,17,1,56,39
1657242613267,CSE 11,A01,083080,Cao; Yingjun,5,15,40,35
1657242619290,CSE 12,A01,083652,Krause-Levy; Sophia Louisa,26,1,120,94
1657242625314,CSE 15L,A01,083654,Morris; Justin Loren,9,0,50,41
1657242625314,CSE 15L,A02,083655,Morris; Justin Loren,9,0,50,41
1657242631340,CSE 20,A01,083657,Tran; Khoa Dang,38,0,80,42
1657242637365,CSE 21,A01,095574,Bach; Quang Tran,22,0,48,26
1657242643392,CSE 30,A01,083084,Eldon; John,4,0,80,76
1657242643392,CSE 30,B01,095061,Bhaskar; Nishant,8,0,50,42
1657242649414,CSE 100,A01,083659,Cao; Yingjun,4,4,70,66
1657242655437,CSE 134B,A01,083661,Powell; Thomas Allan,21,0,100,79
1657242661469,CSE 140,A01,083663,Gungor; Onat,13,0,85,72
1657242667491,CSE 140L,A01,083088,Eldon; John,18,0,100,82
1657242673520,CSE 175,A01,083665,Kumar; Rakesh,3,0,25,22
1657242679546,CSE 190,A00,092507,Dubnov; Shlomo,7,0,20,13
1657242685572,ECE 45,A01,083139,Congero; Spencer William,5,0,75,70
1657242691596,ECE 65,A50,083695,Saad; Andrew S,12,0,30,18
1657242691596,ECE 65,A51,095125,Saad; Andrew S,25,0,26,1
1657242697621,ECE 109,A01,091882,Touri; Behrouz,19,0,70,51
1657242703643,ECE 180,A00,083140,Abi Samra; Nicholas Camill,1,0,30,29
1657242703643,ECE 180,B00,083141,Abi Samra; Nicholas Camill,0,0,30,30
1657242709669,MATH 10A,A01,083735,Patchell; Gregory David,2,0,30,28
1657242709669,MATH 10A,A02,083736,Patchell; Gregory David,20,0,30,10
1657242709669,MATH 10A,A03,083737,Patchell; Gregory David,16,0,30,14
1657242715697,MATH 10B,A01,083207,Lim; Seonhee,7,0,34,27
1657242715697,MATH 10B,A02,083208,Lim; Seonhee,9,0,35,26
1657242715697,MATH 10B,A03,093472,Lim; Seonhee,5,0,34,29
1657242715697,MATH 10B,B01,083739,Sinha; Shubham,11,0,30,19
1657242721720,MATH 18,A01,083743,Cinel; Cameron Alexander,6,0,30,24
1657242721720,MATH 18,A02,083744,Cinel; Cameron Alexander,17,0,30,13
1657242721720,MATH 18,A03,083745,Cinel; Cameron Alexander,8,0,30,22
1657242721720,MATH 18,B01,083748,Rideout; David Porter,4,0,37,33
1657242721720,MATH 18,B02,083749,Rideout; David Porter,4,0,36,32
1657242721720,MATH 18,B03,083750,Rideout; David Porter,2,0,37,35
1657242721720,MATH 18,B04,083751,Rideout; David Porter,6,0,36,30
1657242721720,MATH 18,B05,093473,Rideout; David Porter,5,0,36,31
1657242721720,MATH 18,B06,093474,Rideout; David Porter,5,0,36,31
1657242727742,MATH 20A,A01,083754,Zheng; Zequn,14,0,40,26
1657242733766,MATH 20B,A01,083756,Briones; Jor-el Thomas Caparas,3,0,36,33
1657242733766,MATH 20B,A02,083757,Briones; Jor-el Thomas Caparas,1,0,36,35
1657242733766,MATH 20B,A03,093475,Briones; Jor-el Thomas Caparas,2,0,36,34
1657242739789,MATH 20C,A01,083760,Briones; Jor-el Thomas Caparas,1,0,35,34
1657242739789,MATH 20C,A02,083761,Briones; Jor-el Thomas Caparas,8,0,35,27
1657242739789,MATH 20C,A03,093476,Briones; Jor-el Thomas Caparas,0,1,36,36
1657242739789,MATH 20C,B01,083762,Bach; Quang Tran,1,0,30,29
1657242745814,MATH 20D,A01,083765,Tran; Brian Kha,4,0,30,26
1657242745814,MATH 20D,A02,083766,Tran; Brian Kha,5,0,30,25
1657242745814,MATH 20D,A03,083767,Tran; Brian Kha,4,0,30,26
1657242751838,MATH 20E,A01,083771,Ganguly; Soumya,7,0,32,25
1657242751838,MATH 20E,A02,083772,Ganguly; Soumya,7,0,32,25
1657242751838,MATH 20E,B01,083773,Ciotti; Benjamin,19,0,35,16
1657242751838,MATH 20E,B02,083774,Ciotti; Benjamin,17,0,35,18
1657242757866,MATH 103A,A01,083777,Greenfeld; Be'Eri,3,0,36,33
1657242757866,MATH 103A,A02,083778,Greenfeld; Be'Eri,5,0,36,31
1657242757866,MATH 103A,A03,093561,Greenfeld; Be'Eri,4,0,36,32
1657242757866,MATH 103A,B01,083779,Greenfeld; Be'Eri,6,0,36,30
1657242757866,MATH 103A,B02,083780,Greenfeld; Be'Eri,3,0,36,33
1657242757866,MATH 103A,B03,093562,Greenfeld; Be'Eri,3,0,36,33
1657242763893,MATH 105,A01,085443,Carter; Anne Toulson,15,0,35,20
1657242763893,MATH 105,A02,093477,Carter; Anne Toulson,20,0,35,15
1657242769918,MATH 109,A01,083213,Ganzberger; Geoffrey Michael,2,0,34,32
1657242769918,MATH 109,A02,083214,Ganzberger; Geoffrey Michael,4,0,34,30
1657242769918,MATH 109,A03,093478,Ganzberger; Geoffrey Michael,2,0,34,32
1657242769918,MATH 109,B01,083215,Ganzberger; Geoffrey Michael,1,0,32,31
1657242769918,MATH 109,B02,083216,Ganzberger; Geoffrey Michael,1,0,32,31
1657242769918,MATH 109,B03,093479,Ganzberger; Geoffrey Michael,8,0,32,24
1657242775943,MATH 142A,A01,083219,Chow; Bennett,6,0,32,26
1657242775943,MATH 142A,A02,083220,Chow; Bennett,10,0,32,22
1657242775943,MATH 142A,A03,093480,Chow; Bennett,7,0,32,25
1657242775943,MATH 142A,B03,093481,Chow; Bennett,8,0,32,24
1657242775943,MATH 142A,B04,093558,Chow; Bennett,12,0,32,20
1657242775943,MATH 142A,B05,093559,Chow; Bennett,6,0,32,26
1657242781966,MATH 193A,A01,083224,Rotar; Vladimir,7,0,34,27
1657242781966,MATH 193A,A02,083225,Rotar; Vladimir,6,0,34,28
1657242781966,MATH 193A,A03,083781,Rotar; Vladimir,2,0,34,32
1657242781966,MATH 193A,A04,083782,Rotar; Vladimir,8,0,34,26
1657242781966,MATH 193A,A05,093482,Rotar; Vladimir,6,0,34,28
1657242787989,MATH 197,001,091859,McAuley; Julian John,9999,0,9999,0
1657242787989,MATH 197,002,095566,Kedlaya; Kiran S.,9997,0,9999,2
1657242787989,MATH 197,003,095567,Xiao; Ming,9999,0,9999,0
1657242787989,MATH 197,004,095571,Perols; Johan Lars,9998,0,9999,1
1657242795051,COGS 9,A01,083615,Shannon; Kyle Michael,8,0,75,67
1657242801076,COGS 11,A01,083617,Boyle; Mary E. T.,22,0,48,26
1657242807100,COGS 13,A01,083071,Bastos; Amalia Pinkusfeld,8,0,71,63
1657242813127,COGS 14A,A01,092681,Semenuks; Arturs,2,1,100,98
1657242819154,COGS 14B,A01,083073,Cheng; Tzu-Han,6,0,63,57
1657242825180,COGS 17,A01,092677,Semenuks; Arturs,5,0,81,76
1657242831204,COGS 100,A01,083619,Allen; Michael Gordon,16,0,70,54
1657242837229,COGS 101A,A01,083621,Davis; Joshua Daniel,9,0,68,59
1657242843256,COGS 101B,A01,091572,Allen; Michael Gordon,11,0,65,54
1657242849284,COGS 101C,A01,083625,Delgado; Tania,17,0,35,18
1657242855309,COGS 107A,A01,083627,Boyle; Mary E. T.,13,0,60,47
1657242861332,COGS 118A,A01,083075,Gupta; Anjum,16,0,76,60
1657242867354,CSE 3,A50,083646,Miranda; Gregory Joseph,24,0,50,26
1657242873377,CSE 8A,A50,083650,Miranda; Gregory Joseph,17,1,56,39
1657242879404,CSE 11,A01,083080,Cao; Yingjun,5,15,40,35
1657242885430,CSE 12,A01,083652,Krause-Levy; Sophia Louisa,26,1,120,94
1657242891453,CSE 15L,A01,083654,Morris; Justin Loren,9,0,50,41
1657242891453,CSE 15L,A02,083655,Morris; Justin Loren,9,0,50,41
1657242897476,CSE 20,A01,083657,Tran; Khoa Dang,38,0,80,42
1657242903498,CSE 21,A01,095574,Bach; Quang Tran,22,0,48,26
1657242909520,CSE 30,A01,083084,Eldon; John,4,0,80,76
1657242909520,CSE 30,B01,095061,Bhaskar; Nishant,8,0,50,42
1657242915550,CSE 100,A01,083659,Cao; Yingjun,4,4,70,66
1657242921575,CSE 134B,A01,083661,Powell; Thomas Allan,21,0,100,79
1657242927601,CSE 140,A01,083663,Gungor; Onat,13,0,85,72
1657242933631,CSE 140L,A01,083088,Eldon; John,18,0,100,82
1657242939657,CSE 175,A01,083665,Kumar; Rakesh,3,0,25,22
1657242945679,CSE 190,A00,092507,Dubnov; Shlomo,7,0,20,13
1657242951705,ECE 45,A01,083139,Congero; Spencer William,5,0,75,70
1657242957728,ECE 65,A50,083695,Saad; Andrew S,12,0,30,18
1657242957728,ECE 65,A51,095125,Saad; Andrew S,25,0,26,1
1657242963754,ECE 109,A01,091882,Touri; Behrouz,19,0,70,51
1657242969780,ECE 180,A00,083140,Abi Samra; Nicholas Camill,1,0,30,29
1657242969780,ECE 180,B00,083141,Abi Samra; Nicholas Camill,0,0,30,30
1657242975805,MATH 10A,A01,083735,Patchell; Gregory David,2,0,30,28
1657242975805,MATH 10A,A02,083736,Patchell; Gregory David,20,0,30,10
1657242975805,MATH 10A,A03,083737,Patchell; Gregory David,16,0,30,14
1657242981829,MATH 10B,A01,083207,Lim; Seonhee,7,0,34,27
1657242981829,MATH 10B,A02,083208,Lim; Seonhee,9,0,35,26
1657242981829,MATH 10B,A03,093472,Lim; Seonhee,5,0,34,29
1657242981829,MATH 10B,B01,083739,Sinha; Shubham,11,0,30,19
1657242987861,MATH 18,A01,083743,Cinel; Cameron Alexander,6,0,30,24
1657242987861,MATH 18,A02,083744,Cinel; Cameron Alexander,17,0,30,13
1657242987861,MATH 18,A03,083745,Cinel; Cameron Alexander,8,0,30,22
1657242987861,MATH 18,B01,083748,Rideout; David Porter,4,0,37,33
1657242987861,MATH 18,B02,083749,Rideout; David Porter,4,0,36,32
1657242987861,MATH 18,B03,083750,Rideout; David Porter,2,0,37,35
1657242987861,MATH 18,B04,083751,Rideout; David Porter,6,0,36,30
1657242987861,MATH 18,B05,093473,Rideout; David Porter,5,0,36,31
1657242987861,MATH 18,B06,093474,Rideout; David Porter,5,0,36,31
1657242993890,MATH 20A,A01,083754,Zheng; Zequn,14,0,40,26
1657242999913,MATH 20B,A01,083756,Briones; Jor-el Thomas Caparas,3,0,36,33
1657242999913,MATH 20B,A02,083757,Briones; Jor-el Thomas Caparas,1,0,36,35
1657242999913,MATH 20B,A03,093475,Briones; Jor-el Thomas Caparas,2,0,36,34
1657243005949,MATH 20C,A01,083760,Briones; Jor-el Thomas Caparas,1,0,35,34
1657243005949,MATH 20C,A02,083761,Briones; Jor-el Thomas Caparas,8,0,35,27
1657243005949,MATH 20C,A03,093476,Briones; Jor-el Thomas Caparas,0,1,36,36
1657243005949,MATH 20C,B01,083762,Bach; Quang Tran,1,0,30,29
1657243011976,MATH 20D,A01,083765,Tran; Brian Kha,4,0,30,26
1657243011976,MATH 20D,A02,083766,Tran; Brian Kha,5,0,30,25
1657243011976,MATH 20D,A03,083767,Tran; Brian Kha,4,0,30,26
1657243018001,MATH 20E,A01,083771,Ganguly; Soumya,7,0,32,25
1657243018001,MATH 20E,A02,083772,Ganguly; Soumya,7,0,32,25
1657243018001,MATH 20E,B01,083773,Ciotti; Benjamin,19,0,35,16
1657243018001,MATH 20E,B02,083774,Ciotti; Benjamin,17,0,35,18
1657243024024,MATH 103A,A01,083777,Greenfeld; Be'Eri,3,0,36,33
1657243024024,MATH 103A,A02,083778,Greenfeld; Be'Eri,5,0,36,31
1657243024024,MATH 103A,A03,093561,Greenfeld; Be'Eri,4,0,36,32
1657243024024,MATH 103A,B01,083779,Greenfeld; Be'Eri,6,0,36,30
1657243024024,MATH 103A,B02,083780,Greenfeld; Be'Eri,3,0,36,33
1657243024024,MATH 103A,B03,093562,Greenfeld; Be'Eri,3,0,36,33
1657243030054,MATH 105,A01,085443,Carter; Anne Toulson,15,0,35,20
1657243030054,MATH 105,A02,093477,Carter; Anne Toulson,20,0,35,15
1657243036083,MATH 109,A01,083213,Ganzberger; Geoffrey Michael,2,0,34,32
1657243036083,MATH 109,A02,083214,Ganzberger; Geoffrey Michael,4,0,34,30
1657243036083,MATH 109,A03,093478,Ganzberger; Geoffrey Michael,2,0,34,32
1657243036083,MATH 109,B01,083215,Ganzberger; Geoffrey Michael,1,0,32,31
1657243036083,MATH 109,B02,083216,Ganzberger; Geoffrey Michael,1,0,32,31
1657243036083,MATH 109,B03,093479,Ganzberger; Geoffrey Michael,8,0,32,24
1657243042107,MATH 142A,A01,083219,Chow; Bennett,6,0,32,26
1657243042107,MATH 142A,A02,083220,Chow; Bennett,10,0,32,22
1657243042107,MATH 142A,A03,093480,Chow; Bennett,7,0,32,25
1657243042107,MATH 142A,B03,093481,Chow; Bennett,8,0,32,24
1657243042107,MATH 142A,B04,093558,Chow; Bennett,12,0,32,20
1657243042107,MATH 142A,B05,093559,Chow; Bennett,6,0,32,26
1657243048130,MATH 193A,A01,083224,Rotar; Vladimir,7,0,34,27
1657243048130,MATH 193A,A02,083225,Rotar; Vladimir,6,0,34,28
1657243048130,MATH 193A,A03,083781,Rotar; Vladimir,2,0,34,32
1657243048130,MATH 193A,A04,083782,Rotar; Vladimir,8,0,34,26
1657243048130,MATH 193A,A05,093482,Rotar; Vladimir,6,0,34,28
1657243054151,MATH 197,001,091859,McAuley; Julian John,9999,0,9999,0
1657243054151,MATH 197,002,095566,Kedlaya; Kiran S.,9997,0,9999,2
1657243054151,MATH 197,003,095567,Xiao; Ming,9999,0,9999,0
1657243054151,MATH 197,004,095571,Perols; Johan Lars,9998,0,9999,1
1657243061222,COGS 9,A01,083615,Shannon; Kyle Michael,8,0,75,67
1657243067247,COGS 11,A01,083617,Boyle; Mary E. T.,22,0,48,26
1657243073274,COGS 13,A01,083071,Bastos; Amalia Pinkusfeld,8,0,71,63
1657243079297,COGS 14A,A01,092681,Semenuks; Arturs,2,1,100,98
1657243085325,COGS 14B,A01,083073,Cheng; Tzu-Han,6,0,63,57
1657243091347,COGS 17,A01,092677,Semenuks; Arturs,5,0,81,76
1657243097371,COGS 100,A01,083619,Allen; Michael Gordon,16,0,70,54
1657243103395,COGS 101A,A01,083621,Davis; Joshua Daniel,9,0,68,59
1657243109439,COGS 101B,A01,091572,Allen; Michael Gordon,11,0,65,54
1657243115464,COGS 101C,A01,083625,Delgado; Tania,17,0,35,18
1657243121495,COGS 107A,A01,083627,Boyle; Mary E. T.,13,0,60,47
1657243127518,COGS 118A,A01,083075,Gupta; Anjum,16,0,76,60
1657243133543,CSE 3,A50,083646,Miranda; Gregory Joseph,24,0,50,26
1657243139568,CSE 8A,A50,083650,Miranda; Gregory Joseph,17,1,56,39
1657243145591,CSE 11,A01,083080,Cao; Yingjun,5,15,40,35
1657243151613,CSE 12,A01,083652,Krause-Levy; Sophia Louisa,26,1,120,94
1657243157641,CSE 15L,A01,083654,Morris; Justin Loren,9,0,50,41
1657243157641,CSE 15L,A02,083655,Morris; Justin Loren,9,0,50,41
1657243163662,CSE 20,A01,083657,Tran; Khoa Dang,38,0,80,42
1657243169691,CSE 21,A01,095574,Bach; Quang Tran,22,0,48,26
1657243175719,CSE 30,A01,083084,Eldon; John,4,0,80,76
1657243175719,CSE 30,B01,095061,Bhaskar; Nishant,8,0,50,42
1657243181815,CSE 100,A01,083659,Cao; Yingjun,4,4,70,66
1657243187842,CSE 134B,A01,083661,Powell; Thomas Allan,21,0,100,79
1657243193865,CSE 140,A01,083663,Gungor; Onat,13,0,85,72
1657243199895,CSE 140L,A01,083088,Eldon; John,18,0,100,82
1657243205921,CSE 175,A01,083665,Kumar; Rakesh,3,0,25,22
1657243211945,CSE 190,A00,092507,Dubnov; Shlomo,7,0,20,13
1657243217968,ECE 45,A01,083139,Congero; Spencer William,5,0,75,70
1657243223991,ECE 65,A50,083695,Saad; Andrew S,12,0,30,18
1657243223991,ECE 65,A51,095125,Saad; Andrew S,25,0,26,1
1657243230012,ECE 109,A01,091882,Touri; Behrouz,19,0,70,51
1657243236039,ECE 180,A00,083140,Abi Samra; Nicholas Camill,1,0,30,29
1657243236039,ECE 180,B00,083141,Abi Samra; Nicholas Camill,0,0,30,30
1657243242062,MATH 10A,A01,083735,Patchell; Gregory David,2,0,30,28
1657243242062,MATH 10A,A02,083736,Patchell; Gregory David,20,0,30,10
1657243242062,MATH 10A,A03,083737,Patchell; Gregory David,16,0,30,14
1657243248092,MATH 10B,A01,083207,Lim; Seonhee,7,0,34,27
1657243248092,MATH 10B,A02,083208,Lim; Seonhee,9,0,35,26
1657243248092,MATH 10B,A03,093472,Lim; Seonhee,5,0,34,29
1657243248092,MATH 10B,B01,083739,Sinha; Shubham,11,0,30,19
1657243254116,MATH 18,A01,083743,Cinel; Cameron Alexander,6,0,30,24
1657243254116,MATH 18,A02,083744,Cinel; Cameron Alexander,17,0,30,13
1657243254116,MATH 18,A03,083745,Cinel; Cameron Alexander,8,0,30,22
1657243254116,MATH 18,B01,083748,Rideout; David Porter,4,0,37,33
1657243254116,MATH 18,B02,083749,Rideout; David Porter,4,0,36,32
1657243254116,MATH 18,B03,083750,Rideout; David Porter,2,0,37,35
1657243254116,MATH 18,B04,083751,Rideout; David Porter,6,0,36,30
1657243254116,MATH 18,B05,093473,Rideout; David Porter,5,0,36,31
1657243254116,MATH 18,B06,093474,Rideout; David Porter,5,0,36,31
1657243260139,MATH 20A,A01,083754,Zheng; Zequn,14,0,40,26
1657243266162,MATH 20B,A01,083756,Briones; Jor-el Thomas Caparas,3,0,36,33
1657243266162,MATH 20B,A02,083757,Briones; Jor-el Thomas Caparas,1,0,36,35
1657243266162,MATH 20B,A03,093475,Briones; Jor-el Thomas Caparas,2,0,36,34
1657243272190,MATH 20C,A01,083760,Briones; Jor-el Thomas Caparas,1,0,35,34
1657243272190,MATH 20C,A02,083761,Briones; Jor-el Thomas Caparas,8,0,35,27
1657243272190,MATH 20C,A03,093476,Briones; Jor-el Thomas Caparas,0,1,36,36
1657243272190,MATH 20C,B01,083762,Bach; Quang Tran,1,0,30,29
1657243278214,MATH 20D,A01,083765,Tran; Brian Kha,4,0,30,26
1657243278214,MATH 20D,A02,083766,Tran; Brian Kha,5,0,30,25
1657243278214,MATH 20D,A03,083767,Tran; Brian Kha,4,0,30,26
1657243284239,MATH 20E,A01,083771,Ganguly; Soumya,7,0,32,25
1657243284239,MATH 20E,A02,083772,Ganguly; Soumya,7,0,32,25
1657243284239,MATH 20E,B01,083773,Ciotti; Benjamin,19,0,35,16
1657243284239,MATH 20E,B02,083774,Ciotti; Benjamin,17,0,35,18
1657243290271,MATH 103A,A01,083777,Greenfeld; Be'Eri,3,0,36,33
1657243290271,MATH 103A,A02,083778,Greenfeld; Be'Eri,5,0,36,31
1657243290271,MATH 103A,A03,093561,Greenfeld; Be'Eri,4,0,36,32
1657243290271,MATH 103A,B01,083779,Greenfeld; Be'Eri,6,0,36,30
1657243290271,MATH 103A,B02,083780,Greenfeld; Be'Eri,3,0,36,33
1657243290271,MATH 103A,B03,093562,Greenfeld; Be'Eri,3,0,36,33
1657243296302,MATH 105,A01,085443,Carter; Anne Toulson,15,0,35,20
1657243296302,MATH 105,A02,093477,Carter; Anne Toulson,20,0,35,15
1657243302325,MATH 109,A01,083213,Ganzberger; Geoffrey Michael,2,0,34,32
1657243302325,MATH 109,A02,083214,Ganzberger; Geoffrey Michael,4,0,34,30
1657243302325,MATH 109,A03,093478,Ganzberger; Geoffrey Michael,2,0,34,32
1657243302325,MATH 109,B01,083215,Ganzberger; Geoffrey Michael,1,0,32,31
1657243302325,MATH 109,B02,083216,Ganzberger; Geoffrey Michael,1,0,32,31
1657243302325,MATH 109,B03,093479,Ganzberger; Geoffrey Michael,8,0,32,24
1657243308355,MATH 142A,A01,083219,Chow; Bennett,6,0,32,26
1657243308355,MATH 142A,A02,083220,Chow; Bennett,10,0,32,22
1657243308355,MATH 142A,A03,093480,Chow; Bennett,7,0,32,25
1657243308355,MATH 142A,B03,093481,Chow; Bennett,8,0,32,24
1657243308355,MATH 142A,B04,093558,Chow; Bennett,12,0,32,20
1657243308355,MATH 142A,B05,093559,Chow; Bennett,6,0,32,26
1657243314386,MATH 193A,A01,083224,Rotar; Vladimir,7,0,34,27
1657243314386,MATH 193A,A02,083225,Rotar; Vladimir,6,0,34,28
1657243314386,MATH 193A,A03,083781,Rotar; Vladimir,2,0,34,32
1657243314386,MATH 193A,A04,083782,Rotar; Vladimir,8,0,34,26
1657243314386,MATH 193A,A05,093482,Rotar; Vladimir,6,0,34,28
1657243320413,MATH 197,001,091859,McAuley; Julian John,9999,0,9999,0
1657243320413,MATH 197,002,095566,Kedlaya; Kiran S.,9997,0,9999,2
1657243320413,MATH 197,003,095567,Xiao; Ming,9999,0,9999,0
1657243320413,MATH 197,004,095571,Perols; Johan Lars,9998,0,9999,1
1657243327473,COGS 9,A01,083615,Shannon; Kyle Michael,8,0,75,67
1657243333504,COGS 11,A01,083617,Boyle; Mary E. T.,22,0,48,26
1657243339530,COGS 13,A01,083071,Bastos; Amalia Pinkusfeld,8,0,71,63
1657243345554,COGS 14A,A01,092681,Semenuks; Arturs,2,1,100,98
1657243351581,COGS 14B,A01,083073,Cheng; Tzu-Han,6,0,63,57
1657243357614,COGS 17,A01,092677,Semenuks; Arturs,5,0,81,76
1657243363637,COGS 100,A01,083619,Allen; Michael Gordon,16,0,70,54
1657243369663,COGS 101A,A01,083621,Davis; Joshua Daniel,9,0,68,59
1657243375686,COGS 101B,A01,091572,Allen; Michael Gordon,11,0,65,54
1657243381711,COGS 101C,A01,083625,Delgado; Tania,17,0,35,18
1657243387736,COGS 107A,A01,083627,Boyle; Mary E. T.,13,0,60,47
1657243393762,COGS 118A,A01,083075,Gupta; Anjum,16,0,76,60
1657243399784,CSE 3,A50,083646,Miranda; Gregory Joseph,24,0,50,26
1657243405821,CSE 8A,A50,083650,Miranda; Gregory Joseph,17,1,56,39
1657243411849,CSE 11,A01,083080,Cao; Yingjun,5,15,40,35
1657243417878,CSE 12,A01,083652,Krause-Levy; Sophia Louisa,26,1,120,94
1657243423901,CSE 15L,A01,083654,Morris; Justin Loren,9,0,50,41
1657243423901,CSE 15L,A02,083655,Morris; Justin Loren,9,0,50,41
1657243429927,CSE 20,A01,083657,Tran; Khoa Dang,38,0,80,42
1657243435954,CSE 21,A01,095574,Bach; Quang Tran,22,0,48,26
1657243441979,CSE 30,A01,083084,Eldon; John,4,0,80,76
1657243441979,CSE 30,B01,095061,Bhaskar; Nishant,8,0,50,42
1657243448003,CSE 100,A01,083659,Cao; Yingjun,4,4,70,66
1657243454034,CSE 134B,A01,083661,Powell; Thomas Allan,21,0,100,79
1657243460061,CSE 140,A01,083663,Gungor; Onat,13,0,85,72
1657243466088,CSE 140L,A01,083088,Eldon; John,18,0,100,82
1657243472112,CSE 175,A01,083665,Kumar; Rakesh,3,0,25,22
1657243478138,CSE 190,A00,092507,Dubnov; Shlomo,7,0,20,13
1657243484167,ECE 45,A01,083139,Congero; Spencer William,5,0,75,70
1657243490194,ECE 65,A50,083695,Saad; Andrew S,12,0,30,18
1657243490194,ECE 65,A51,095125,Saad; Andrew S,25,0,26,1
1657243496222,ECE 109,A01,091882,Touri; Behrouz,19,0,70,51
1657243502252,ECE 180,A00,083140,Abi Samra; Nicholas Camill,1,0,30,29
1657243502252,ECE 180,B00,083141,Abi Samra; Nicholas Camill,0,0,30,30
1657243508275,MATH 10A,A01,083735,Patchell; Gregory David,2,0,30,28
1657243508275,MATH 10A,A02,083736,Patchell; Gregory David,20,0,30,10
1657243508275,MATH 10A,A03,083737,Patchell; Gregory David,16,0,30,14
1657243514298,MATH 10B,A01,083207,Lim; Seonhee,7,0,34,27
1657243514298,MATH 10B,A02,083208,Lim; Seonhee,9,0,35,26
1657243514298,MATH 10B,A03,093472,Lim; Seonhee,5,0,34,29
1657243514298,MATH 10B,B01,083739,Sinha; Shubham,11,0,30,19
1657243520323,MATH 18,A01,083743,Cinel; Cameron Alexander,6,0,30,24
1657243520323,MATH 18,A02,083744,Cinel; Cameron Alexander,17,0,30,13
1657243520323,MATH 18,A03,083745,Cinel; Cameron Alexander,8,0,30,22
1657243520323,MATH 18,B01,083748,Rideout; David Porter,4,0,37,33
1657243520323,MATH 18,B02,083749,Rideout; David Porter,4,0,36,32
1657243520323,MATH 18,B03,083750,Rideout; David Porter,2,0,37,35
1657243520323,MATH 18,B04,083751,Rideout; David Porter,6,0,36,30
1657243520323,MATH 18,B05,093473,Rideout; David Porter,5,0,36,31
1657243520323,MATH 18,B06,093474,Rideout; David Porter,5,0,36,31
1657243526357,MATH 20A,A01,083754,Zheng; Zequn,14,0,40,26
1657243532385,MATH 20B,A01,083756,Briones; Jor-el Thomas Caparas,3,0,36,33
1657243532385,MATH 20B,A02,083757,Briones; Jor-el Thomas Caparas,1,0,36,35
1657243532385,MATH 20B,A03,093475,Briones; Jor-el Thomas Caparas,2,0,36,34
1657243538407,MATH 20C,A01,083760,Briones; Jor-el Thomas Caparas,1,0,35,34
1657243538407,MATH 20C,A02,083761,Briones; Jor-el Thomas Caparas,8,0,35,27
1657243538407,MATH 20C,A03,093476,Briones; Jor-el Thomas Caparas,0,1,36,36
1657243538407,MATH 20C,B01,083762,Bach; Quang Tran,1,0,30,29
1657243544429,MATH 20D,A01,083765,Tran; Brian Kha,4,0,30,26
1657243544429,MATH 20D,A02,083766,Tran; Brian Kha,5,0,30,25
1657243544429,MATH 20D,A03,083767,Tran; Brian Kha,4,0,30,26
1657243550458,MATH 20E,A01,083771,Ganguly; Soumya,7,0,32,25
1657243550458,MATH 20E,A02,083772,Ganguly; Soumya,7,0,32,25
1657243550458,MATH 20E,B01,083773,Ciotti; Benjamin,19,0,35,16
1657243550458,MATH 20E,B02,083774,Ciotti; Benjamin,17,0,35,18
1657243556480,MATH 103A,A01,083777,Greenfeld; Be'Eri,3,0,36,33
1657243556480,MATH 103A,A02,083778,Greenfeld; Be'Eri,5,0,36,31
1657243556480,MATH 103A,A03,093561,Greenfeld; Be'Eri,4,0,36,32
1657243556480,MATH 103A,B01,083779,Greenfeld; Be'Eri,6,0,36,30
1657243556480,MATH 103A,B02,083780,Greenfeld; Be'Eri,3,0,36,33
1657243556480,MATH 103A,B03,093562,Greenfeld; Be'Eri,3,0,36,33
1657243562508,MATH 105,A01,085443,Carter; Anne Toulson,15,0,35,20
1657243562508,MATH 105,A02,093477,Carter; Anne Toulson,20,0,35,15
1657243568536,MATH 109,A01,083213,Ganzberger; Geoffrey Michael,2,0,34,32
1657243568536,MATH 109,A02,083214,Ganzberger; Geoffrey Michael,4,0,34,30
1657243568536,MATH 109,A03,093478,Ganzberger; Geoffrey Michael,2,0,34,32
1657243568536,MATH 109,B01,083215,Ganzberger; Geoffrey Michael,1,0,32,31
1657243568536,MATH 109,B02,083216,Ganzberger; Geoffrey Michael,1,0,32,31
1657243568536,MATH 109,B03,093479,Ganzberger; Geoffrey Michael,8,0,32,24
1657243574566,MATH 142A,A01,083219,Chow; Bennett,6,0,32,26
1657243574566,MATH 142A,A02,083220,Chow; Bennett,10,0,32,22
1657243574566,MATH 142A,A03,093480,Chow; Bennett,7,0,32,25
1657243574566,MATH 142A,B03,093481,Chow; Bennett,8,0,32,24
1657243574566,MATH 142A,B04,093558,Chow; Bennett,12,0,32,20
1657243574566,MATH 142A,B05,093559,Chow; Bennett,6,0,32,26
1657243580595,MATH 193A,A01,083224,Rotar; Vladimir,7,0,34,27
1657243580595,MATH 193A,A02,083225,Rotar; Vladimir,6,0,34,28
1657243580595,MATH 193A,A03,083781,Rotar; Vladimir,2,0,34,32
1657243580595,MATH 193A,A04,083782,Rotar; Vladimir,8,0,34,26
1657243580595,MATH 193A,A05,093482,Rotar; Vladimir,6,0,34,28
1657243586630,MATH 197,001,091859,McAuley; Julian John,9999,0,9999,0
1657243586630,MATH 197,002,095566,Kedlaya; Kiran S.,9997,0,9999,2
1657243586630,MATH 197,003,095567,Xiao; Ming,9999,0,9999,0
1657243586630,MATH 197,004,095571,Perols; Johan Lars,9998,0,9999,1
1657243593693,COGS 9,A01,083615,Shannon; Kyle Michael,8,0,75,67
1657243599717,COGS 11,A01,083617,Boyle; Mary E. T.,22,0,48,26
1657243605739,COGS 13,A01,083071,Bastos; Amalia Pinkusfeld,8,0,71,63
1657243611772,COGS 14A,A01,092681,Semenuks; Arturs,2,1,100,98
1657243617800,COGS 14B,A01,083073,Cheng; Tzu-Han,6,0,63,57
1657243623822,COGS 17,A01,092677,Semenuks; Arturs,5,0,81,76
1657243629847,COGS 100,A01,083619,Allen; Michael Gordon,16,0,70,54
1657243635874,COGS 101A,A01,083621,Davis; Joshua Daniel,9,0,68,59
1657243641897,COGS 101B,A01,091572,Allen; Michael Gordon,11,0,65,54
1657243647920,COGS 101C,A01,083625,Delgado; Tania,17,0,35,18
1657243653950,COGS 107A,A01,083627,Boyle; Mary E. T.,13,0,60,47
1657243659973,COGS 118A,A01,083075,Gupta; Anjum,16,0,76,60
1657243666000,CSE 3,A50,083646,Miranda; Gregory Joseph,24,0,50,26
1657243672025,CSE 8A,A50,083650,Miranda; Gregory Joseph,17,1,56,39
1657243678048,CSE 11,A01,083080,Cao; Yingjun,5,15,40,35
1657243684078,CSE 12,A01,083652,Krause-Levy; Sophia Louisa,26,1,120,94
1657243690111,CSE 15L,A01,083654,Morris; Justin Loren,9,0,50,41
1657243690111,CSE 15L,A02,083655,Morris; Justin Loren,9,0,50,41
1657243696138,CSE 20,A01,083657,Tran; Khoa Dang,38,0,80,42
1657243702161,CSE 21,A01,095574,Bach; Quang Tran,22,0,48,26
1657243708188,CSE 30,A01,083084,Eldon; John,4,0,80,76
1657243708188,CSE 30,B01,095061,Bhaskar; Nishant,8,0,50,42
1657243714219,CSE 100,A01,083659,Cao; Yingjun,4,4,70,66
1657243720248,CSE 134B,A01,083661,Powell; Thomas Allan,21,0,100,79
1657243726277,CSE 140,A01,083663,Gungor; Onat,13,0,85,72
1657243732301,CSE 140L,A01,083088,Eldon; John,18,0,100,82
1657243738326,CSE 175,A01,083665,Kumar; Rakesh,3,0,25,22
1657243744349,CSE 190,A00,092507,Dubnov; Shlomo,7,0,20,13
1657243750375,ECE 45,A01,083139,Congero; Spencer William,5,0,75,70
1657243756398,ECE 65,A50,083695,Saad; Andrew S,12,0,30,18
1657243756398,ECE 65,A51,095125,Saad; Andrew S,25,0,26,1
1657243762421,ECE 109,A01,091882,Touri; Behrouz,19,0,70,51
1657243768463,ECE 180,A00,083140,Abi Samra; Nicholas Camill,1,0,30,29
1657243768463,ECE 180,B00,083141,Abi Samra; Nicholas Camill,0,0,30,30
1657243774484,MATH 10A,A01,083735,Patchell; Gregory David,2,0,30,28
1657243774484,MATH 10A,A02,083736,Patchell; Gregory David,20,0,30,10
1657243774484,MATH 10A,A03,083737,Patchell; Gregory David,16,0,30,14
1657243780582,MATH 10B,A01,083207,Lim; Seonhee,7,0,34,27
1657243780582,MATH 10B,A02,083208,Lim; Seonhee,9,0,35,26
1657243780582,MATH 10B,A03,093472,Lim; Seonhee,5,0,34,29
1657243780582,MATH 10B,B01,083739,Sinha; Shubham,11,0,30,19
1657243786637,MATH 18,A01,083743,Cinel; Cameron Alexander,6,0,30,24
1657243786637,MATH 18,A02,083744,Cinel; Cameron Alexander,17,0,30,13
1657243786637,MATH 18,A03,083745,Cinel; Cameron Alexander,8,0,30,22
1657243786637,MATH 18,B01,083748,Rideout; David Porter,4,0,37,33
1657243786637,MATH 18,B02,083749,Rideout; David Porter,4,0,36,32
1657243786637,MATH 18,B03,083750,Rideout; David Porter,2,0,37,35
1657243786637,MATH 18,B04,083751,Rideout; David Porter,6,0,36,30
1657243786637,MATH 18,B05,093473,Rideout; David Porter,5,0,36,31
1657243786637,MATH 18,B06,093474,Rideout; David Porter,5,0,36,31
1657243792674,MATH 20A,A01,083754,Zheng; Zequn,14,0,40,26
1657243798707,MATH 20B,A01,083756,Briones; Jor-el Thomas Caparas,3,0,36,33
1657243798707,MATH 20B,A02,083757,Briones; Jor-el Thomas Caparas,1,0,36,35
1657243798707,MATH 20B,A03,093475,Briones; Jor-el Thomas Caparas,2,0,36,34
1657243804746,MATH 20C,A01,083760,Briones; Jor-el Thomas Caparas,1,0,35,34
1657243804746,MATH 20C,A02,083761,Briones; Jor-el Thomas Caparas,8,0,35,27
1657243804746,MATH 20C,A03,093476,Briones; Jor-el Thomas Caparas,0,1,36,36
1657243804746,MATH 20C,B01,083762,Bach; Quang Tran,1,0,30,29
1657243810769,MATH 20D,A01,083765,Tran; Brian Kha,4,0,30,26
1657243810769,MATH 20D,A02,083766,Tran; Brian Kha,5,0,30,25
1657243810769,MATH 20D,A03,083767,Tran; Brian Kha,4,0,30,26
1657243816798,MATH 20E,A01,083771,Ganguly; Soumya,7,0,32,25
1657243816798,MATH 20E,A02,083772,Ganguly; Soumya,7,0,32,25
1657243816798,MATH 20E,B01,083773,Ciotti; Benjamin,19,0,35,16
1657243816798,MATH 20E,B02,083774,Ciotti; Benjamin,17,0,35,18
1657243822827,MATH 103A,A01,083777,Greenfeld; Be'Eri,3,0,36,33
1657243822827,MATH 103A,A02,083778,Greenfeld; Be'Eri,5,0,36,31
1657243822827,MATH 103A,A03,093561,Greenfeld; Be'Eri,4,0,36,32
1657243822827,MATH 103A,B01,083779,Greenfeld; Be'Eri,6,0,36,30
1657243822827,MATH 103A,B02,083780,Greenfeld; Be'Eri,3,0,36,33
1657243822827,MATH 103A,B03,093562,Greenfeld; Be'Eri,3,0,36,33
1657243828849,MATH 105,A01,085443,Carter; Anne Toulson,15,0,35,20
1657243828849,MATH 105,A02,093477,Carter; Anne Toulson,20,0,35,15
1657243834877,MATH 109,A01,083213,Ganzberger; Geoffrey Michael,2,0,34,32
1657243834877,MATH 109,A02,083214,Ganzberger; Geoffrey Michael,4,0,34,30
1657243834877,MATH 109,A03,093478,Ganzberger; Geoffrey Michael,2,0,34,32
1657243834877,MATH 109,B01,083215,Ganzberger; Geoffrey Michael,1,0,32,31
1657243834877,MATH 109,B02,083216,Ganzberger; Geoffrey Michael,1,0,32,31
1657243834877,MATH 109,B03,093479,Ganzberger; Geoffrey Michael,8,0,32,24
1657243840901,MATH 142A,A01,083219,Chow; Bennett,6,0,32,26
1657243840901,MATH 142A,A02,083220,Chow; Bennett,10,0,32,22
1657243840901,MATH 142A,A03,093480,Chow; Bennett,7,0,32,25
1657243840901,MATH 142A,B03,093481,Chow; Bennett,8,0,32,24
1657243840901,MATH 142A,B04,093558,Chow; Bennett,12,0,32,20
1657243840901,MATH 142A,B05,093559,Chow; Bennett,6,0,32,26
1657243846924,MATH 193A,A01,083224,Rotar; Vladimir,7,0,34,27
1657243846924,MATH 193A,A02,083225,Rotar; Vladimir,6,0,34,28
1657243846924,MATH 193A,A03,083781,Rotar; Vladimir,2,0,34,32
1657243846924,MATH 193A,A04,083782,Rotar; Vladimir,8,0,34,26
1657243846924,MATH 193A,A05,093482,Rotar; Vladimir,6,0,34,28
1657243852957,MATH 197,001,091859,McAuley; Julian John,9999,0,9999,0
1657243852957,MATH 197,002,095566,Kedlaya; Kiran S.,9997,0,9999,2
1657243852957,MATH 197,003,095567,Xiao; Ming,9999,0,9999,0
1657243852957,MATH 197,004,095571,Perols; Johan Lars,9998,0,9999,1
1657243860012,COGS 9,A01,083615,Shannon; Kyle Michael,8,0,75,67
1657243866041,COGS 11,A01,083617,Boyle; Mary E. T.,22,0,48,26
1657243872068,COGS 13,A01,083071,Bastos; Amalia Pinkusfeld,8,0,71,63
1657243878091,COGS 14A,A01,092681,Semenuks; Arturs,2,1,100,98
1657243884118,COGS 14B,A01,083073,Cheng; Tzu-Han,6,0,63,57
1657243890143,COGS 17,A01,092677,Semenuks; Arturs,5,0,81,76
1657243896172,COGS 100,A01,083619,Allen; Michael Gordon,16,0,70,54
1657243902198,COGS 101A,A01,083621,Davis; Joshua Daniel,9,0,68,59
1657243908220,COGS 101B,A01,091572,Allen; Michael Gordon,11,0,65,54
1657243914241,COGS 101C,A01,083625,Delgado; Tania,17,0,35,18
1657243920274,COGS 107A,A01,083627,Boyle; Mary E. T.,13,0,60,47
1657243926300,COGS 118A,A01,083075,Gupta; Anjum,16,0,76,60
1657243932330,CSE 3,A50,083646,Miranda; Gregory Joseph,24,0,50,26
1657243938357,CSE 8A,A50,083650,Miranda; Gregory Joseph,17,1,56,39
1657243944387,CSE 11,A01,083080,Cao; Yingjun,5,15,40,35
1657243950410,CSE 12,A01,083652,Krause-Levy; Sophia Louisa,26,1,120,94
1657243956442,CSE 15L,A01,083654,Morris; Justin Loren,9,0,50,41
1657243956442,CSE 15L,A02,083655,Morris; Justin Loren,9,0,50,41
1657243962476,CSE 20,A01,083657,Tran; Khoa Dang,38,0,80,42
1657243968498,CSE 21,A01,095574,Bach; Quang Tran,22,0,48,26
1657243974521,CSE 30,A01,083084,Eldon; John,4,0,80,76
1657243974521,CSE 30,B01,095061,Bhaskar; Nishant,8,0,50,42
1657243980550,CSE 100,A01,083659,Cao; Yingjun,4,4,70,66
1657243986573,CSE 134B,A01,083661,Powell; Thomas Allan,21,0,100,79
1657243992600,CSE 140,A01,083663,Gungor; Onat,13,0,85,72
1657243998640,CSE 140L,A01,083088,Eldon; John,18,0,100,82
1657244004664,CSE 175,A01,083665,Kumar; Rakesh,3,0,25,22
1657244010691,CSE 190,A00,092507,Dubnov; Shlomo,7,0,20,13
1657244016714,ECE 45,A01,083139,Congero; Spencer William,5,0,75,70
1657244022737,ECE 65,A50,083695,Saad; Andrew S,12,0,30,18
1657244022737,ECE 65,A51,095125,Saad; Andrew S,25,0,26,1
1657244028758,ECE 109,A01,091882,Touri; Behrouz,19,0,70,51
1657244034784,ECE 180,A00,083140,Abi Samra; Nicholas Camill,1,0,30,29
1657244034784,ECE 180,B00,083141,Abi Samra; Nicholas Camill,0,0,30,30
1657244040810,MATH 10A,A01,083735,Patchell; Gregory David,2,0,30,28
1657244040810,MATH 10A,A02,083736,Patchell; Gregory David,20,0,30,10
1657244040810,MATH 10A,A03,083737,Patchell; Gregory David,16,0,30,14
1657244046836,MATH 10B,A01,083207,Lim; Seonhee,7,0,34,27
1657244046836,MATH 10B,A02,083208,Lim; Seonhee,9,0,35,26
1657244046836,MATH 10B,A03,093472,Lim; Seonhee,5,0,34,29
1657244046836,MATH 10B,B01,083739,Sinha; Shubham,11,0,30,19
1657244052866,MATH 18,A01,083743,Cinel; Cameron Alexander,6,0,30,24
1657244052866,MATH 18,A02,083744,Cinel; Cameron Alexander,17,0,30,13
1657244052866,MATH 18,A03,083745,Cinel; Cameron Alexander,8,0,30,22
1657244052866,MATH 18,B01,083748,Rideout; David Porter,4,0,37,33
1657244052866,MATH 18,B02,083749,Rideout; David Porter,4,0,36,32
1657244052866,MATH 18,B03,083750,Rideout; David Porter,2,0,37,35
1657244052866,MATH 18,B04,083751,Rideout; David Porter,6,0,36,30
1657244052866,MATH 18,B05,093473,Rideout; David Porter,5,0,36,31
1657244052866,MATH 18,B06,093474,Rideout; David Porter,5,0,36,31
1657244058890,MATH 20A,A01,083754,Zheng; Zequn,14,0,40,26
1657244064916,MATH 20B,A01,083756,Briones; Jor-el Thomas Caparas,3,0,36,33
1657244064916,MATH 20B,A02,083757,Briones; Jor-el Thomas Caparas,1,0,36,35
1657244064916,MATH 20B,A03,093475,Briones; Jor-el Thomas Caparas,2,0,36,34
1657244070948,MATH 20C,A01,083760,Briones; Jor-el Thomas Caparas,1,0,35,34
1657244070948,MATH 20C,A02,083761,Briones; Jor-el Thomas Caparas,8,0,35,27
1657244070948,MATH 20C,A03,093476,Briones; Jor-el Thomas Caparas,0,1,36,36
1657244070948,MATH 20C,B01,083762,Bach; Quang Tran,1,0,30,29
1657244076975,MATH 20D,A01,083765,Tran; Brian Kha,4,0,30,26
1657244076975,MATH 20D,A02,083766,Tran; Brian Kha,5,0,30,25
1657244076975,MATH 20D,A03,083767,Tran; Brian Kha,4,0,30,26
1657244083001,MATH 20E,A01,083771,Ganguly; Soumya,7,0,32,25
1657244083001,MATH 20E,A02,083772,Ganguly; Soumya,7,0,32,25
1657244083001,MATH 20E,B01,083773,Ciotti; Benjamin,19,0,35,16
1657244083001,MATH 20E,B02,083774,Ciotti; Benjamin,17,0,35,18
1657244089024,MATH 103A,A01,083777,Greenfeld; Be'Eri,3,0,36,33
1657244089024,MATH 103A,A02,083778,Greenfeld; Be'Eri,5,0,36,31
1657244089024,MATH 103A,A03,093561,Greenfeld; Be'Eri,4,0,36,32
1657244089024,MATH 103A,B01,083779,Greenfeld; Be'Eri,6,0,36,30
1657244089024,MATH 103A,B02,083780,Greenfeld; Be'Eri,3,0,36,33
1657244089024,MATH 103A,B03,093562,Greenfeld; Be'Eri,3,0,36,33
1657244095052,MATH 105,A01,085443,Carter; Anne Toulson,15,0,35,20
1657244095052,MATH 105,A02,093477,Carter; Anne Toulson,20,0,35,15
1657244101079,MATH 109,A01,083213,Ganzberger; Geoffrey Michael,2,0,34,32
1657244101079,MATH 109,A02,083214,Ganzberger; Geoffrey Michael,4,0,34,30
1657244101079,MATH 109,A03,093478,Ganzberger; Geoffrey Michael,2,0,34,32
1657244101079,MATH 109,B01,083215,Ganzberger; Geoffrey Michael,1,0,32,31
1657244101079,MATH 109,B02,083216,Ganzberger; Geoffrey Michael,1,0,32,31
1657244101079,MATH 109,B03,093479,Ganzberger; Geoffrey Michael,8,0,32,24
1657244107107,MATH 142A,A01,083219,Chow; Bennett,6,0,32,26
1657244107107,MATH 142A,A02,083220,Chow; Bennett,10,0,32,22
1657244107107,MATH 142A,A03,093480,Chow; Bennett,7,0,32,25
1657244107107,MATH 142A,B03,093481,Chow; Bennett,8,0,32,24
1657244107107,MATH 142A,B04,093558,Chow; Bennett,12,0,32,20
1657244107107,MATH 142A,B05,093559,Chow; Bennett,6,0,32,26
1657244113136,MATH 193A,A01,083224,Rotar; Vladimir,7,0,34,27
1657244113136,MATH 193A,A02,083225,Rotar; Vladimir,6,0,34,28
1657244113136,MATH 193A,A03,083781,Rotar; Vladimir,2,0,34,32
1657244113136,MATH 193A,A04,083782,Rotar; Vladimir,8,0,34,26
1657244113136,MATH 193A,A05,093482,Rotar; Vladimir,6,0,34,28
1657244119161,MATH 197,001,091859,McAuley; Julian John,9999,0,9999,0
1657244119161,MATH 197,002,095566,Kedlaya; Kiran S.,9997,0,9999,2
1657244119161,MATH 197,003,095567,Xiao; Ming,9999,0,9999,0
1657244119161,MATH 197,004,095571,Perols; Johan Lars,9998,0,9999,1
1657244126224,COGS 9,A01,083615,Shannon; Kyle Michael,8,0,75,67
1657244132247,COGS 11,A01,083617,Boyle; Mary E. T.,22,0,48,26
1657244138270,COGS 13,A01,083071,Bastos; Amalia Pinkusfeld,8,0,71,63
1657244144293,COGS 14A,A01,092681,Semenuks; Arturs,2,1,100,98
1657244150316,COGS 14B,A01,083073,Cheng; Tzu-Han,6,0,63,57
1657244156341,COGS 17,A01,092677,Semenuks; Arturs,5,0,81,76
1657244162366,COGS 100,A01,083619,Allen; Michael Gordon,16,0,70,54
1657244168391,COGS 101A,A01,083621,Davis; Joshua Daniel,9,0,68,59
1657244174415,COGS 101B,A01,091572,Allen; Michael Gordon,11,0,65,54
1657244180441,COGS 101C,A01,083625,Delgado; Tania,17,0,35,18
1657244186466,COGS 107A,A01,083627,Boyle; Mary E. T.,13,0,60,47
1657244192490,COGS 118A,A01,083075,Gupta; Anjum,16,0,76,60
1657244198526,CSE 3,A50,083646,Miranda; Gregory Joseph,24,0,50,26
1657244204549,CSE 8A,A50,083650,Miranda; Gregory Joseph,17,1,56,39
1657244210571,CSE 11,A01,083080,Cao; Yingjun,5,15,40,35
1657244216592,CSE 12,A01,083652,Krause-Levy; Sophia Louisa,26,1,120,94
1657244222620,CSE 15L,A01,083654,Morris; Justin Loren,9,0,50,41
1657244222620,CSE 15L,A02,083655,Morris; Justin Loren,9,0,50,41
1657244228643,CSE 20,A01,083657,Tran; Khoa Dang,38,0,80,42
1657244234664,CSE 21,A01,095574,Bach; Quang Tran,22,0,48,26
1657244240704,CSE 30,A01,083084,Eldon; John,4,0,80,76
1657244240704,CSE 30,B01,095061,Bhaskar; Nishant,8,0,50,42
1657244246731,CSE 100,A01,083659,Cao; Yingjun,4,4,70,66
1657244252758,CSE 134B,A01,083661,Powell; Thomas Allan,21,0,100,79
1657244258780,CSE 140,A01,083663,Gungor; Onat,13,0,85,72
1657244264803,CSE 140L,A01,083088,Eldon; John,18,0,100,82
1657244270827,CSE 175,A01,083665,Kumar; Rakesh,3,0,25,22
1657244276853,CSE 190,A00,092507,Dubnov; Shlomo,7,0,20,13
1657244282879,ECE 45,A01,083139,Congero; Spencer William,5,0,75,70
1657244288901,ECE 65,A50,083695,Saad; Andrew S,12,0,30,18
1657244288901,ECE 65,A51,095125,Saad; Andrew S,25,0,26,1
1657244294929,ECE 109,A01,091882,Touri; Behrouz,19,0,70,51
1657244300967,ECE 180,A00,083140,Abi Samra; Nicholas Camill,1,0,30,29
1657244300967,ECE 180,B00,083141,Abi Samra; Nicholas Camill,0,0,30,30
1657244306994,MATH 10A,A01,083735,Patchell; Gregory David,2,0,30,28
1657244306994,MATH 10A,A02,083736,Patchell; Gregory David,20,0,30,10
1657244306994,MATH 10A,A03,083737,Patchell; Gregory David,16,0,30,14
1657244313017,MATH 10B,A01,083207,Lim; Seonhee,7,0,34,27
1657244313017,MATH 10B,A02,083208,Lim; Seonhee,9,0,35,26
1657244313017,MATH 10B,A03,093472,Lim; Seonhee,5,0,34,29
1657244313017,MATH 10B,B01,083739,Sinha; Shubham,11,0,30,19
1657244319040,MATH 18,A01,083743,Cinel; Cameron Alexander,6,0,30,24
1657244319040,MATH 18,A02,083744,Cinel; Cameron Alexander,17,0,30,13
1657244319040,MATH 18,A03,083745,Cinel; Cameron Alexander,8,0,30,22
1657244319040,MATH 18,B01,083748,Rideout; David Porter,4,0,37,33
1657244319040,MATH 18,B02,083749,Rideout; David Porter,4,0,36,32
1657244319040,MATH 18,B03,083750,Rideout; David Porter,2,0,37,35
1657244319040,MATH 18,B04,083751,Rideout; David Porter,6,0,36,30
1657244319040,MATH 18,B05,093473,Rideout; David Porter,5,0,36,31
1657244319040,MATH 18,B06,093474,Rideout; David Porter,5,0,36,31
1657244325062,MATH 20A,A01,083754,Zheng; Zequn,14,0,40,26
1657244331085,MATH 20B,A01,083756,Briones; Jor-el Thomas Caparas,3,0,36,33
1657244331085,MATH 20B,A02,083757,Briones; Jor-el Thomas Caparas,1,0,36,35
1657244331085,MATH 20B,A03,093475,Briones; Jor-el Thomas Caparas,2,0,36,34
1657244337118,MATH 20C,A01,083760,Briones; Jor-el Thomas Caparas,1,0,35,34
1657244337118,MATH 20C,A02,083761,Briones; Jor-el Thomas Caparas,8,0,35,27
1657244337118,MATH 20C,A03,093476,Briones; Jor-el Thomas Caparas,0,1,36,36
1657244337118,MATH 20C,B01,083762,Bach; Quang Tran,1,0,30,29
1657244343146,MATH 20D,A01,083765,Tran; Brian Kha,4,0,30,26
1657244343146,MATH 20D,A02,083766,Tran; Brian Kha,5,0,30,25
1657244343146,MATH 20D,A03,083767,Tran; Brian Kha,4,0,30,26
1657244349176,MATH 20E,A01,083771,Ganguly; Soumya,7,0,32,25
1657244349176,MATH 20E,A02,083772,Ganguly; Soumya,7,0,32,25
1657244349176,MATH 20E,B01,083773,Ciotti; Benjamin,19,0,35,16
1657244349176,MATH 20E,B02,083774,Ciotti; Benjamin,17,0,35,18
1657244355199,MATH 103A,A01,083777,Greenfeld; Be'Eri,3,0,36,33
1657244355199,MATH 103A,A02,083778,Greenfeld; Be'Eri,5,0,36,31
1657244355199,MATH 103A,A03,093561,Greenfeld; Be'Eri,4,0,36,32
1657244355199,MATH 103A,B01,083779,Greenfeld; Be'Eri,6,0,36,30
1657244355199,MATH 103A,B02,083780,Greenfeld; Be'Eri,3,0,36,33
1657244355199,MATH 103A,B03,093562,Greenfeld; Be'Eri,3,0,36,33
1657244361222,MATH 105,A01,085443,Carter; Anne Toulson,15,0,35,20
1657244361222,MATH 105,A02,093477,Carter; Anne Toulson,20,0,35,15
1657244367246,MATH 109,A01,083213,Ganzberger; Geoffrey Michael,2,0,34,32
1657244367246,MATH 109,A02,083214,Ganzberger; Geoffrey Michael,4,0,34,30
1657244367246,MATH 109,A03,093478,Ganzberger; Geoffrey Michael,2,0,34,32
1657244367246,MATH 109,B01,083215,Ganzberger; Geoffrey Michael,1,0,32,31
1657244367246,MATH 109,B02,083216,Ganzberger; Geoffrey Michael,1,0,32,31
1657244367246,MATH 109,B03,093479,Ganzberger; Geoffrey Michael,8,0,32,24
1657244373270,MATH 142A,A01,083219,Chow; Bennett,6,0,32,26
1657244373270,MATH 142A,A02,083220,Chow; Bennett,10,0,32,22
1657244373270,MATH 142A,A03,093480,Chow; Bennett,7,0,32,25
1657244373270,MATH 142A,B03,093481,Chow; Bennett,8,0,32,24
1657244373270,MATH 142A,B04,093558,Chow; Bennett,12,0,32,20
1657244373270,MATH 142A,B05,093559,Chow; Bennett,6,0,32,26
1657244379362,MATH 193A,A01,083224,Rotar; Vladimir,7,0,34,27
1657244379362,MATH 193A,A02,083225,Rotar; Vladimir,6,0,34,28
1657244379362,MATH 193A,A03,083781,Rotar; Vladimir,2,0,34,32
1657244379362,MATH 193A,A04,083782,Rotar; Vladimir,8,0,34,26
1657244379362,MATH 193A,A05,093482,Rotar; Vladimir,6,0,34,28
1657244385387,MATH 197,001,091859,McAuley; Julian John,9999,0,9999,0
1657244385387,MATH 197,002,095566,Kedlaya; Kiran S.,9997,0,9999,2
1657244385387,MATH 197,003,095567,Xiao; Ming,9999,0,9999,0
1657244385387,MATH 197,004,095571,Perols; Johan Lars,9998,0,9999,1
1657244392453,COGS 9,A01,083615,Shannon; Kyle Michael,8,0,75,67
1657244398476,COGS 11,A01,083617,Boyle; Mary E. T.,22,0,48,26
1657244404498,COGS 13,A01,083071,Bastos; Amalia Pinkusfeld,8,0,71,63
1657244410525,COGS 14A,A01,092681,Semenuks; Arturs,2,1,100,98
1657244416555,COGS 14B,A01,083073,Cheng; Tzu-Han,6,0,63,57
1657244422580,COGS 17,A01,092677,Semenuks; Arturs,5,0,81,76
1657244428606,COGS 100,A01,083619,Allen; Michael Gordon,16,0,70,54
1657244434632,COGS 101A,A01,083621,Davis; Joshua Daniel,9,0,68,59
1657244440658,COGS 101B,A01,091572,Allen; Michael Gordon,11,0,65,54
1657244446679,COGS 101C,A01,083625,Delgado; Tania,17,0,35,18
1657244452703,COGS 107A,A01,083627,Boyle; Mary E. T.,13,0,60,47
1657244458729,COGS 118A,A01,083075,Gupta; Anjum,16,0,76,60
1657244464756,CSE 3,A50,083646,Miranda; Gregory Joseph,24,0,50,26
1657244470782,CSE 8A,A50,083650,Miranda; Gregory Joseph,17,1,56,39
1657244476815,CSE 11,A01,083080,Cao; Yingjun,5,15,40,35
1657244482841,CSE 12,A01,083652,Krause-Levy; Sophia Louisa,26,1,120,94
1657244488864,CSE 15L,A01,083654,Morris; Justin Loren,9,0,50,41
1657244488864,CSE 15L,A02,083655,Morris; Justin Loren,9,0,50,41
1657244494890,CSE 20,A01,083657,Tran; Khoa Dang,38,0,80,42
1657244500912,CSE 21,A01,095574,Bach; Quang Tran,22,0,48,26
1657244506936,CSE 30,A01,083084,Eldon; John,4,0,80,76
1657244506936,CSE 30,B01,095061,Bhaskar; Nishant,8,0,50,42
1657244512960,CSE 100,A01,083659,Cao; Yingjun,4,4,70,66
1657244518983,CSE 134B,A01,083661,Powell; Thomas Allan,21,0,100,79
1657244525006,CSE 140,A01,083663,Gungor; Onat,13,0,85,72
1657244531029,CSE 140L,A01,083088,Eldon; John,18,0,100,82
1657244537059,CSE 175,A01,083665,Kumar; Rakesh,3,0,25,22
1657244543085,CSE 190,A00,092507,Dubnov; Shlomo,7,0,20,13
1657244549108,ECE 45,A01,083139,Congero; Spencer William,5,0,75,70
1657244555130,ECE 65,A50,083695,Saad; Andrew S,12,0,30,18
1657244555130,ECE 65,A51,095125,Saad; Andrew S,25,0,26,1
1657244561151,ECE 109,A01,091882,Touri; Behrouz,19,0,70,51
1657244567177,ECE 180,A00,083140,Abi Samra; Nicholas Camill,1,0,30,29
1657244567177,ECE 180,B00,083141,Abi Samra; Nicholas Camill,0,0,30,30
1657244573200,MATH 10A,A01,083735,Patchell; Gregory David,2,0,30,28
1657244573200,MATH 10A,A02,083736,Patchell; Gregory David,20,0,30,10
1657244573200,MATH 10A,A03,083737,Patchell; Gregory David,16,0,30,14
1657244579222,MATH 10B,A01,083207,Lim; Seonhee,7,0,34,27
1657244579222,MATH 10B,A02,083208,Lim; Seonhee,9,0,35,26
1657244579222,MATH 10B,A03,093472,Lim; Seonhee,5,0,34,29
1657244579222,MATH 10B,B01,083739,Sinha; Shubham,11,0,30,19
1657244585247,MATH 18,A01,083743,Cinel; Cameron Alexander,6,0,30,24
1657244585247,MATH 18,A02,083744,Cinel; Cameron Alexander,17,0,30,13
1657244585247,MATH 18,A03,083745,Cinel; Cameron Alexander,8,0,30,22
1657244585247,MATH 18,B01,083748,Rideout; David Porter,4,0,37,33
1657244585247,MATH 18,B02,083749,Rideout; David Porter,4,0,36,32
1657244585247,MATH 18,B03,083750,Rideout; David Porter,2,0,37,35
1657244585247,MATH 18,B04,083751,Rideout; David Porter,6,0,36,30
1657244585247,MATH 18,B05,093473,Rideout; David Porter,5,0,36,31
1657244585247,MATH 18,B06,093474,Rideout; David Porter,5,0,36,31
1657244591269,MATH 20A,A01,083754,Zheng; Zequn,14,0,40,26
1657244597295,MATH 20B,A01,083756,Briones; Jor-el Thomas Caparas,3,0,36,33
1657244597295,MATH 20B,A02,083757,Briones; Jor-el Thomas Caparas,1,0,36,35
1657244597295,MATH 20B,A03,093475,Briones; Jor-el Thomas Caparas,2,0,36,34
1657244603324,MATH 20C,A01,083760,Briones; Jor-el Thomas Caparas,1,0,35,34
1657244603324,MATH 20C,A02,083761,Briones; Jor-el Thomas Caparas,8,0,35,27
1657244603324,MATH 20C,A03,093476,Briones; Jor-el Thomas Caparas,0,1,36,36
1657244603324,MATH 20C,B01,083762,Bach; Quang Tran,1,0,30,29
1657244609348,MATH 20D,A01,083765,Tran; Brian Kha,4,0,30,26
1657244609348,MATH 20D,A02,083766,Tran; Brian Kha,5,0,30,25
1657244609348,MATH 20D,A03,083767,Tran; Brian Kha,4,0,30,26
1657244615377,MATH 20E,A01,083771,Ganguly; Soumya,7,0,32,25
1657244615377,MATH 20E,A02,083772,Ganguly; Soumya,7,0,32,25
1657244615377,MATH 20E,B01,083773,Ciotti; Benjamin,19,0,35,16
1657244615377,MATH 20E,B02,083774,Ciotti; Benjamin,17,0,35,18
1657244621404,MATH 103A,A01,083777,Greenfeld; Be'Eri,3,0,36,33
1657244621404,MATH 103A,A02,083778,Greenfeld; Be'Eri,5,0,36,31
1657244621404,MATH 103A,A03,093561,Greenfeld; Be'Eri,4,0,36,32
1657244621404,MATH 103A,B01,083779,Greenfeld; Be'Eri,6,0,36,30
1657244621404,MATH 103A,B02,083780,Greenfeld; Be'Eri,3,0,36,33
1657244621404,MATH 103A,B03,093562,Greenfeld; Be'Eri,3,0,36,33
1657244627428,MATH 105,A01,085443,Carter; Anne Toulson,15,0,35,20
1657244627428,MATH 105,A02,093477,Carter; Anne Toulson,20,0,35,15
1657244633453,MATH 109,A01,083213,Ganzberger; Geoffrey Michael,2,0,34,32
1657244633453,MATH 109,A02,083214,Ganzberger; Geoffrey Michael,4,0,34,30
1657244633453,MATH 109,A03,093478,Ganzberger; Geoffrey Michael,2,0,34,32
1657244633453,MATH 109,B01,083215,Ganzberger; Geoffrey Michael,1,0,32,31
1657244633453,MATH 109,B02,083216,Ganzberger; Geoffrey Michael,1,0,32,31
1657244633453,MATH 109,B03,093479,Ganzberger; Geoffrey Michael,8,0,32,24
1657244639479,MATH 142A,A01,083219,Chow; Bennett,6,0,32,26
1657244639479,MATH 142A,A02,083220,Chow; Bennett,10,0,32,22
1657244639479,MATH 142A,A03,093480,Chow; Bennett,7,0,32,25
1657244639479,MATH 142A,B03,093481,Chow; Bennett,8,0,32,24
1657244639479,MATH 142A,B04,093558,Chow; Bennett,12,0,32,20
1657244639479,MATH 142A,B05,093559,Chow; Bennett,6,0,32,26
1657244645502,MATH 193A,A01,083224,Rotar; Vladimir,7,0,34,27
1657244645502,MATH 193A,A02,083225,Rotar; Vladimir,6,0,34,28
1657244645502,MATH 193A,A03,083781,Rotar; Vladimir,2,0,34,32
1657244645502,MATH 193A,A04,083782,Rotar; Vladimir,8,0,34,26
1657244645502,MATH 193A,A05,093482,Rotar; Vladimir,6,0,34,28
1657244651525,MATH 197,001,091859,McAuley; Julian John,9999,0,9999,0
1657244651525,MATH 197,002,095566,Kedlaya; Kiran S.,9997,0,9999,2
1657244651525,MATH 197,003,095567,Xiao; Ming,9999,0,9999,0
1657244651525,MATH 197,004,095571,Perols; Johan Lars,9998,0,9999,1
1657244658578,COGS 9,A01,083615,Shannon; Kyle Michael,8,0,75,67
1657244664605,COGS 11,A01,083617,Boyle; Mary E. T.,22,0,48,26
1657244670629,COGS 13,A01,083071,Bastos; Amalia Pinkusfeld,8,0,71,63
1657244676653,COGS 14A,A01,092681,Semenuks; Arturs,2,1,100,98
1657244682692,COGS 14B,A01,083073,Cheng; Tzu-Han,6,0,63,57
1657244688716,COGS 17,A01,092677,Semenuks; Arturs,5,0,81,76
1657244694739,COGS 100,A01,083619,Allen; Michael Gordon,16,0,70,54
1657244700767,COGS 101A,A01,083621,Davis; Joshua Daniel,9,0,68,59
1657244706789,COGS 101B,A01,091572,Allen; Michael Gordon,11,0,65,54
1657244712811,COGS 101C,A01,083625,Delgado; Tania,17,0,35,18
1657244718837,COGS 107A,A01,083627,Boyle; Mary E. T.,13,0,60,47
1657244724861,COGS 118A,A01,083075,Gupta; Anjum,16,0,76,60
1657244730884,CSE 3,A50,083646,Miranda; Gregory Joseph,24,0,50,26
1657244736907,CSE 8A,A50,083650,Miranda; Gregory Joseph,17,1,56,39
1657244742929,CSE 11,A01,083080,Cao; Yingjun,5,15,40,35
1657244748955,CSE 12,A01,083652,Krause-Levy; Sophia Louisa,26,1,120,94
1657244754980,CSE 15L,A01,083654,Morris; Justin Loren,9,0,50,41
1657244754980,CSE 15L,A02,083655,Morris; Justin Loren,9,0,50,41
1657244761004,CSE 20,A01,083657,Tran; Khoa Dang,38,0,80,42
1657244767031,CSE 21,A01,095574,Bach; Quang Tran,22,0,48,26
1657244773055,CSE 30,A01,083084,Eldon; John,4,0,80,76
1657244773055,CSE 30,B01,095061,Bhaskar; Nishant,8,0,50,42
1657244779077,CSE 100,A01,083659,Cao; Yingjun,4,4,70,66
1657244785100,CSE 134B,A01,083661,Powell; Thomas Allan,21,0,100,79
1657244791133,CSE 140,A01,083663,Gungor; Onat,13,0,85,72
1657244797159,CSE 140L,A01,083088,Eldon; John,18,0,100,82
1657244803182,CSE 175,A01,083665,Kumar; Rakesh,3,0,25,22
1657244809205,CSE 190,A00,092507,Dubnov; Shlomo,7,0,20,13
1657244815228,ECE 45,A01,083139,Congero; Spencer William,5,0,75,70
1657244821255,ECE 65,A50,083695,Saad; Andrew S,12,0,30,18
1657244821255,ECE 65,A51,095125,Saad; Andrew S,25,0,26,1
1657244827281,ECE 109,A01,091882,Touri; Behrouz,19,0,70,51
1657244833304,ECE 180,A00,083140,Abi Samra; Nicholas Camill,1,0,30,29
1657244833304,ECE 180,B00,083141,Abi Samra; Nicholas Camill,0,0,30,30
1657244839335,MATH 10A,A01,083735,Patchell; Gregory David,2,0,30,28
1657244839335,MATH 10A,A02,083736,Patchell; Gregory David,20,0,30,10
1657244839335,MATH 10A,A03,083737,Patchell; Gregory David,16,0,30,14
1657244845360,MATH 10B,A01,083207,Lim; Seonhee,7,0,34,27
1657244845360,MATH 10B,A02,083208,Lim; Seonhee,9,0,35,26
1657244845360,MATH 10B,A03,093472,Lim; Seonhee,5,0,34,29
1657244845360,MATH 10B,B01,083739,Sinha; Shubham,11,0,30,19
1657244851386,MATH 18,A01,083743,Cinel; Cameron Alexander,6,0,30,24
1657244851386,MATH 18,A02,083744,Cinel; Cameron Alexander,17,0,30,13
1657244851386,MATH 18,A03,083745,Cinel; Cameron Alexander,8,0,30,22
1657244851386,MATH 18,B01,083748,Rideout; David Porter,4,0,37,33
1657244851386,MATH 18,B02,083749,Rideout; David Porter,4,0,36,32
1657244851386,MATH 18,B03,083750,Rideout; David Porter,2,0,37,35
1657244851386,MATH 18,B04,083751,Rideout; David Porter,6,0,36,30
1657244851386,MATH 18,B05,093473,Rideout; David Porter,5,0,36,31
1657244851386,MATH 18,B06,093474,Rideout; David Porter,5,0,36,31
1657244857410,MATH 20A,A01,083754,Zheng; Zequn,14,0,40,26
1657244863436,MATH 20B,A01,083756,Briones; Jor-el Thomas Caparas,3,0,36,33
1657244863436,MATH 20B,A02,083757,Briones; Jor-el Thomas Caparas,1,0,36,35
1657244863436,MATH 20B,A03,093475,Briones; Jor-el Thomas Caparas,2,0,36,34
1657244869460,MATH 20C,A01,083760,Briones; Jor-el Thomas Caparas,1,0,35,34
1657244869460,MATH 20C,A02,083761,Briones; Jor-el Thomas Caparas,8,0,35,27
1657244869460,MATH 20C,A03,093476,Briones; Jor-el Thomas Caparas,0,1,36,36
1657244869460,MATH 20C,B01,083762,Bach; Quang Tran,1,0,30,29
1657244875481,MATH 20D,A01,083765,Tran; Brian Kha,4,0,30,26
1657244875481,MATH 20D,A02,083766,Tran; Brian Kha,5,0,30,25
1657244875481,MATH 20D,A03,083767,Tran; Brian Kha,4,0,30,26
1657244881510,MATH 20E,A01,083771,Ganguly; Soumya,7,0,32,25
1657244881510,MATH 20E,A02,083772,Ganguly; Soumya,7,0,32,25
1657244881510,MATH 20E,B01,083773,Ciotti; Benjamin,19,0,35,16
1657244881510,MATH 20E,B02,083774,Ciotti; Benjamin,17,0,35,18
1657244887540,MATH 103A,A01,083777,Greenfeld; Be'Eri,3,0,36,33
1657244887540,MATH 103A,A02,083778,Greenfeld; Be'Eri,5,0,36,31
1657244887540,MATH 103A,A03,093561,Greenfeld; Be'Eri,4,0,36,32
1657244887540,MATH 103A,B01,083779,Greenfeld; Be'Eri,6,0,36,30
1657244887540,MATH 103A,B02,083780,Greenfeld; Be'Eri,3,0,36,33
1657244887540,MATH 103A,B03,093562,Greenfeld; Be'Eri,3,0,36,33
1657244893566,MATH 105,A01,085443,Carter; Anne Toulson,15,0,35,20
1657244893566,MATH 105,A02,093477,Carter; Anne Toulson,20,0,35,15
1657244899590,MATH 109,A01,083213,Ganzberger; Geoffrey Michael,2,0,34,32
1657244899590,MATH 109,A02,083214,Ganzberger; Geoffrey Michael,4,0,34,30
1657244899590,MATH 109,A03,093478,Ganzberger; Geoffrey Michael,2,0,34,32
1657244899590,MATH 109,B01,083215,Ganzberger; Geoffrey Michael,1,0,32,31
1657244899590,MATH 109,B02,083216,Ganzberger; Geoffrey Michael,1,0,32,31
1657244899590,MATH 109,B03,093479,Ganzberger; Geoffrey Michael,8,0,32,24
1657244905618,MATH 142A,A01,083219,Chow; Bennett,6,0,32,26
1657244905618,MATH 142A,A02,083220,Chow; Bennett,10,0,32,22
1657244905618,MATH 142A,A03,093480,Chow; Bennett,7,0,32,25
1657244905618,MATH 142A,B03,093481,Chow; Bennett,8,0,32,24
1657244905618,MATH 142A,B04,093558,Chow; Bennett,12,0,32,20
1657244905618,MATH 142A,B05,093559,Chow; Bennett,6,0,32,26
1657244911640,MATH 193A,A01,083224,Rotar; Vladimir,7,0,34,27
1657244911640,MATH 193A,A02,083225,Rotar; Vladimir,6,0,34,28
1657244911640,MATH 193A,A03,083781,Rotar; Vladimir,2,0,34,32
1657244911640,MATH 193A,A04,083782,Rotar; Vladimir,8,0,34,26
1657244911640,MATH 193A,A05,093482,Rotar; Vladimir,6,0,34,28
1657244917673,MATH 197,001,091859,McAuley; Julian John,9999,0,9999,0
1657244917673,MATH 197,002,095566,Kedlaya; Kiran S.,9997,0,9999,2
1657244917673,MATH 197,003,095567,Xiao; Ming,9999,0,9999,0
1657244917673,MATH 197,004,095571,Perols; Johan Lars,9998,0,9999,1
1657244924730,COGS 9,A01,083615,Shannon; Kyle Michael,8,0,75,67
1657244930757,COGS 11,A01,083617,Boyle; Mary E. T.,22,0,48,26
1657244936781,COGS 13,A01,083071,Bastos; Amalia Pinkusfeld,8,0,71,63
1657244942809,COGS 14A,A01,092681,Semenuks; Arturs,2,1,100,98
1657244948836,COGS 14B,A01,083073,Cheng; Tzu-Han,6,0,63,57
1657244954864,COGS 17,A01,092677,Semenuks; Arturs,5,0,81,76
1657244960888,COGS 100,A01,083619,Allen; Michael Gordon,16,0,70,54
1657244966914,COGS 101A,A01,083621,Davis; Joshua Daniel,9,0,68,59
1657244973026,COGS 101B,A01,091572,Allen; Michael Gordon,11,0,65,54
1657244979056,COGS 101C,A01,083625,Delgado; Tania,17,0,35,18
1657244985078,COGS 107A,A01,083627,Boyle; Mary E. T.,13,0,60,47
1657244991101,COGS 118A,A01,083075,Gupta; Anjum,16,0,76,60
1657244997124,CSE 3,A50,083646,Miranda; Gregory Joseph,24,0,50,26
1657245003150,CSE 8A,A50,083650,Miranda; Gregory Joseph,17,1,56,39
1657245009174,CSE 11,A01,083080,Cao; Yingjun,5,15,40,35
1657245015200,CSE 12,A01,083652,Krause-Levy; Sophia Louisa,26,1,120,94
1657245021230,CSE 15L,A01,083654,Morris; Justin Loren,9,0,50,41
1657245021230,CSE 15L,A02,083655,Morris; Justin Loren,9,0,50,41
1657245027271,CSE 20,A01,083657,Tran; Khoa Dang,38,0,80,42
1657245033298,CSE 21,A01,095574,Bach; Quang Tran,22,0,48,26
1657245039320,CSE 30,A01,083084,Eldon; John,4,0,80,76
1657245039320,CSE 30,B01,095061,Bhaskar; Nishant,8,0,50,42
1657245045347,CSE 100,A01,083659,Cao; Yingjun,4,4,70,66
1657245051370,CSE 134B,A01,083661,Powell; Thomas Allan,21,0,100,79
1657245057394,CSE 140,A01,083663,Gungor; Onat,13,0,85,72
1657245063420,CSE 140L,A01,083088,Eldon; John,18,0,100,82
1657245069453,CSE 175,A01,083665,Kumar; Rakesh,3,0,25,22
1657245075479,CSE 190,A00,092507,Dubnov; Shlomo,7,0,20,13
1657245081502,ECE 45,A01,083139,Congero; Spencer William,5,0,75,70
1657245087536,ECE 65,A50,083695,Saad; Andrew S,12,0,30,18
1657245087536,ECE 65,A51,095125,Saad; Andrew S,25,0,26,1
1657245093559,ECE 109,A01,091882,Touri; Behrouz,19,0,70,51
1657245099591,ECE 180,A00,083140,Abi Samra; Nicholas Camill,1,0,30,29
1657245099591,ECE 180,B00,083141,Abi Samra; Nicholas Camill,0,0,30,30
1657245105616,MATH 10A,A01,083735,Patchell; Gregory David,2,0,30,28
1657245105616,MATH 10A,A02,083736,Patchell; Gregory David,20,0,30,10
1657245105616,MATH 10A,A03,083737,Patchell; Gregory David,16,0,30,14
1657245111654,MATH 10B,A01,083207,Lim; Seonhee,7,0,34,27
1657245111654,MATH 10B,A02,083208,Lim; Seonhee,9,0,35,26
1657245111654,MATH 10B,A03,093472,Lim; Seonhee,5,0,34,29
1657245111654,MATH 10B,B01,083739,Sinha; Shubham,11,0,30,19
1657245117690,MATH 18,A01,083743,Cinel; Cameron Alexander,6,0,30,24
1657245117690,MATH 18,A02,083744,Cinel; Cameron Alexander,17,0,30,13
1657245117690,MATH 18,A03,083745,Cinel; Cameron Alexander,8,0,30,22
1657245117690,MATH 18,B01,083748,Rideout; David Porter,4,0,37,33
1657245117690,MATH 18,B02,083749,Rideout; David Porter,4,0,36,32
1657245117690,MATH 18,B03,083750,Rideout; David Porter,2,0,37,35
1657245117690,MATH 18,B04,083751,Rideout; David Porter,6,0,36,30
1657245117690,MATH 18,B05,093473,Rideout; David Porter,5,0,36,31
1657245117690,MATH 18,B06,093474,Rideout; David Porter,5,0,36,31
1657245123712,MATH 20A,A01,083754,Zheng; Zequn,14,0,40,26
1657245129736,MATH 20B,A01,083756,Briones; Jor-el Thomas Caparas,3,0,36,33
1657245129736,MATH 20B,A02,083757,Briones; Jor-el Thomas Caparas,1,0,36,35
1657245129736,MATH 20B,A03,093475,Briones; Jor-el Thomas Caparas,2,0,36,34
1657245135764,MATH 20C,A01,083760,Briones; Jor-el Thomas Caparas,1,0,35,34
1657245135764,MATH 20C,A02,083761,Briones; Jor-el Thomas Caparas,8,0,35,27
1657245135764,MATH 20C,A03,093476,Briones; Jor-el Thomas Caparas,0,1,36,36
1657245135764,MATH 20C,B01,083762,Bach; Quang Tran,1,0,30,29
1657245141788,MATH 20D,A01,083765,Tran; Brian Kha,4,0,30,26
1657245141788,MATH 20D,A02,083766,Tran; Brian Kha,5,0,30,25
1657245141788,MATH 20D,A03,083767,Tran; Brian Kha,4,0,30,26
1657245147812,MATH 20E,A01,083771,Ganguly; Soumya,7,0,32,25
1657245147812,MATH 20E,A02,083772,Ganguly; Soumya,7,0,32,25
1657245147812,MATH 20E,B01,083773,Ciotti; Benjamin,19,0,35,16
1657245147812,MATH 20E,B02,083774,Ciotti; Benjamin,17,0,35,18
1657245153842,MATH 103A,A01,083777,Greenfeld; Be'Eri,3,0,36,33
1657245153842,MATH 103A,A02,083778,Greenfeld; Be'Eri,5,0,36,31
1657245153842,MATH 103A,A03,093561,Greenfeld; Be'Eri,4,0,36,32
1657245153842,MATH 103A,B01,083779,Greenfeld; Be'Eri,6,0,36,30
1657245153842,MATH 103A,B02,083780,Greenfeld; Be'Eri,3,0,36,33
1657245153842,MATH 103A,B03,093562,Greenfeld; Be'Eri,3,0,36,33
1657245159872,MATH 105,A01,085443,Carter; Anne Toulson,15,0,35,20
1657245159872,MATH 105,A02,093477,Carter; Anne Toulson,20,0,35,15
1657245165897,MATH 109,A01,083213,Ganzberger; Geoffrey Michael,2,0,34,32
1657245165897,MATH 109,A02,083214,Ganzberger; Geoffrey Michael,4,0,34,30
1657245165897,MATH 109,A03,093478,Ganzberger; Geoffrey Michael,2,0,34,32
1657245165897,MATH 109,B01,083215,Ganzberger; Geoffrey Michael,1,0,32,31
1657245165897,MATH 109,B02,083216,Ganzberger; Geoffrey Michael,1,0,32,31
1657245165897,MATH 109,B03,093479,Ganzberger; Geoffrey Michael,8,0,32,24
1657245171922,MATH 142A,A01,083219,Chow; Bennett,6,0,32,26
1657245171922,MATH 142A,A02,083220,Chow; Bennett,10,0,32,22
1657245171922,MATH 142A,A03,093480,Chow; Bennett,7,0,32,25
1657245171922,MATH 142A,B03,093481,Chow; Bennett,8,0,32,24
1657245171922,MATH 142A,B04,093558,Chow; Bennett,12,0,32,20
1657245171922,MATH 142A,B05,093559,Chow; Bennett,6,0,32,26
1657245177946,MATH 193A,A01,083224,Rotar; Vladimir,7,0,34,27
1657245177946,MATH 193A,A02,083225,Rotar; Vladimir,6,0,34,28
1657245177946,MATH 193A,A03,083781,Rotar; Vladimir,2,0,34,32
1657245177946,MATH 193A,A04,083782,Rotar; Vladimir,8,0,34,26
1657245177946,MATH 193A,A05,093482,Rotar; Vladimir,6,0,34,28
1657245183969,MATH 197,001,091859,McAuley; Julian John,9999,0,9999,0
1657245183969,MATH 197,002,095566,Kedlaya; Kiran S.,9997,0,9999,2
1657245183969,MATH 197,003,095567,Xiao; Ming,9999,0,9999,0
1657245183969,MATH 197,004,095571,Perols; Johan Lars,9998,0,9999,1
1657245191034,COGS 9,A01,083615,Shannon; Kyle Michael,8,0,75,67
1657245197060,COGS 11,A01,083617,Boyle; Mary E. T.,22,0,48,26
1657245203089,COGS 13,A01,083071,Bastos; Amalia Pinkusfeld,8,0,71,63
1657245209113,COGS 14A,A01,092681,Semenuks; Arturs,2,1,100,98
1657245215156,COGS 14B,A01,083073,Cheng; Tzu-Han,6,0,63,57
1657245221181,COGS 17,A01,092677,Semenuks; Arturs,5,0,81,76
1657245227206,COGS 100,A01,083619,Allen; Michael Gordon,16,0,70,54
1657245233235,COGS 101A,A01,083621,Davis; Joshua Daniel,9,0,68,59
1657245239262,COGS 101B,A01,091572,Allen; Michael Gordon,11,0,65,54
1657245245292,COGS 101C,A01,083625,Delgado; Tania,17,0,35,18
1657245251318,COGS 107A,A01,083627,Boyle; Mary E. T.,13,0,60,47
1657245257342,COGS 118A,A01,083075,Gupta; Anjum,16,0,76,60
1657245263364,CSE 3,A50,083646,Miranda; Gregory Joseph,24,0,50,26
1657245269388,CSE 8A,A50,083650,Miranda; Gregory Joseph,17,1,56,39
1657245275414,CSE 11,A01,083080,Cao; Yingjun,5,15,40,35
1657245281440,CSE 12,A01,083652,Krause-Levy; Sophia Louisa,26,1,120,94
1657245287463,CSE 15L,A01,083654,Morris; Justin Loren,9,0,50,41
1657245287463,CSE 15L,A02,083655,Morris; Justin Loren,9,0,50,41
1657245293489,CSE 20,A01,083657,Tran; Khoa Dang,38,0,80,42
1657245299515,CSE 21,A01,095574,Bach; Quang Tran,22,0,48,26
1657245305538,CSE 30,A01,083084,Eldon; John,4,0,80,76
1657245305538,CSE 30,B01,095061,Bhaskar; Nishant,8,0,50,42
1657245311564,CSE 100,A01,083659,Cao; Yingjun,4,4,70,66
1657245317586,CSE 134B,A01,083661,Powell; Thomas Allan,21,0,100,79
1657245323611,CSE 140,A01,083663,Gungor; Onat,13,0,85,72
1657245329638,CSE 140L,A01,083088,Eldon; John,18,0,100,82
1657245335662,CSE 175,A01,083665,Kumar; Rakesh,3,0,25,22
1657245341683,CSE 190,A00,092507,Dubnov; Shlomo,7,0,20,13
1657245347711,ECE 45,A01,083139,Congero; Spencer William,5,0,75,70
1657245353733,ECE 65,A50,083695,Saad; Andrew S,12,0,30,18
1657245353733,ECE 65,A51,095125,Saad; Andrew S,25,0,26,1
1657245359760,ECE 109,A01,091882,Touri; Behrouz,19,0,70,51
1657245365786,ECE 180,A00,083140,Abi Samra; Nicholas Camill,1,0,30,29
1657245365786,ECE 180,B00,083141,Abi Samra; Nicholas Camill,0,0,30,30
1657245371809,MATH 10A,A01,083735,Patchell; Gregory David,2,0,30,28
1657245371809,MATH 10A,A02,083736,Patchell; Gregory David,20,0,30,10
1657245371809,MATH 10A,A03,083737,Patchell; Gregory David,16,0,30,14
1657245377838,MATH 10B,A01,083207,Lim; Seonhee,7,0,34,27
1657245377838,MATH 10B,A02,083208,Lim; Seonhee,9,0,35,26
1657245377838,MATH 10B,A03,093472,Lim; Seonhee,5,0,34,29
1657245377838,MATH 10B,B01,083739,Sinha; Shubham,11,0,30,19
1657245383869,MATH 18,A01,083743,Cinel; Cameron Alexander,6,0,30,24
1657245383869,MATH 18,A02,083744,Cinel; Cameron Alexander,17,0,30,13
1657245383869,MATH 18,A03,083745,Cinel; Cameron Alexander,8,0,30,22
1657245383869,MATH 18,B01,083748,Rideout; David Porter,4,0,37,33
1657245383869,MATH 18,B02,083749,Rideout; David Porter,4,0,36,32
1657245383869,MATH 18,B03,083750,Rideout; David Porter,2,0,37,35
1657245383869,MATH 18,B04,083751,Rideout; David Porter,6,0,36,30
1657245383869,MATH 18,B05,093473,Rideout; David Porter,5,0,36,31
1657245383869,MATH 18,B06,093474,Rideout; David Porter,5,0,36,31
1657245389896,MATH 20A,A01,083754,Zheng; Zequn,14,0,40,26
1657245395919,MATH 20B,A01,083756,Briones; Jor-el Thomas Caparas,3,0,36,33
1657245395919,MATH 20B,A02,083757,Briones; Jor-el Thomas Caparas,1,0,36,35
1657245395919,MATH 20B,A03,093475,Briones; Jor-el Thomas Caparas,2,0,36,34
1657245401943,MATH 20C,A01,083760,Briones; Jor-el Thomas Caparas,1,0,35,34
1657245401943,MATH 20C,A02,083761,Briones; Jor-el Thomas Caparas,8,0,35,27
1657245401943,MATH 20C,A03,093476,Briones; Jor-el Thomas Caparas,0,1,36,36
1657245401943,MATH 20C,B01,083762,Bach; Quang Tran,1,0,30,29
1657245407965,MATH 20D,A01,083765,Tran; Brian Kha,4,0,30,26
1657245407965,MATH 20D,A02,083766,Tran; Brian Kha,5,0,30,25
1657245407965,MATH 20D,A03,083767,Tran; Brian Kha,4,0,30,26
1657245413992,MATH 20E,A01,083771,Ganguly; Soumya,7,0,32,25
1657245413992,MATH 20E,A02,083772,Ganguly; Soumya,7,0,32,25
1657245413992,MATH 20E,B01,083773,Ciotti; Benjamin,19,0,35,16
1657245413992,MATH 20E,B02,083774,Ciotti; Benjamin,17,0,35,18
1657245420022,MATH 103A,A01,083777,Greenfeld; Be'Eri,3,0,36,33
1657245420022,MATH 103A,A02,083778,Greenfeld; Be'Eri,5,0,36,31
1657245420022,MATH 103A,A03,093561,Greenfeld; Be'Eri,4,0,36,32
1657245420022,MATH 103A,B01,083779,Greenfeld; Be'Eri,6,0,36,30
1657245420022,MATH 103A,B02,083780,Greenfeld; Be'Eri,3,0,36,33
1657245420022,MATH 103A,B03,093562,Greenfeld; Be'Eri,3,0,36,33
1657245426052,MATH 105,A01,085443,Carter; Anne Toulson,15,0,35,20
1657245426052,MATH 105,A02,093477,Carter; Anne Toulson,20,0,35,15
1657245432076,MATH 109,A01,083213,Ganzberger; Geoffrey Michael,2,0,34,32
1657245432076,MATH 109,A02,083214,Ganzberger; Geoffrey Michael,4,0,34,30
1657245432076,MATH 109,A03,093478,Ganzberger; Geoffrey Michael,2,0,34,32
1657245432076,MATH 109,B01,083215,Ganzberger; Geoffrey Michael,1,0,32,31
1657245432076,MATH 109,B02,083216,Ganzberger; Geoffrey Michael,1,0,32,31
1657245432076,MATH 109,B03,093479,Ganzberger; Geoffrey Michael,8,0,32,24
1657245438101,MATH 142A,A01,083219,Chow; Bennett,6,0,32,26
1657245438101,MATH 142A,A02,083220,Chow; Bennett,10,0,32,22
1657245438101,MATH 142A,A03,093480,Chow; Bennett,7,0,32,25
1657245438101,MATH 142A,B03,093481,Chow; Bennett,8,0,32,24
1657245438101,MATH 142A,B04,093558,Chow; Bennett,12,0,32,20
1657245438101,MATH 142A,B05,093559,Chow; Bennett,6,0,32,26
1657245444128,MATH 193A,A01,083224,Rotar; Vladimir,7,0,34,27
1657245444128,MATH 193A,A02,083225,Rotar; Vladimir,6,0,34,28
1657245444128,MATH 193A,A03,083781,Rotar; Vladimir,2,0,34,32
1657245444128,MATH 193A,A04,083782,Rotar; Vladimir,8,0,34,26
1657245444128,MATH 193A,A05,093482,Rotar; Vladimir,6,0,34,28
1657245450155,MATH 197,001,091859,McAuley; Julian John,9999,0,9999,0
1657245450155,MATH 197,002,095566,Kedlaya; Kiran S.,9997,0,9999,2
1657245450155,MATH 197,003,095567,Xiao; Ming,9999,0,9999,0
1657245450155,MATH 197,004,095571,Perols; Johan Lars,9998,0,9999,1
1657245457208,COGS 9,A01,083615,Shannon; Kyle Michael,8,0,75,67
1657245463235,COGS 11,A01,083617,Boyle; Mary E. T.,22,0,48,26
1657245469260,COGS 13,A01,083071,Bastos; Amalia Pinkusfeld,8,0,71,63
1657245475282,COGS 14A,A01,092681,Semenuks; Arturs,2,1,100,98
1657245481305,COGS 14B,A01,083073,Cheng; Tzu-Han,6,0,63,57
1657245487327,COGS 17,A01,092677,Semenuks; Arturs,5,0,81,76
1657245493349,COGS 100,A01,083619,Allen; Michael Gordon,16,0,70,54
1657245499376,COGS 101A,A01,083621,Davis; Joshua Daniel,9,0,68,59
1657245505402,COGS 101B,A01,091572,Allen; Michael Gordon,11,0,65,54
1657245511423,COGS 101C,A01,083625,Delgado; Tania,17,0,35,18
1657245517447,COGS 107A,A01,083627,Boyle; Mary E. T.,13,0,60,47
1657245523470,COGS 118A,A01,083075,Gupta; Anjum,16,0,76,60
1657245529498,CSE 3,A50,083646,Miranda; Gregory Joseph,24,0,50,26
1657245535521,CSE 8A,A50,083650,Miranda; Gregory Joseph,17,1,56,39
1657245541545,CSE 11,A01,083080,Cao; Yingjun,5,15,40,35
1657245547571,CSE 12,A01,083652,Krause-Levy; Sophia Louisa,26,1,120,94
1657245553597,CSE 15L,A01,083654,Morris; Justin Loren,9,0,50,41
1657245553597,CSE 15L,A02,083655,Morris; Justin Loren,9,0,50,41
1657245559622,CSE 20,A01,083657,Tran; Khoa Dang,38,0,80,42
1657245565646,CSE 21,A01,095574,Bach; Quang Tran,22,0,48,26
1657245571767,CSE 30,A01,083084,Eldon; John,4,0,80,76
1657245571767,CSE 30,B01,095061,Bhaskar; Nishant,8,0,50,42
1657245577792,CSE 100,A01,083659,Cao; Yingjun,4,4,70,66
1657245583817,CSE 134B,A01,083661,Powell; Thomas Allan,21,0,100,79
1657245589843,CSE 140,A01,083663,Gungor; Onat,13,0,85,72
1657245595869,CSE 140L,A01,083088,Eldon; John,18,0,100,82
1657245601896,CSE 175,A01,083665,Kumar; Rakesh,3,0,25,22
1657245607919,CSE 190,A00,092507,Dubnov; Shlomo,7,0,20,13
1657245613942,ECE 45,A01,083139,Congero; Spencer William,5,0,75,70
1657245619970,ECE 65,A50,083695,Saad; Andrew S,12,0,30,18
1657245619970,ECE 65,A51,095125,Saad; Andrew S,25,0,26,1
1657245625996,ECE 109,A01,091882,Touri; Behrouz,19,0,70,51
1657245632021,ECE 180,A00,083140,Abi Samra; Nicholas Camill,1,0,30,29
1657245632021,ECE 180,B00,083141,Abi Samra; Nicholas Camill,0,0,30,30
1657245638048,MATH 10A,A01,083735,Patchell; Gregory David,2,0,30,28
1657245638048,MATH 10A,A02,083736,Patchell; Gregory David,20,0,30,10
1657245638048,MATH 10A,A03,083737,Patchell; Gregory David,16,0,30,14
1657245644071,MATH 10B,A01,083207,Lim; Seonhee,7,0,34,27
1657245644071,MATH 10B,A02,083208,Lim; Seonhee,9,0,35,26
1657245644071,MATH 10B,A03,093472,Lim; Seonhee,5,0,34,29
1657245644071,MATH 10B,B01,083739,Sinha; Shubham,11,0,30,19
1657245650101,MATH 18,A01,083743,Cinel; Cameron Alexander,6,0,30,24
1657245650101,MATH 18,A02,083744,Cinel; Cameron Alexander,17,0,30,13
1657245650101,MATH 18,A03,083745,Cinel; Cameron Alexander,8,0,30,22
1657245650101,MATH 18,B01,083748,Rideout; David Porter,4,0,37,33
1657245650101,MATH 18,B02,083749,Rideout; David Porter,4,0,36,32
1657245650101,MATH 18,B03,083750,Rideout; David Porter,2,0,37,35
1657245650101,MATH 18,B04,083751,Rideout; David Porter,6,0,36,30
1657245650101,MATH 18,B05,093473,Rideout; David Porter,5,0,36,31
1657245650101,MATH 18,B06,093474,Rideout; David Porter,5,0,36,31
1657245656125,MATH 20A,A01,083754,Zheng; Zequn,14,0,40,26
1657245662149,MATH 20B,A01,083756,Briones; Jor-el Thomas Caparas,3,0,36,33
1657245662149,MATH 20B,A02,083757,Briones; Jor-el Thomas Caparas,1,0,36,35
1657245662149,MATH 20B,A03,093475,Briones; Jor-el Thomas Caparas,2,0,36,34
1657245668177,MATH 20C,A01,083760,Briones; Jor-el Thomas Caparas,1,0,35,34
1657245668177,MATH 20C,A02,083761,Briones; Jor-el Thomas Caparas,8,0,35,27
1657245668177,MATH 20C,A03,093476,Briones; Jor-el Thomas Caparas,0,1,36,36
1657245668177,MATH 20C,B01,083762,Bach; Quang Tran,1,0,30,29
1657245674204,MATH 20D,A01,083765,Tran; Brian Kha,4,0,30,26
1657245674204,MATH 20D,A02,083766,Tran; Brian Kha,5,0,30,25
1657245674204,MATH 20D,A03,083767,Tran; Brian Kha,4,0,30,26
1657245680233,MATH 20E,A01,083771,Ganguly; Soumya,7,0,32,25
1657245680233,MATH 20E,A02,083772,Ganguly; Soumya,7,0,32,25
1657245680233,MATH 20E,B01,083773,Ciotti; Benjamin,19,0,35,16
1657245680233,MATH 20E,B02,083774,Ciotti; Benjamin,17,0,35,18
1657245686261,MATH 103A,A01,083777,Greenfeld; Be'Eri,3,0,36,33
1657245686261,MATH 103A,A02,083778,Greenfeld; Be'Eri,5,0,36,31
1657245686261,MATH 103A,A03,093561,Greenfeld; Be'Eri,4,0,36,32
1657245686261,MATH 103A,B01,083779,Greenfeld; Be'Eri,6,0,36,30
1657245686261,MATH 103A,B02,083780,Greenfeld; Be'Eri,3,0,36,33
1657245686261,MATH 103A,B03,093562,Greenfeld; Be'Eri,3,0,36,33
1657245692283,MATH 105,A01,085443,Carter; Anne Toulson,15,0,35,20
1657245692283,MATH 105,A02,093477,Carter; Anne Toulson,20,0,35,15
1657245698306,MATH 109,A01,083213,Ganzberger; Geoffrey Michael,2,0,34,32
1657245698306,MATH 109,A02,083214,Ganzberger; Geoffrey Michael,4,0,34,30
1657245698306,MATH 109,A03,093478,Ganzberger; Geoffrey Michael,2,0,34,32
1657245698306,MATH 109,B01,083215,Ganzberger; Geoffrey Michael,1,0,32,31
1657245698306,MATH 109,B02,083216,Ganzberger; Geoffrey Michael,1,0,32,31
1657245698306,MATH 109,B03,093479,Ganzberger; Geoffrey Michael,8,0,32,24
1657245704340,MATH 142A,A01,083219,Chow; Bennett,6,0,32,26
1657245704340,MATH 142A,A02,083220,Chow; Bennett,10,0,32,22
1657245704340,MATH 142A,A03,093480,Chow; Bennett,7,0,32,25
1657245704340,MATH 142A,B03,093481,Chow; Bennett,8,0,32,24
1657245704340,MATH 142A,B04,093558,Chow; Bennett,12,0,32,20
1657245704340,MATH 142A,B05,093559,Chow; Bennett,6,0,32,26
1657245710369,MATH 193A,A01,083224,Rotar; Vladimir,7,0,34,27
1657245710369,MATH 193A,A02,083225,Rotar; Vladimir,6,0,34,28
1657245710369,MATH 193A,A03,083781,Rotar; Vladimir,2,0,34,32
1657245710369,MATH 193A,A04,083782,Rotar; Vladimir,8,0,34,26
1657245710369,MATH 193A,A05,093482,Rotar; Vladimir,6,0,34,28
1657245716393,MATH 197,001,091859,McAuley; Julian John,9999,0,9999,0
1657245716393,MATH 197,002,095566,Kedlaya; Kiran S.,9997,0,9999,2
1657245716393,MATH 197,003,095567,Xiao; Ming,9999,0,9999,0
1657245716393,MATH 197,004,095571,Perols; Johan Lars,9998,0,9999,1
1657245723460,COGS 9,A01,083615,Shannon; Kyle Michael,8,0,75,67
1657245729487,COGS 11,A01,083617,Boyle; Mary E. T.,22,0,48,26
1657245735512,COGS 13,A01,083071,Bastos; Amalia Pinkusfeld,8,0,71,63
1657245741535,COGS 14A,A01,092681,Semenuks; Arturs,2,1,100,98
1657245747558,COGS 14B,A01,083073,Cheng; Tzu-Han,6,0,63,57
1657245753580,COGS 17,A01,092677,Semenuks; Arturs,5,0,81,76
1657245759605,COGS 100,A01,083619,Allen; Michael Gordon,16,0,70,54
1657245765629,COGS 101A,A01,083621,Davis; Joshua Daniel,9,0,68,59
1657245771653,COGS 101B,A01,091572,Allen; Michael Gordon,11,0,65,54
1657245777695,COGS 101C,A01,083625,Delgado; Tania,17,0,35,18
1657245783719,COGS 107A,A01,083627,Boyle; Mary E. T.,13,0,60,47
1657245789746,COGS 118A,A01,083075,Gupta; Anjum,16,0,76,60
1657245795770,CSE 3,A50,083646,Miranda; Gregory Joseph,24,0,50,26
1657245801800,CSE 8A,A50,083650,Miranda; Gregory Joseph,17,1,56,39
1657245807833,CSE 11,A01,083080,Cao; Yingjun,5,15,40,35
1657245813864,CSE 12,A01,083652,Krause-Levy; Sophia Louisa,26,1,120,94
1657245819888,CSE 15L,A01,083654,Morris; Justin Loren,9,0,50,41
1657245819888,CSE 15L,A02,083655,Morris; Justin Loren,9,0,50,41
1657245825911,CSE 20,A01,083657,Tran; Khoa Dang,38,0,80,42
1657245831934,CSE 21,A01,095574,Bach; Quang Tran,22,0,48,26
1657245837957,CSE 30,A01,083084,Eldon; John,4,0,80,76
1657245837957,CSE 30,B01,095061,Bhaskar; Nishant,8,0,50,42
1657245843989,CSE 100,A01,083659,Cao; Yingjun,4,4,70,66
1657245850018,CSE 134B,A01,083661,Powell; Thomas Allan,21,0,100,79
1657245856043,CSE 140,A01,083663,Gungor; Onat,13,0,85,72
1657245862068,CSE 140L,A01,083088,Eldon; John,18,0,100,82
1657245868097,CSE 175,A01,083665,Kumar; Rakesh,3,0,25,22
1657245874121,CSE 190,A00,092507,Dubnov; Shlomo,7,0,20,13
1657245880151,ECE 45,A01,083139,Congero; Spencer William,5,0,75,70
1657245886175,ECE 65,A50,083695,Saad; Andrew S,12,0,30,18
1657245886175,ECE 65,A51,095125,Saad; Andrew S,25,0,26,1
1657245892198,ECE 109,A01,091882,Touri; Behrouz,19,0,70,51
1657245898224,ECE 180,A00,083140,Abi Samra; Nicholas Camill,1,0,30,29
1657245898224,ECE 180,B00,083141,Abi Samra; Nicholas Camill,0,0,30,30
1657245904252,MATH 10A,A01,083735,Patchell; Gregory David,2,0,30,28
1657245904252,MATH 10A,A02,083736,Patchell; Gregory David,20,0,30,10
1657245904252,MATH 10A,A03,083737,Patchell; Gregory David,16,0,30,14
1657245910275,MATH 10B,A01,083207,Lim; Seonhee,7,0,34,27
1657245910275,MATH 10B,A02,083208,Lim; Seonhee,9,0,35,26
1657245910275,MATH 10B,A03,093472,Lim; Seonhee,5,0,34,29
1657245910275,MATH 10B,B01,083739,Sinha; Shubham,11,0,30,19
1657245916309,MATH 18,A01,083743,Cinel; Cameron Alexander,6,0,30,24
1657245916309,MATH 18,A02,083744,Cinel; Cameron Alexander,17,0,30,13
1657245916309,MATH 18,A03,083745,Cinel; Cameron Alexander,8,0,30,22
1657245916309,MATH 18,B01,083748,Rideout; David Porter,4,0,37,33
1657245916309,MATH 18,B02,083749,Rideout; David Porter,4,0,36,32
1657245916309,MATH 18,B03,083750,Rideout; David Porter,2,0,37,35
1657245916309,MATH 18,B04,083751,Rideout; David Porter,6,0,36,30
1657245916309,MATH 18,B05,093473,Rideout; David Porter,5,0,36,31
1657245916309,MATH 18,B06,093474,Rideout; David Porter,5,0,36,31
1657245922331,MATH 20A,A01,083754,Zheng; Zequn,14,0,40,26
1657245928353,MATH 20B,A01,083756,Briones; Jor-el Thomas Caparas,3,0,36,33
1657245928353,MATH 20B,A02,083757,Briones; Jor-el Thomas Caparas,1,0,36,35
1657245928353,MATH 20B,A03,093475,Briones; Jor-el Thomas Caparas,2,0,36,34
1657245934377,MATH 20C,A01,083760,Briones; Jor-el Thomas Caparas,1,0,35,34
1657245934377,MATH 20C,A02,083761,Briones; Jor-el Thomas Caparas,8,0,35,27
1657245934377,MATH 20C,A03,093476,Briones; Jor-el Thomas Caparas,0,1,36,36
1657245934377,MATH 20C,B01,083762,Bach; Quang Tran,1,0,30,29
1657245940406,MATH 20D,A01,083765,Tran; Brian Kha,4,0,30,26
1657245940406,MATH 20D,A02,083766,Tran; Brian Kha,5,0,30,25
1657245940406,MATH 20D,A03,083767,Tran; Brian Kha,4,0,30,26
1657245946430,MATH 20E,A01,083771,Ganguly; Soumya,7,0,32,25
1657245946430,MATH 20E,A02,083772,Ganguly; Soumya,7,0,32,25
1657245946430,MATH 20E,B01,083773,Ciotti; Benjamin,19,0,35,16
1657245946430,MATH 20E,B02,083774,Ciotti; Benjamin,17,0,35,18
1657245952462,MATH 103A,A01,083777,Greenfeld; Be'Eri,3,0,36,33
1657245952462,MATH 103A,A02,083778,Greenfeld; Be'Eri,5,0,36,31
1657245952462,MATH 103A,A03,093561,Greenfeld; Be'Eri,4,0,36,32
1657245952462,MATH 103A,B01,083779,Greenfeld; Be'Eri,6,0,36,30
1657245952462,MATH 103A,B02,083780,Greenfeld; Be'Eri,3,0,36,33
1657245952462,MATH 103A,B03,093562,Greenfeld; Be'Eri,3,0,36,33
1657245958493,MATH 105,A01,085443,Carter; Anne Toulson,15,0,35,20
1657245958493,MATH 105,A02,093477,Carter; Anne Toulson,20,0,35,15
1657245964522,MATH 109,A01,083213,Ganzberger; Geoffrey Michael,2,0,34,32
1657245964522,MATH 109,A02,083214,Ganzberger; Geoffrey Michael,4,0,34,30
1657245964522,MATH 109,A03,093478,Ganzberger; Geoffrey Michael,2,0,34,32
1657245964522,MATH 109,B01,083215,Ganzberger; Geoffrey Michael,1,0,32,31
1657245964522,MATH 109,B02,083216,Ganzberger; Geoffrey Michael,1,0,32,31
1657245964522,MATH 109,B03,093479,Ganzberger; Geoffrey Michael,8,0,32,24
1657245970545,MATH 142A,A01,083219,Chow; Bennett,6,0,32,26
1657245970545,MATH 142A,A02,083220,Chow; Bennett,10,0,32,22
1657245970545,MATH 142A,A03,093480,Chow; Bennett,7,0,32,25
1657245970545,MATH 142A,B03,093481,Chow; Bennett,8,0,32,24
1657245970545,MATH 142A,B04,093558,Chow; Bennett,12,0,32,20
1657245970545,MATH 142A,B05,093559,Chow; Bennett,6,0,32,26
1657245976568,MATH 193A,A01,083224,Rotar; Vladimir,7,0,34,27
1657245976568,MATH 193A,A02,083225,Rotar; Vladimir,6,0,34,28
1657245976568,MATH 193A,A03,083781,Rotar; Vladimir,2,0,34,32
1657245976568,MATH 193A,A04,083782,Rotar; Vladimir,8,0,34,26
1657245976568,MATH 193A,A05,093482,Rotar; Vladimir,6,0,34,28
1657245982601,MATH 197,001,091859,McAuley; Julian John,9999,0,9999,0
1657245982601,MATH 197,002,095566,Kedlaya; Kiran S.,9997,0,9999,2
1657245982601,MATH 197,003,095567,Xiao; Ming,9999,0,9999,0
1657245982601,MATH 197,004,095571,Perols; Johan Lars,9998,0,9999,1
1657245989655,COGS 9,A01,083615,Shannon; Kyle Michael,8,0,75,67
1657245995689,COGS 11,A01,083617,Boyle; Mary E. T.,22,0,48,26
1657246001712,COGS 13,A01,083071,Bastos; Amalia Pinkusfeld,8,0,71,63
1657246007739,COGS 14A,A01,092681,Semenuks; Arturs,2,1,100,98
1657246013763,COGS 14B,A01,083073,Cheng; Tzu-Han,6,0,63,57
1657246019790,COGS 17,A01,092677,Semenuks; Arturs,5,0,81,76
1657246025812,COGS 100,A01,083619,Allen; Michael Gordon,16,0,70,54
1657246031837,COGS 101A,A01,083621,Davis; Joshua Daniel,9,0,68,59
1657246037858,COGS 101B,A01,091572,Allen; Michael Gordon,11,0,65,54
1657246043883,COGS 101C,A01,083625,Delgado; Tania,17,0,35,18
1657246049910,COGS 107A,A01,083627,Boyle; Mary E. T.,13,0,60,47
1657246055935,COGS 118A,A01,083075,Gupta; Anjum,16,0,76,60
1657246061958,CSE 3,A50,083646,Miranda; Gregory Joseph,24,0,50,26
1657246067986,CSE 8A,A50,083650,Miranda; Gregory Joseph,17,1,56,39
1657246074012,CSE 11,A01,083080,Cao; Yingjun,5,15,40,35
1657246080040,CSE 12,A01,083652,Krause-Levy; Sophia Louisa,26,1,120,94
1657246086066,CSE 15L,A01,083654,Morris; Justin Loren,9,0,50,41
1657246086066,CSE 15L,A02,083655,Morris; Justin Loren,9,0,50,41
1657246092094,CSE 20,A01,083657,Tran; Khoa Dang,38,0,80,42
1657246098118,CSE 21,A01,095574,Bach; Quang Tran,22,0,48,26
1657246104160,CSE 30,A01,083084,Eldon; John,4,0,80,76
1657246104160,CSE 30,B01,095061,Bhaskar; Nishant,8,0,50,42
1657246110182,CSE 100,A01,083659,Cao; Yingjun,4,4,70,66
1657246116207,CSE 134B,A01,083661,Powell; Thomas Allan,21,0,100,79
1657246122233,CSE 140,A01,083663,Gungor; Onat,13,0,85,72
1657246128264,CSE 140L,A01,083088,Eldon; John,18,0,100,82
1657246134285,CSE 175,A01,083665,Kumar; Rakesh,3,0,25,22
1657246140308,CSE 190,A00,092507,Dubnov; Shlomo,7,0,20,13
1657246146337,ECE 45,A01,083139,Congero; Spencer William,5,0,75,70
1657246152367,ECE 65,A50,083695,Saad; Andrew S,12,0,30,18
1657246152367,ECE 65,A51,095125,Saad; Andrew S,25,0,26,1
1657246158391,ECE 109,A01,091882,Touri; Behrouz,19,0,70,51
1657246164414,ECE 180,A00,083140,Abi Samra; Nicholas Camill,1,0,30,29
1657246164414,ECE 180,B00,083141,Abi Samra; Nicholas Camill,0,0,30,30
1657246170529,MATH 10A,A01,083735,Patchell; Gregory David,2,0,30,28
1657246170529,MATH 10A,A02,083736,Patchell; Gregory David,20,0,30,10
1657246170529,MATH 10A,A03,083737,Patchell; Gregory David,16,0,30,14
1657246176554,MATH 10B,A01,083207,Lim; Seonhee,7,0,34,27
1657246176554,MATH 10B,A02,083208,Lim; Seonhee,9,0,35,26
1657246176554,MATH 10B,A03,093472,Lim; Seonhee,5,0,34,29
1657246176554,MATH 10B,B01,083739,Sinha; Shubham,11,0,30,19
1657246182581,MATH 18,A01,083743,Cinel; Cameron Alexander,6,0,30,24
1657246182581,MATH 18,A02,083744,Cinel; Cameron Alexander,17,0,30,13
1657246182581,MATH 18,A03,083745,Cinel; Cameron Alexander,8,0,30,22
1657246182581,MATH 18,B01,083748,Rideout; David Porter,4,0,37,33
1657246182581,MATH 18,B02,083749,Rideout; David Porter,4,0,36,32
1657246182581,MATH 18,B03,083750,Rideout; David Porter,2,0,37,35
1657246182581,MATH 18,B04,083751,Rideout; David Porter,6,0,36,30
1657246182581,MATH 18,B05,093473,Rideout; David Porter,5,0,36,31
1657246182581,MATH 18,B06,093474,Rideout; David Porter,5,0,36,31
1657246188608,MATH 20A,A01,083754,Zheng; Zequn,14,0,40,26
1657246194634,MATH 20B,A01,083756,Briones; Jor-el Thomas Caparas,3,0,36,33
1657246194634,MATH 20B,A02,083757,Briones; Jor-el Thomas Caparas,1,0,36,35
1657246194634,MATH 20B,A03,093475,Briones; Jor-el Thomas Caparas,2,0,36,34
1657246200665,MATH 20C,A01,083760,Briones; Jor-el Thomas Caparas,1,0,35,34
1657246200665,MATH 20C,A02,083761,Briones; Jor-el Thomas Caparas,8,0,35,27
1657246200665,MATH 20C,A03,093476,Briones; Jor-el Thomas Caparas,0,1,36,36
1657246200665,MATH 20C,B01,083762,Bach; Quang Tran,1,0,30,29
1657246206692,MATH 20D,A01,083765,Tran; Brian Kha,4,0,30,26
1657246206692,MATH 20D,A02,083766,Tran; Brian Kha,5,0,30,25
1657246206692,MATH 20D,A03,083767,Tran; Brian Kha,4,0,30,26
1657246212715,MATH 20E,A01,083771,Ganguly; Soumya,7,0,32,25
1657246212715,MATH 20E,A02,083772,Ganguly; Soumya,7,0,32,25
1657246212715,MATH 20E,B01,083773,Ciotti; Benjamin,19,0,35,16
1657246212715,MATH 20E,B02,083774,Ciotti; Benjamin,17,0,35,18
1657246218744,MATH 103A,A01,083777,Greenfeld; Be'Eri,3,0,36,33
1657246218744,MATH 103A,A02,083778,Greenfeld; Be'Eri,5,0,36,31
1657246218744,MATH 103A,A03,093561,Greenfeld; Be'Eri,4,0,36,32
1657246218744,MATH 103A,B01,083779,Greenfeld; Be'Eri,6,0,36,30
1657246218744,MATH 103A,B02,083780,Greenfeld; Be'Eri,3,0,36,33
1657246218744,MATH 103A,B03,093562,Greenfeld; Be'Eri,3,0,36,33
1657246224769,MATH 105,A01,085443,Carter; Anne Toulson,15,0,35,20
1657246224769,MATH 105,A02,093477,Carter; Anne Toulson,20,0,35,15
1657246230791,MATH 109,A01,083213,Ganzberger; Geoffrey Michael,2,0,34,32
1657246230791,MATH 109,A02,083214,Ganzberger; Geoffrey Michael,4,0,34,30
1657246230791,MATH 109,A03,093478,Ganzberger; Geoffrey Michael,2,0,34,32
1657246230791,MATH 109,B01,083215,Ganzberger; Geoffrey Michael,1,0,32,31
1657246230791,MATH 109,B02,083216,Ganzberger; Geoffrey Michael,1,0,32,31
1657246230791,MATH 109,B03,093479,Ganzberger; Geoffrey Michael,8,0,32,24
1657246236817,MATH 142A,A01,083219,Chow; Bennett,6,0,32,26
1657246236817,MATH 142A,A02,083220,Chow; Bennett,10,0,32,22
1657246236817,MATH 142A,A03,093480,Chow; Bennett,7,0,32,25
1657246236817,MATH 142A,B03,093481,Chow; Bennett,8,0,32,24
1657246236817,MATH 142A,B04,093558,Chow; Bennett,12,0,32,20
1657246236817,MATH 142A,B05,093559,Chow; Bennett,6,0,32,26
1657246242844,MATH 193A,A01,083224,Rotar; Vladimir,7,0,34,27
1657246242844,MATH 193A,A02,083225,Rotar; Vladimir,6,0,34,28
1657246242844,MATH 193A,A03,083781,Rotar; Vladimir,2,0,34,32
1657246242844,MATH 193A,A04,083782,Rotar; Vladimir,8,0,34,26
1657246242844,MATH 193A,A05,093482,Rotar; Vladimir,6,0,34,28
1657246248866,MATH 197,001,091859,McAuley; Julian John,9999,0,9999,0
1657246248866,MATH 197,002,095566,Kedlaya; Kiran S.,9997,0,9999,2
1657246248866,MATH 197,003,095567,Xiao; Ming,9999,0,9999,0
1657246248866,MATH 197,004,095571,Perols; Johan Lars,9998,0,9999,1
1657246255918,COGS 9,A01,083615,Shannon; Kyle Michael,8,0,75,67
1657246261941,COGS 11,A01,083617,Boyle; Mary E. T.,22,0,48,26
1657246267965,COGS 13,A01,083071,Bastos; Amalia Pinkusfeld,8,0,71,63
1657246273986,COGS 14A,A01,092681,Semenuks; Arturs,2,1,100,98
1657246280009,COGS 14B,A01,083073,Cheng; Tzu-Han,6,0,63,57
1657246286035,COGS 17,A01,092677,Semenuks; Arturs,5,0,81,76
1657246292058,COGS 100,A01,083619,Allen; Michael Gordon,16,0,70,54
1657246298081,COGS 101A,A01,083621,Davis; Joshua Daniel,9,0,68,59
1657246304102,COGS 101B,A01,091572,Allen; Michael Gordon,11,0,65,54
1657246310129,COGS 101C,A01,083625,Delgado; Tania,17,0,35,18
1657246316154,COGS 107A,A01,083627,Boyle; Mary E. T.,13,0,60,47
1657246322180,COGS 118A,A01,083075,Gupta; Anjum,16,0,76,60
1657246328210,CSE 3,A50,083646,Miranda; Gregory Joseph,24,0,50,26
1657246334233,CSE 8A,A50,083650,Miranda; Gregory Joseph,17,1,56,39
1657246340255,CSE 11,A01,083080,Cao; Yingjun,5,15,40,35
1657246346279,CSE 12,A01,083652,Krause-Levy; Sophia Louisa,26,1,120,94
1657246352308,CSE 15L,A01,083654,Morris; Justin Loren,9,0,50,41
1657246352308,CSE 15L,A02,083655,Morris; Justin Loren,9,0,50,41
1657246358334,CSE 20,A01,083657,Tran; Khoa Dang,38,0,80,42
1657246364358,CSE 21,A01,095574,Bach; Quang Tran,22,0,48,26
1657246370383,CSE 30,A01,083084,Eldon; John,4,0,80,76
1657246370383,CSE 30,B01,095061,Bhaskar; Nishant,8,0,50,42
1657246376406,CSE 100,A01,083659,Cao; Yingjun,4,4,70,66
1657246382432,CSE 134B,A01,083661,Powell; Thomas Allan,21,0,100,79
1657246388459,CSE 140,A01,083663,Gungor; Onat,13,0,85,72
1657246394481,CSE 140L,A01,083088,Eldon; John,18,0,100,82
1657246400506,CSE 175,A01,083665,Kumar; Rakesh,3,0,25,22
1657246406532,CSE 190,A00,092507,Dubnov; Shlomo,7,0,20,13
1657246412556,ECE 45,A01,083139,Congero; Spencer William,5,0,75,70
1657246418578,ECE 65,A50,083695,Saad; Andrew S,12,0,30,18
1657246418578,ECE 65,A51,095125,Saad; Andrew S,25,0,26,1
1657246424601,ECE 109,A01,091882,Touri; Behrouz,19,0,70,51
1657246430624,ECE 180,A00,083140,Abi Samra; Nicholas Camill,1,0,30,29
1657246430624,ECE 180,B00,083141,Abi Samra; Nicholas Camill,0,0,30,30
1657246436647,MATH 10A,A01,083735,Patchell; Gregory David,2,0,30,28
1657246436647,MATH 10A,A02,083736,Patchell; Gregory David,20,0,30,10
1657246436647,MATH 10A,A03,083737,Patchell; Gregory David,16,0,30,14
1657246442671,MATH 10B,A01,083207,Lim; Seonhee,7,0,34,27
1657246442671,MATH 10B,A02,083208,Lim; Seonhee,9,0,35,26
1657246442671,MATH 10B,A03,093472,Lim; Seonhee,5,0,34,29
1657246442671,MATH 10B,B01,083739,Sinha; Shubham,11,0,30,19
1657246448697,MATH 18,A01,083743,Cinel; Cameron Alexander,6,0,30,24
1657246448697,MATH 18,A02,083744,Cinel; Cameron Alexander,17,0,30,13
1657246448697,MATH 18,A03,083745,Cinel; Cameron Alexander,8,0,30,22
1657246448697,MATH 18,B01,083748,Rideout; David Porter,4,0,37,33
1657246448697,MATH 18,B02,083749,Rideout; David Porter,4,0,36,32
1657246448697,MATH 18,B03,083750,Rideout; David Porter,2,0,37,35
1657246448697,MATH 18,B04,083751,Rideout; David Porter,6,0,36,30
1657246448697,MATH 18,B05,093473,Rideout; David Porter,5,0,36,31
1657246448697,MATH 18,B06,093474,Rideout; David Porter,5,0,36,31
1657246454721,MATH 20A,A01,083754,Zheng; Zequn,14,0,40,26
1657246460747,MATH 20B,A01,083756,Briones; Jor-el Thomas Caparas,3,0,36,33
1657246460747,MATH 20B,A02,083757,Briones; Jor-el Thomas Caparas,1,0,36,35
1657246460747,MATH 20B,A03,093475,Briones; Jor-el Thomas Caparas,2,0,36,34
1657246466770,MATH 20C,A01,083760,Briones; Jor-el Thomas Caparas,1,0,35,34
1657246466770,MATH 20C,A02,083761,Briones; Jor-el Thomas Caparas,8,0,35,27
1657246466770,MATH 20C,A03,093476,Briones; Jor-el Thomas Caparas,0,1,36,36
1657246466770,MATH 20C,B01,083762,Bach; Quang Tran,1,0,30,29
1657246472793,MATH 20D,A01,083765,Tran; Brian Kha,4,0,30,26
1657246472793,MATH 20D,A02,083766,Tran; Brian Kha,5,0,30,25
1657246472793,MATH 20D,A03,083767,Tran; Brian Kha,4,0,30,26
1657246478817,MATH 20E,A01,083771,Ganguly; Soumya,7,0,32,25
1657246478817,MATH 20E,A02,083772,Ganguly; Soumya,7,0,32,25
1657246478817,MATH 20E,B01,083773,Ciotti; Benjamin,19,0,35,16
1657246478817,MATH 20E,B02,083774,Ciotti; Benjamin,17,0,35,18
1657246484839,MATH 103A,A01,083777,Greenfeld; Be'Eri,3,0,36,33
1657246484839,MATH 103A,A02,083778,Greenfeld; Be'Eri,5,0,36,31
1657246484839,MATH 103A,A03,093561,Greenfeld; Be'Eri,4,0,36,32
1657246484839,MATH 103A,B01,083779,Greenfeld; Be'Eri,6,0,36,30
1657246484839,MATH 103A,B02,083780,Greenfeld; Be'Eri,3,0,36,33
1657246484839,MATH 103A,B03,093562,Greenfeld; Be'Eri,3,0,36,33
1657246490862,MATH 105,A01,085443,Carter; Anne Toulson,15,0,35,20
1657246490862,MATH 105,A02,093477,Carter; Anne Toulson,20,0,35,15
1657246496885,MATH 109,A01,083213,Ganzberger; Geoffrey Michael,2,0,34,32
1657246496885,MATH 109,A02,083214,Ganzberger; Geoffrey Michael,4,0,34,30
1657246496885,MATH 109,A03,093478,Ganzberger; Geoffrey Michael,2,0,34,32
1657246496885,MATH 109,B01,083215,Ganzberger; Geoffrey Michael,1,0,32,31
1657246496885,MATH 109,B02,083216,Ganzberger; Geoffrey Michael,1,0,32,31
1657246496885,MATH 109,B03,093479,Ganzberger; Geoffrey Michael,8,0,32,24
1657246502909,MATH 142A,A01,083219,Chow; Bennett,6,0,32,26
1657246502909,MATH 142A,A02,083220,Chow; Bennett,10,0,32,22
1657246502909,MATH 142A,A03,093480,Chow; Bennett,7,0,32,25
1657246502909,MATH 142A,B03,093481,Chow; Bennett,8,0,32,24
1657246502909,MATH 142A,B04,093558,Chow; Bennett,12,0,32,20
1657246502909,MATH 142A,B05,093559,Chow; Bennett,6,0,32,26
1657246508958,MATH 193A,A01,083224,Rotar; Vladimir,7,0,34,27
1657246508958,MATH 193A,A02,083225,Rotar; Vladimir,6,0,34,28
1657246508958,MATH 193A,A03,083781,Rotar; Vladimir,2,0,34,32
1657246508958,MATH 193A,A04,083782,Rotar; Vladimir,8,0,34,26
1657246508958,MATH 193A,A05,093482,Rotar; Vladimir,6,0,34,28
1657246514980,MATH 197,001,091859,McAuley; Julian John,9999,0,9999,0
1657246514980,MATH 197,002,095566,Kedlaya; Kiran S.,9997,0,9999,2
1657246514980,MATH 197,003,095567,Xiao; Ming,9999,0,9999,0
1657246514980,MATH 197,004,095571,Perols; Johan Lars,9998,0,9999,1
1657246522033,COGS 9,A01,083615,Shannon; Kyle Michael,8,0,75,67
1657246528059,COGS 11,A01,083617,Boyle; Mary E. T.,22,0,48,26
1657246534082,COGS 13,A01,083071,Bastos; Amalia Pinkusfeld,8,0,71,63
1657246540108,COGS 14A,A01,092681,Semenuks; Arturs,2,1,100,98
1657246546135,COGS 14B,A01,083073,Cheng; Tzu-Han,6,0,63,57
1657246552157,COGS 17,A01,092677,Semenuks; Arturs,5,0,81,76
1657246558185,COGS 100,A01,083619,Allen; Michael Gordon,16,0,70,54
1657246564211,COGS 101A,A01,083621,Davis; Joshua Daniel,9,0,68,59
1657246570236,COGS 101B,A01,091572,Allen; Michael Gordon,11,0,65,54
1657246576259,COGS 101C,A01,083625,Delgado; Tania,17,0,35,18
1657246582284,COGS 107A,A01,083627,Boyle; Mary E. T.,13,0,60,47
1657246588311,COGS 118A,A01,083075,Gupta; Anjum,16,0,76,60
1657246594339,CSE 3,A50,083646,Miranda; Gregory Joseph,24,0,50,26
1657246600364,CSE 8A,A50,083650,Miranda; Gregory Joseph,17,1,56,39
1657246606390,CSE 11,A01,083080,Cao; Yingjun,5,15,40,35
1657246612416,CSE 12,A01,083652,Krause-Levy; Sophia Louisa,26,1,120,94
1657246618443,CSE 15L,A01,083654,Morris; Justin Loren,9,0,50,41
1657246618443,CSE 15L,A02,083655,Morris; Justin Loren,9,0,50,41
1657246624474,CSE 20,A01,083657,Tran; Khoa Dang,38,0,80,42
1657246630500,CSE 21,A01,095574,Bach; Quang Tran,22,0,48,26
1657246636528,CSE 30,A01,083084,Eldon; John,4,0,80,76
1657246636528,CSE 30,B01,095061,Bhaskar; Nishant,8,0,50,42
1657246642556,CSE 100,A01,083659,Cao; Yingjun,4,4,70,66
1657246648582,CSE 134B,A01,083661,Powell; Thomas Allan,21,0,100,79
1657246654619,CSE 140,A01,083663,Gungor; Onat,13,0,85,72
1657246660655,CSE 140L,A01,083088,Eldon; John,18,0,100,82
1657246666677,CSE 175,A01,083665,Kumar; Rakesh,3,0,25,22
1657246672701,CSE 190,A00,092507,Dubnov; Shlomo,7,0,20,13
1657246678722,ECE 45,A01,083139,Congero; Spencer William,5,0,75,70
1657246684745,ECE 65,A50,083695,Saad; Andrew S,12,0,30,18
1657246684745,ECE 65,A51,095125,Saad; Andrew S,25,0,26,1
1657246690767,ECE 109,A01,091882,Touri; Behrouz,19,0,70,51
1657246696790,ECE 180,A00,083140,Abi Samra; Nicholas Camill,1,0,30,29
1657246696790,ECE 180,B00,083141,Abi Samra; Nicholas Camill,0,0,30,30
1657246702824,MATH 10A,A01,083735,Patchell; Gregory David,2,0,30,28
1657246702824,MATH 10A,A02,083736,Patchell; Gregory David,20,0,30,10
1657246702824,MATH 10A,A03,083737,Patchell; Gregory David,16,0,30,14
1657246708854,MATH 10B,A01,083207,Lim; Seonhee,7,0,34,27
1657246708854,MATH 10B,A02,083208,Lim; Seonhee,9,0,35,26
1657246708854,MATH 10B,A03,093472,Lim; Seonhee,5,0,34,29
1657246708854,MATH 10B,B01,083739,Sinha; Shubham,11,0,30,19
1657246714885,MATH 18,A01,083743,Cinel; Cameron Alexander,6,0,30,24
1657246714885,MATH 18,A02,083744,Cinel; Cameron Alexander,17,0,30,13
1657246714885,MATH 18,A03,083745,Cinel; Cameron Alexander,8,0,30,22
1657246714885,MATH 18,B01,083748,Rideout; David Porter,4,0,37,33
1657246714885,MATH 18,B02,083749,Rideout; David Porter,4,0,36,32
1657246714885,MATH 18,B03,083750,Rideout; David Porter,2,0,37,35
1657246714885,MATH 18,B04,083751,Rideout; David Porter,6,0,36,30
1657246714885,MATH 18,B05,093473,Rideout; David Porter,5,0,36,31
1657246714885,MATH 18,B06,093474,Rideout; David Porter,5,0,36,31
1657246720909,MATH 20A,A01,083754,Zheng; Zequn,14,0,40,26
1657246726935,MATH 20B,A01,083756,Briones; Jor-el Thomas Caparas,3,0,36,33
1657246726935,MATH 20B,A02,083757,Briones; Jor-el Thomas Caparas,1,0,36,35
1657246726935,MATH 20B,A03,093475,Briones; Jor-el Thomas Caparas,2,0,36,34
1657246732958,MATH 20C,A01,083760,Briones; Jor-el Thomas Caparas,1,0,35,34
1657246732958,MATH 20C,A02,083761,Briones; Jor-el Thomas Caparas,8,0,35,27
1657246732958,MATH 20C,A03,093476,Briones; Jor-el Thomas Caparas,0,1,36,36
1657246732958,MATH 20C,B01,083762,Bach; Quang Tran,1,0,30,29
1657246738981,MATH 20D,A01,083765,Tran; Brian Kha,4,0,30,26
1657246738981,MATH 20D,A02,083766,Tran; Brian Kha,5,0,30,25
1657246738981,MATH 20D,A03,083767,Tran; Brian Kha,4,0,30,26
1657246745009,MATH 20E,A01,083771,Ganguly; Soumya,7,0,32,25
1657246745009,MATH 20E,A02,083772,Ganguly; Soumya,7,0,32,25
1657246745009,MATH 20E,B01,083773,Ciotti; Benjamin,19,0,35,16
1657246745009,MATH 20E,B02,083774,Ciotti; Benjamin,17,0,35,18
1657246751045,MATH 103A,A01,083777,Greenfeld; Be'Eri,3,0,36,33
1657246751045,MATH 103A,A02,083778,Greenfeld; Be'Eri,5,0,36,31
1657246751045,MATH 103A,A03,093561,Greenfeld; Be'Eri,4,0,36,32
1657246751045,MATH 103A,B01,083779,Greenfeld; Be'Eri,6,0,36,30
1657246751045,MATH 103A,B02,083780,Greenfeld; Be'Eri,3,0,36,33
1657246751045,MATH 103A,B03,093562,Greenfeld; Be'Eri,3,0,36,33
1657246757073,MATH 105,A01,085443,Carter; Anne Toulson,15,0,35,20
1657246757073,MATH 105,A02,093477,Carter; Anne Toulson,20,0,35,15
1657246766871,MATH 109,A01,083213,Ganzberger; Geoffrey Michael,2,0,34,32
1657246766871,MATH 109,A02,083214,Ganzberger; Geoffrey Michael,4,0,34,30
1657246766871,MATH 109,A03,093478,Ganzberger; Geoffrey Michael,2,0,34,32
1657246766871,MATH 109,B01,083215,Ganzberger; Geoffrey Michael,1,0,32,31
1657246766871,MATH 109,B02,083216,Ganzberger; Geoffrey Michael,1,0,32,31
1657246766871,MATH 109,B03,093479,Ganzberger; Geoffrey Michael,8,0,32,24
1657246772969,MATH 142A,A01,083219,Chow; Bennett,6,0,32,26
1657246772969,MATH 142A,A02,083220,Chow; Bennett,10,0,32,22
1657246772969,MATH 142A,A03,093480,Chow; Bennett,7,0,32,25
1657246772969,MATH 142A,B03,093481,Chow; Bennett,8,0,32,24
1657246772969,MATH 142A,B04,093558,Chow; Bennett,12,0,32,20
1657246772969,MATH 142A,B05,093559,Chow; Bennett,6,0,32,26
1657246778996,MATH 193A,A01,083224,Rotar; Vladimir,7,0,34,27
1657246778996,MATH 193A,A02,083225,Rotar; Vladimir,6,0,34,28
1657246778996,MATH 193A,A03,083781,Rotar; Vladimir,2,0,34,32
1657246778996,MATH 193A,A04,083782,Rotar; Vladimir,8,0,34,26
1657246778996,MATH 193A,A05,093482,Rotar; Vladimir,6,0,34,28
1657246785020,MATH 197,001,091859,McAuley; Julian John,9999,0,9999,0
1657246785020,MATH 197,002,095566,Kedlaya; Kiran S.,9997,0,9999,2
1657246785020,MATH 197,003,095567,Xiao; Ming,9999,0,9999,0
1657246785020,MATH 197,004,095571,Perols; Johan Lars,9998,0,9999,1
1657246792082,COGS 9,A01,083615,Shannon; Kyle Michael,8,0,75,67
1657246798107,COGS 11,A01,083617,Boyle; Mary E. T.,22,0,48,26
1657246804134,COGS 13,A01,083071,Bastos; Amalia Pinkusfeld,8,0,71,63
1657246810178,COGS 14A,A01,092681,Semenuks; Arturs,2,1,100,98
1657246816201,COGS 14B,A01,083073,Cheng; Tzu-Han,6,0,63,57
1657246822229,COGS 17,A01,092677,Semenuks; Arturs,5,0,81,76
1657246828251,COGS 100,A01,083619,Allen; Michael Gordon,16,0,70,54
1657246834273,COGS 101A,A01,083621,Davis; Joshua Daniel,9,0,68,59
1657246840296,COGS 101B,A01,091572,Allen; Michael Gordon,11,0,65,54
1657246846318,COGS 101C,A01,083625,Delgado; Tania,17,0,35,18
1657246852340,COGS 107A,A01,083627,Boyle; Mary E. T.,13,0,60,47
1657246858366,COGS 118A,A01,083075,Gupta; Anjum,16,0,76,60
1657246864398,CSE 3,A50,083646,Miranda; Gregory Joseph,24,0,50,26
1657246870420,CSE 8A,A50,083650,Miranda; Gregory Joseph,17,1,56,39
1657246876447,CSE 11,A01,083080,Cao; Yingjun,5,15,40,35
1657246882472,CSE 12,A01,083652,Krause-Levy; Sophia Louisa,26,1,120,94
1657246888496,CSE 15L,A01,083654,Morris; Justin Loren,9,0,50,41
1657246888496,CSE 15L,A02,083655,Morris; Justin Loren,9,0,50,41
1657246894522,CSE 20,A01,083657,Tran; Khoa Dang,38,0,80,42
1657246900558,CSE 21,A01,095574,Bach; Quang Tran,22,0,48,26
1657246906591,CSE 30,A01,083084,Eldon; John,4,0,80,76
1657246906591,CSE 30,B01,095061,Bhaskar; Nishant,8,0,50,42
1657246912626,CSE 100,A01,083659,Cao; Yingjun,4,4,70,66
1657246918652,CSE 134B,A01,083661,Powell; Thomas Allan,21,0,100,79
1657246924676,CSE 140,A01,083663,Gungor; Onat,13,0,85,72
1657246930700,CSE 140L,A01,083088,Eldon; John,18,0,100,82
1657246936746,CSE 175,A01,083665,Kumar; Rakesh,3,0,25,22
1657246942774,CSE 190,A00,092507,Dubnov; Shlomo,7,0,20,13
1657246948809,ECE 45,A01,083139,Congero; Spencer William,5,0,75,70
1657246954834,ECE 65,A50,083695,Saad; Andrew S,12,0,30,18
1657246954834,ECE 65,A51,095125,Saad; Andrew S,25,0,26,1
1657246960863,ECE 109,A01,091882,Touri; Behrouz,19,0,70,51
1657246966886,ECE 180,A00,083140,Abi Samra; Nicholas Camill,1,0,30,29
1657246966886,ECE 180,B00,083141,Abi Samra; Nicholas Camill,0,0,30,30
1657246972912,MATH 10A,A01,083735,Patchell; Gregory David,2,0,30,28
1657246972912,MATH 10A,A02,083736,Patchell; Gregory David,20,0,30,10
1657246972912,MATH 10A,A03,083737,Patchell; Gregory David,16,0,30,14
1657246978946,MATH 10B,A01,083207,Lim; Seonhee,7,0,34,27
1657246978946,MATH 10B,A02,083208,Lim; Seonhee,9,0,35,26
1657246978946,MATH 10B,A03,093472,Lim; Seonhee,5,0,34,29
1657246978946,MATH 10B,B01,083739,Sinha; Shubham,11,0,30,19
1657246984971,MATH 18,A01,083743,Cinel; Cameron Alexander,6,0,30,24
1657246984971,MATH 18,A02,083744,Cinel; Cameron Alexander,17,0,30,13
1657246984971,MATH 18,A03,083745,Cinel; Cameron Alexander,8,0,30,22
1657246984971,MATH 18,B01,083748,Rideout; David Porter,4,0,37,33
1657246984971,MATH 18,B02,083749,Rideout; David Porter,4,0,36,32
1657246984971,MATH 18,B03,083750,Rideout; David Porter,2,0,37,35
1657246984971,MATH 18,B04,083751,Rideout; David Porter,6,0,36,30
1657246984971,MATH 18,B05,093473,Rideout; David Porter,5,0,36,31
1657246984971,MATH 18,B06,093474,Rideout; David Porter,5,0,36,31
1657246990996,MATH 20A,A01,083754,Zheng; Zequn,14,0,40,26
1657246997020,MATH 20B,A01,083756,Briones; Jor-el Thomas Caparas,3,0,36,33
1657246997020,MATH 20B,A02,083757,Briones; Jor-el Thomas Caparas,1,0,36,35
1657246997020,MATH 20B,A03,093475,Briones; Jor-el Thomas Caparas,2,0,36,34
1657247003043,MATH 20C,A01,083760,Briones; Jor-el Thomas Caparas,1,0,35,34
1657247003043,MATH 20C,A02,083761,Briones; Jor-el Thomas Caparas,8,0,35,27
1657247003043,MATH 20C,A03,093476,Briones; Jor-el Thomas Caparas,0,1,36,36
1657247003043,MATH 20C,B01,083762,Bach; Quang Tran,1,0,30,29
1657247009072,MATH 20D,A01,083765,Tran; Brian Kha,4,0,30,26
1657247009072,MATH 20D,A02,083766,Tran; Brian Kha,5,0,30,25
1657247009072,MATH 20D,A03,083767,Tran; Brian Kha,4,0,30,26
1657247015098,MATH 20E,A01,083771,Ganguly; Soumya,7,0,32,25
1657247015098,MATH 20E,A02,083772,Ganguly; Soumya,7,0,32,25
1657247015098,MATH 20E,B01,083773,Ciotti; Benjamin,19,0,35,16
1657247015098,MATH 20E,B02,083774,Ciotti; Benjamin,17,0,35,18
1657247021122,MATH 103A,A01,083777,Greenfeld; Be'Eri,3,0,36,33
1657247021122,MATH 103A,A02,083778,Greenfeld; Be'Eri,5,0,36,31
1657247021122,MATH 103A,A03,093561,Greenfeld; Be'Eri,4,0,36,32
1657247021122,MATH 103A,B01,083779,Greenfeld; Be'Eri,6,0,36,30
1657247021122,MATH 103A,B02,083780,Greenfeld; Be'Eri,3,0,36,33
1657247021122,MATH 103A,B03,093562,Greenfeld; Be'Eri,3,0,36,33
1657247027152,MATH 105,A01,085443,Carter; Anne Toulson,15,0,35,20
1657247027152,MATH 105,A02,093477,Carter; Anne Toulson,20,0,35,15
1657247033180,MATH 109,A01,083213,Ganzberger; Geoffrey Michael,2,0,34,32
1657247033180,MATH 109,A02,083214,Ganzberger; Geoffrey Michael,4,0,34,30
1657247033180,MATH 109,A03,093478,Ganzberger; Geoffrey Michael,2,0,34,32
1657247033180,MATH 109,B01,083215,Ganzberger; Geoffrey Michael,1,0,32,31
1657247033180,MATH 109,B02,083216,Ganzberger; Geoffrey Michael,1,0,32,31
1657247033180,MATH 109,B03,093479,Ganzberger; Geoffrey Michael,8,0,32,24
1657247039213,MATH 142A,A01,083219,Chow; Bennett,6,0,32,26
1657247039213,MATH 142A,A02,083220,Chow; Bennett,10,0,32,22
1657247039213,MATH 142A,A03,093480,Chow; Bennett,7,0,32,25
1657247039213,MATH 142A,B03,093481,Chow; Bennett,8,0,32,24
1657247039213,MATH 142A,B04,093558,Chow; Bennett,12,0,32,20
1657247039213,MATH 142A,B05,093559,Chow; Bennett,6,0,32,26
1657247045242,MATH 193A,A01,083224,Rotar; Vladimir,7,0,34,27
1657247045242,MATH 193A,A02,083225,Rotar; Vladimir,6,0,34,28
1657247045242,MATH 193A,A03,083781,Rotar; Vladimir,2,0,34,32
1657247045242,MATH 193A,A04,083782,Rotar; Vladimir,8,0,34,26
1657247045242,MATH 193A,A05,093482,Rotar; Vladimir,6,0,34,28
1657247051267,MATH 197,001,091859,McAuley; Julian John,9999,0,9999,0
1657247051267,MATH 197,002,095566,Kedlaya; Kiran S.,9997,0,9999,2
1657247051267,MATH 197,003,095567,Xiao; Ming,9999,0,9999,0
1657247051267,MATH 197,004,095571,Perols; Johan Lars,9998,0,9999,1
1657247058328,COGS 9,A01,083615,Shannon; Kyle Michael,8,0,75,67
1657247064352,COGS 11,A01,083617,Boyle; Mary E. T.,22,0,48,26
1657247070382,COGS 13,A01,083071,Bastos; Amalia Pinkusfeld,8,0,71,63
1657247076420,COGS 14A,A01,092681,Semenuks; Arturs,2,1,100,98
1657247082443,COGS 14B,A01,083073,Cheng; Tzu-Han,6,0,63,57
1657247088467,COGS 17,A01,092677,Semenuks; Arturs,5,0,81,76
1657247094500,COGS 100,A01,083619,Allen; Michael Gordon,16,0,70,54
1657247100522,COGS 101A,A01,083621,Davis; Joshua Daniel,9,0,68,59
1657247106545,COGS 101B,A01,091572,Allen; Michael Gordon,11,0,65,54
1657247112568,COGS 101C,A01,083625,Delgado; Tania,17,0,35,18
1657247118606,COGS 107A,A01,083627,Boyle; Mary E. T.,13,0,60,47
1657247124632,COGS 118A,A01,083075,Gupta; Anjum,16,0,76,60
1657247130656,CSE 3,A50,083646,Miranda; Gregory Joseph,24,0,50,26
1657247136683,CSE 8A,A50,083650,Miranda; Gregory Joseph,17,1,56,39
1657247142707,CSE 11,A01,083080,Cao; Yingjun,5,15,40,35
1657247148739,CSE 12,A01,083652,Krause-Levy; Sophia Louisa,26,1,120,94
1657247154762,CSE 15L,A01,083654,Morris; Justin Loren,9,0,50,41
1657247154762,CSE 15L,A02,083655,Morris; Justin Loren,9,0,50,41
1657247160788,CSE 20,A01,083657,Tran; Khoa Dang,38,0,80,42
1657247166813,CSE 21,A01,095574,Bach; Quang Tran,22,0,48,26
1657247172847,CSE 30,A01,083084,Eldon; John,4,0,80,76
1657247172847,CSE 30,B01,095061,Bhaskar; Nishant,8,0,50,42
1657247178868,CSE 100,A01,083659,Cao; Yingjun,4,4,70,66
1657247184892,CSE 134B,A01,083661,Powell; Thomas Allan,21,0,100,79
1657247190919,CSE 140,A01,083663,Gungor; Onat,13,0,85,72
1657247196942,CSE 140L,A01,083088,Eldon; John,18,0,100,82
1657247202965,CSE 175,A01,083665,Kumar; Rakesh,3,0,25,22
1657247208986,CSE 190,A00,092507,Dubnov; Shlomo,7,0,20,13
1657247215007,ECE 45,A01,083139,Congero; Spencer William,5,0,75,70
1657247221029,ECE 65,A50,083695,Saad; Andrew S,12,0,30,18
1657247221029,ECE 65,A51,095125,Saad; Andrew S,25,0,26,1
1657247227057,ECE 109,A01,091882,Touri; Behrouz,19,0,70,51
1657247233084,ECE 180,A00,083140,Abi Samra; Nicholas Camill,1,0,30,29
1657247233084,ECE 180,B00,083141,Abi Samra; Nicholas Camill,0,0,30,30
1657247239136,MATH 10A,A01,083735,Patchell; Gregory David,2,0,30,28
1657247239136,MATH 10A,A02,083736,Patchell; Gregory David,20,0,30,10
1657247239136,MATH 10A,A03,083737,Patchell; Gregory David,16,0,30,14
1657247245166,MATH 10B,A01,083207,Lim; Seonhee,7,0,34,27
1657247245166,MATH 10B,A02,083208,Lim; Seonhee,9,0,35,26
1657247245166,MATH 10B,A03,093472,Lim; Seonhee,5,0,34,29
1657247245166,MATH 10B,B01,083739,Sinha; Shubham,11,0,30,19
1657247251196,MATH 18,A01,083743,Cinel; Cameron Alexander,6,0,30,24
1657247251196,MATH 18,A02,083744,Cinel; Cameron Alexander,17,0,30,13
1657247251196,MATH 18,A03,083745,Cinel; Cameron Alexander,8,0,30,22
1657247251196,MATH 18,B01,083748,Rideout; David Porter,4,0,37,33
1657247251196,MATH 18,B02,083749,Rideout; David Porter,4,0,36,32
1657247251196,MATH 18,B03,083750,Rideout; David Porter,2,0,37,35
1657247251196,MATH 18,B04,083751,Rideout; David Porter,6,0,36,30
1657247251196,MATH 18,B05,093473,Rideout; David Porter,5,0,36,31
1657247251196,MATH 18,B06,093474,Rideout; David Porter,5,0,36,31
1657247257219,MATH 20A,A01,083754,Zheng; Zequn,14,0,40,26
1657247263242,MATH 20B,A01,083756,Briones; Jor-el Thomas Caparas,3,0,36,33
1657247263242,MATH 20B,A02,083757,Briones; Jor-el Thomas Caparas,1,0,36,35
1657247263242,MATH 20B,A03,093475,Briones; Jor-el Thomas Caparas,2,0,36,34
1657247269264,MATH 20C,A01,083760,Briones; Jor-el Thomas Caparas,1,0,35,34
1657247269264,MATH 20C,A02,083761,Briones; Jor-el Thomas Caparas,8,0,35,27
1657247269264,MATH 20C,A03,093476,Briones; Jor-el Thomas Caparas,0,1,36,36
1657247269264,MATH 20C,B01,083762,Bach; Quang Tran,1,0,30,29
1657247275288,MATH 20D,A01,083765,Tran; Brian Kha,4,0,30,26
1657247275288,MATH 20D,A02,083766,Tran; Brian Kha,5,0,30,25
1657247275288,MATH 20D,A03,083767,Tran; Brian Kha,4,0,30,26
1657247281311,MATH 20E,A01,083771,Ganguly; Soumya,7,0,32,25
1657247281311,MATH 20E,A02,083772,Ganguly; Soumya,7,0,32,25
1657247281311,MATH 20E,B01,083773,Ciotti; Benjamin,19,0,35,16
1657247281311,MATH 20E,B02,083774,Ciotti; Benjamin,17,0,35,18
1657247287335,MATH 103A,A01,083777,Greenfeld; Be'Eri,3,0,36,33
1657247287335,MATH 103A,A02,083778,Greenfeld; Be'Eri,5,0,36,31
1657247287335,MATH 103A,A03,093561,Greenfeld; Be'Eri,4,0,36,32
1657247287335,MATH 103A,B01,083779,Greenfeld; Be'Eri,6,0,36,30
1657247287335,MATH 103A,B02,083780,Greenfeld; Be'Eri,3,0,36,33
1657247287335,MATH 103A,B03,093562,Greenfeld; Be'Eri,3,0,36,33
1657247293361,MATH 105,A01,085443,Carter; Anne Toulson,15,0,35,20
1657247293361,MATH 105,A02,093477,Carter; Anne Toulson,20,0,35,15
1657247299393,MATH 109,A01,083213,Ganzberger; Geoffrey Michael,2,0,34,32
1657247299393,MATH 109,A02,083214,Ganzberger; Geoffrey Michael,4,0,34,30
1657247299393,MATH 109,A03,093478,Ganzberger; Geoffrey Michael,2,0,34,32
1657247299393,MATH 109,B01,083215,Ganzberger; Geoffrey Michael,1,0,32,31
1657247299393,MATH 109,B02,083216,Ganzberger; Geoffrey Michael,1,0,32,31
1657247299393,MATH 109,B03,093479,Ganzberger; Geoffrey Michael,8,0,32,24
1657247305430,MATH 142A,A01,083219,Chow; Bennett,6,0,32,26
1657247305430,MATH 142A,A02,083220,Chow; Bennett,10,0,32,22
1657247305430,MATH 142A,A03,093480,Chow; Bennett,7,0,32,25
1657247305430,MATH 142A,B03,093481,Chow; Bennett,8,0,32,24
1657247305430,MATH 142A,B04,093558,Chow; Bennett,12,0,32,20
1657247305430,MATH 142A,B05,093559,Chow; Bennett,6,0,32,26
1657247311452,MATH 193A,A01,083224,Rotar; Vladimir,7,0,34,27
1657247311452,MATH 193A,A02,083225,Rotar; Vladimir,6,0,34,28
1657247311452,MATH 193A,A03,083781,Rotar; Vladimir,2,0,34,32
1657247311452,MATH 193A,A04,083782,Rotar; Vladimir,8,0,34,26
1657247311452,MATH 193A,A05,093482,Rotar; Vladimir,6,0,34,28
1657247317476,MATH 197,001,091859,McAuley; Julian John,9999,0,9999,0
1657247317476,MATH 197,002,095566,Kedlaya; Kiran S.,9997,0,9999,2
1657247317476,MATH 197,003,095567,Xiao; Ming,9999,0,9999,0
1657247317476,MATH 197,004,095571,Perols; Johan Lars,9998,0,9999,1
1657247324535,COGS 9,A01,083615,Shannon; Kyle Michael,8,0,75,67
1657247330560,COGS 11,A01,083617,Boyle; Mary E. T.,22,0,48,26
1657247336585,COGS 13,A01,083071,Bastos; Amalia Pinkusfeld,8,0,71,63
1657247342610,COGS 14A,A01,092681,Semenuks; Arturs,2,1,100,98
1657247348633,COGS 14B,A01,083073,Cheng; Tzu-Han,6,0,63,57
1657247354655,COGS 17,A01,092677,Semenuks; Arturs,5,0,81,76
1657247360683,COGS 100,A01,083619,Allen; Michael Gordon,16,0,70,54
1657247366793,COGS 101A,A01,083621,Davis; Joshua Daniel,9,0,68,59
1657247372815,COGS 101B,A01,091572,Allen; Michael Gordon,11,0,65,54
1657247378848,COGS 101C,A01,083625,Delgado; Tania,17,0,35,18
1657247384873,COGS 107A,A01,083627,Boyle; Mary E. T.,13,0,60,47
1657247390897,COGS 118A,A01,083075,Gupta; Anjum,16,0,76,60
1657247396931,CSE 3,A50,083646,Miranda; Gregory Joseph,24,0,50,26
1657247402953,CSE 8A,A50,083650,Miranda; Gregory Joseph,17,1,56,39
1657247408986,CSE 11,A01,083080,Cao; Yingjun,5,15,40,35
1657247415009,CSE 12,A01,083652,Krause-Levy; Sophia Louisa,26,1,120,94
1657247421031,CSE 15L,A01,083654,Morris; Justin Loren,9,0,50,41
1657247421031,CSE 15L,A02,083655,Morris; Justin Loren,9,0,50,41
1657247427062,CSE 20,A01,083657,Tran; Khoa Dang,38,0,80,42
1657247433084,CSE 21,A01,095574,Bach; Quang Tran,22,0,48,26
1657247439112,CSE 30,A01,083084,Eldon; John,4,0,80,76
1657247439112,CSE 30,B01,095061,Bhaskar; Nishant,8,0,50,42
1657247445134,CSE 100,A01,083659,Cao; Yingjun,4,4,70,66
1657247459203,CSE 134B,A01,083661,Powell; Thomas Allan,21,0,100,79
1657247465233,CSE 140,A01,083663,Gungor; Onat,13,0,85,72
1657247471256,CSE 140L,A01,083088,Eldon; John,18,0,100,82
1657247477281,CSE 175,A01,083665,Kumar; Rakesh,3,0,25,22
1657247483306,CSE 190,A00,092507,Dubnov; Shlomo,7,0,20,13
1657247489329,ECE 45,A01,083139,Congero; Spencer William,5,0,75,70
1657247495351,ECE 65,A50,083695,Saad; Andrew S,12,0,30,18
1657247495351,ECE 65,A51,095125,Saad; Andrew S,25,0,26,1
1657247501386,ECE 109,A01,091882,Touri; Behrouz,19,0,70,51
1657247507407,ECE 180,A00,083140,Abi Samra; Nicholas Camill,1,0,30,29
1657247507407,ECE 180,B00,083141,Abi Samra; Nicholas Camill,0,0,30,30
1657247513429,MATH 10A,A01,083735,Patchell; Gregory David,2,0,30,28
1657247513429,MATH 10A,A02,083736,Patchell; Gregory David,20,0,30,10
1657247513429,MATH 10A,A03,083737,Patchell; Gregory David,16,0,30,14
1657247519454,MATH 10B,A01,083207,Lim; Seonhee,7,0,34,27
1657247519454,MATH 10B,A02,083208,Lim; Seonhee,9,0,35,26
1657247519454,MATH 10B,A03,093472,Lim; Seonhee,5,0,34,29
1657247519454,MATH 10B,B01,083739,Sinha; Shubham,11,0,30,19
1657247525485,MATH 18,A01,083743,Cinel; Cameron Alexander,6,0,30,24
1657247525485,MATH 18,A02,083744,Cinel; Cameron Alexander,17,0,30,13
1657247525485,MATH 18,A03,083745,Cinel; Cameron Alexander,8,0,30,22
1657247525485,MATH 18,B01,083748,Rideout; David Porter,4,0,37,33
1657247525485,MATH 18,B02,083749,Rideout; David Porter,4,0,36,32
1657247525485,MATH 18,B03,083750,Rideout; David Porter,2,0,37,35
1657247525485,MATH 18,B04,083751,Rideout; David Porter,6,0,36,30
1657247525485,MATH 18,B05,093473,Rideout; David Porter,5,0,36,31
1657247525485,MATH 18,B06,093474,Rideout; David Porter,5,0,36,31
1657247531512,MATH 20A,A01,083754,Zheng; Zequn,14,0,40,26
1657247537535,MATH 20B,A01,083756,Briones; Jor-el Thomas Caparas,3,0,36,33
1657247537535,MATH 20B,A02,083757,Briones; Jor-el Thomas Caparas,1,0,36,35
1657247537535,MATH 20B,A03,093475,Briones; Jor-el Thomas Caparas,2,0,36,34
1657247543559,MATH 20C,A01,083760,Briones; Jor-el Thomas Caparas,1,0,35,34
1657247543559,MATH 20C,A02,083761,Briones; Jor-el Thomas Caparas,8,0,35,27
1657247543559,MATH 20C,A03,093476,Briones; Jor-el Thomas Caparas,0,1,36,36
1657247543559,MATH 20C,B01,083762,Bach; Quang Tran,1,0,30,29
1657247549586,MATH 20D,A01,083765,Tran; Brian Kha,4,0,30,26
1657247549586,MATH 20D,A02,083766,Tran; Brian Kha,5,0,30,25
1657247549586,MATH 20D,A03,083767,Tran; Brian Kha,4,0,30,26
1657247555610,MATH 20E,A01,083771,Ganguly; Soumya,7,0,32,25
1657247555610,MATH 20E,A02,083772,Ganguly; Soumya,7,0,32,25
1657247555610,MATH 20E,B01,083773,Ciotti; Benjamin,19,0,35,16
1657247555610,MATH 20E,B02,083774,Ciotti; Benjamin,17,0,35,18
1657247561633,MATH 103A,A01,083777,Greenfeld; Be'Eri,3,0,36,33
1657247561633,MATH 103A,A02,083778,Greenfeld; Be'Eri,5,0,36,31
1657247561633,MATH 103A,A03,093561,Greenfeld; Be'Eri,4,0,36,32
1657247561633,MATH 103A,B01,083779,Greenfeld; Be'Eri,6,0,36,30
1657247561633,MATH 103A,B02,083780,Greenfeld; Be'Eri,3,0,36,33
1657247561633,MATH 103A,B03,093562,Greenfeld; Be'Eri,3,0,36,33
1657247567657,MATH 105,A01,085443,Carter; Anne Toulson,15,0,35,20
1657247567657,MATH 105,A02,093477,Carter; Anne Toulson,20,0,35,15
1657247573764,MATH 109,A01,083213,Ganzberger; Geoffrey Michael,2,0,34,32
1657247573764,MATH 109,A02,083214,Ganzberger; Geoffrey Michael,4,0,34,30
1657247573764,MATH 109,A03,093478,Ganzberger; Geoffrey Michael,2,0,34,32
1657247573764,MATH 109,B01,083215,Ganzberger; Geoffrey Michael,1,0,32,31
1657247573764,MATH 109,B02,083216,Ganzberger; Geoffrey Michael,1,0,32,31
1657247573764,MATH 109,B03,093479,Ganzberger; Geoffrey Michael,8,0,32,24
1657247579805,MATH 142A,A01,083219,Chow; Bennett,6,0,32,26
1657247579805,MATH 142A,A02,083220,Chow; Bennett,10,0,32,22
1657247579805,MATH 142A,A03,093480,Chow; Bennett,7,0,32,25
1657247579805,MATH 142A,B03,093481,Chow; Bennett,8,0,32,24
1657247579805,MATH 142A,B04,093558,Chow; Bennett,12,0,32,20
1657247579805,MATH 142A,B05,093559,Chow; Bennett,6,0,32,26
1657247585834,MATH 193A,A01,083224,Rotar; Vladimir,7,0,34,27
1657247585834,MATH 193A,A02,083225,Rotar; Vladimir,6,0,34,28
1657247585834,MATH 193A,A03,083781,Rotar; Vladimir,2,0,34,32
1657247585834,MATH 193A,A04,083782,Rotar; Vladimir,8,0,34,26
1657247585834,MATH 193A,A05,093482,Rotar; Vladimir,6,0,34,28
1657247591856,MATH 197,001,091859,McAuley; Julian John,9999,0,9999,0
1657247591856,MATH 197,002,095566,Kedlaya; Kiran S.,9997,0,9999,2
1657247591856,MATH 197,003,095567,Xiao; Ming,9999,0,9999,0
1657247591856,MATH 197,004,095571,Perols; Johan Lars,9998,0,9999,1
1657247598911,COGS 9,A01,083615,Shannon; Kyle Michael,8,0,75,67
1657247604932,COGS 11,A01,083617,Boyle; Mary E. T.,22,0,48,26
1657247610958,COGS 13,A01,083071,Bastos; Amalia Pinkusfeld,8,0,71,63
1657247616981,COGS 14A,A01,092681,Semenuks; Arturs,2,1,100,98
1657247623007,COGS 14B,A01,083073,Cheng; Tzu-Han,6,0,63,57
1657247629032,COGS 17,A01,092677,Semenuks; Arturs,5,0,81,76
1657247635053,COGS 100,A01,083619,Allen; Michael Gordon,16,0,70,54
1657247641087,COGS 101A,A01,083621,Davis; Joshua Daniel,9,0,68,59
1657247647110,COGS 101B,A01,091572,Allen; Michael Gordon,11,0,65,54
1657247653136,COGS 101C,A01,083625,Delgado; Tania,17,0,35,18
1657247659157,COGS 107A,A01,083627,Boyle; Mary E. T.,13,0,60,47
1657247665183,COGS 118A,A01,083075,Gupta; Anjum,16,0,76,60
1657247671210,CSE 3,A50,083646,Miranda; Gregory Joseph,24,0,50,26
1657247677236,CSE 8A,A50,083650,Miranda; Gregory Joseph,17,1,56,39
1657247683262,CSE 11,A01,083080,Cao; Yingjun,5,15,40,35
1657247689287,CSE 12,A01,083652,Krause-Levy; Sophia Louisa,26,1,120,94
1657247695315,CSE 15L,A01,083654,Morris; Justin Loren,9,0,50,41
1657247695315,CSE 15L,A02,083655,Morris; Justin Loren,9,0,50,41
1657247701337,CSE 20,A01,083657,Tran; Khoa Dang,38,0,80,42
1657247707360,CSE 21,A01,095574,Bach; Quang Tran,22,0,48,26
1657247713381,CSE 30,A01,083084,Eldon; John,4,0,80,76
1657247713381,CSE 30,B01,095061,Bhaskar; Nishant,8,0,50,42
1657247719405,CSE 100,A01,083659,Cao; Yingjun,4,4,70,66
1657247725427,CSE 134B,A01,083661,Powell; Thomas Allan,21,0,100,79
1657247731451,CSE 140,A01,083663,Gungor; Onat,13,0,85,72
1657247737473,CSE 140L,A01,083088,Eldon; John,18,0,100,82
1657247743500,CSE 175,A01,083665,Kumar; Rakesh,3,0,25,22
1657247749522,CSE 190,A00,092507,Dubnov; Shlomo,7,0,20,13
1657247755545,ECE 45,A01,083139,Congero; Spencer William,5,0,75,70
1657247761568,ECE 65,A50,083695,Saad; Andrew S,12,0,30,18
1657247761568,ECE 65,A51,095125,Saad; Andrew S,25,0,26,1
1657247767593,ECE 109,A01,091882,Touri; Behrouz,19,0,70,51
1657247773615,ECE 180,A00,083140,Abi Samra; Nicholas Camill,1,0,30,29
1657247773615,ECE 180,B00,083141,Abi Samra; Nicholas Camill,0,0,30,30
1657247779643,MATH 10A,A01,083735,Patchell; Gregory David,2,0,30,28
1657247779643,MATH 10A,A02,083736,Patchell; Gregory David,20,0,30,10
1657247779643,MATH 10A,A03,083737,Patchell; Gregory David,16,0,30,14
1657247785675,MATH 10B,A01,083207,Lim; Seonhee,7,0,34,27
1657247785675,MATH 10B,A02,083208,Lim; Seonhee,9,0,35,26
1657247785675,MATH 10B,A03,093472,Lim; Seonhee,5,0,34,29
1657247785675,MATH 10B,B01,083739,Sinha; Shubham,11,0,30,19
1657247791700,MATH 18,A01,083743,Cinel; Cameron Alexander,6,0,30,24
1657247791700,MATH 18,A02,083744,Cinel; Cameron Alexander,17,0,30,13
1657247791700,MATH 18,A03,083745,Cinel; Cameron Alexander,8,0,30,22
1657247791700,MATH 18,B01,083748,Rideout; David Porter,4,0,37,33
1657247791700,MATH 18,B02,083749,Rideout; David Porter,4,0,36,32
1657247791700,MATH 18,B03,083750,Rideout; David Porter,2,0,37,35
1657247791700,MATH 18,B04,083751,Rideout; David Porter,6,0,36,30
1657247791700,MATH 18,B05,093473,Rideout; David Porter,5,0,36,31
1657247791700,MATH 18,B06,093474,Rideout; David Porter,5,0,36,31
1657247797722,MATH 20A,A01,083754,Zheng; Zequn,14,0,40,26
1657247803750,MATH 20B,A01,083756,Briones; Jor-el Thomas Caparas,3,0,36,33
1657247803750,MATH 20B,A02,083757,Briones; Jor-el Thomas Caparas,1,0,36,35
1657247803750,MATH 20B,A03,093475,Briones; Jor-el Thomas Caparas,2,0,36,34
1657247809773,MATH 20C,A01,083760,Briones; Jor-el Thomas Caparas,1,0,35,34
1657247809773,MATH 20C,A02,083761,Briones; Jor-el Thomas Caparas,8,0,35,27
1657247809773,MATH 20C,A03,093476,Briones; Jor-el Thomas Caparas,0,1,36,36
1657247809773,MATH 20C,B01,083762,Bach; Quang Tran,1,0,30,29
1657247815796,MATH 20D,A01,083765,Tran; Brian Kha,4,0,30,26
1657247815796,MATH 20D,A02,083766,Tran; Brian Kha,5,0,30,25
1657247815796,MATH 20D,A03,083767,Tran; Brian Kha,4,0,30,26
1657247821822,MATH 20E,A01,083771,Ganguly; Soumya,7,0,32,25
1657247821822,MATH 20E,A02,083772,Ganguly; Soumya,7,0,32,25
1657247821822,MATH 20E,B01,083773,Ciotti; Benjamin,19,0,35,16
1657247821822,MATH 20E,B02,083774,Ciotti; Benjamin,17,0,35,18
1657247827852,MATH 103A,A01,083777,Greenfeld; Be'Eri,3,0,36,33
1657247827852,MATH 103A,A02,083778,Greenfeld; Be'Eri,5,0,36,31
1657247827852,MATH 103A,A03,093561,Greenfeld; Be'Eri,4,0,36,32
1657247827852,MATH 103A,B01,083779,Greenfeld; Be'Eri,6,0,36,30
1657247827852,MATH 103A,B02,083780,Greenfeld; Be'Eri,3,0,36,33
1657247827852,MATH 103A,B03,093562,Greenfeld; Be'Eri,3,0,36,33
1657247833875,MATH 105,A01,085443,Carter; Anne Toulson,15,0,35,20
1657247833875,MATH 105,A02,093477,Carter; Anne Toulson,20,0,35,15
1657247839899,MATH 109,A01,083213,Ganzberger; Geoffrey Michael,2,0,34,32
1657247839899,MATH 109,A02,083214,Ganzberger; Geoffrey Michael,4,0,34,30
1657247839899,MATH 109,A03,093478,Ganzberger; Geoffrey Michael,2,0,34,32
1657247839899,MATH 109,B01,083215,Ganzberger; Geoffrey Michael,1,0,32,31
1657247839899,MATH 109,B02,083216,Ganzberger; Geoffrey Michael,1,0,32,31
1657247839899,MATH 109,B03,093479,Ganzberger; Geoffrey Michael,8,0,32,24
1657247845922,MATH 142A,A01,083219,Chow; Bennett,6,0,32,26
1657247845922,MATH 142A,A02,083220,Chow; Bennett,10,0,32,22
1657247845922,MATH 142A,A03,093480,Chow; Bennett,7,0,32,25
1657247845922,MATH 142A,B03,093481,Chow; Bennett,8,0,32,24
1657247845922,MATH 142A,B04,093558,Chow; Bennett,12,0,32,20
1657247845922,MATH 142A,B05,093559,Chow; Bennett,6,0,32,26
1657247851946,MATH 193A,A01,083224,Rotar; Vladimir,7,0,34,27
1657247851946,MATH 193A,A02,083225,Rotar; Vladimir,6,0,34,28
1657247851946,MATH 193A,A03,083781,Rotar; Vladimir,2,0,34,32
1657247851946,MATH 193A,A04,083782,Rotar; Vladimir,8,0,34,26
1657247851946,MATH 193A,A05,093482,Rotar; Vladimir,6,0,34,28
1657247857967,MATH 197,001,091859,McAuley; Julian John,9999,0,9999,0
1657247857967,MATH 197,002,095566,Kedlaya; Kiran S.,9997,0,9999,2
1657247857967,MATH 197,003,095567,Xiao; Ming,9999,0,9999,0
1657247857967,MATH 197,004,095571,Perols; Johan Lars,9998,0,9999,1
1657247865029,COGS 9,A01,083615,Shannon; Kyle Michael,8,0,75,67
1657247871061,COGS 11,A01,083617,Boyle; Mary E. T.,22,0,48,26
1657247877089,COGS 13,A01,083071,Bastos; Amalia Pinkusfeld,8,0,71,63
1657247883112,COGS 14A,A01,092681,Semenuks; Arturs,2,1,100,98
1657247889136,COGS 14B,A01,083073,Cheng; Tzu-Han,6,0,63,57
1657247895160,COGS 17,A01,092677,Semenuks; Arturs,5,0,81,76
1657247901198,COGS 100,A01,083619,Allen; Michael Gordon,16,0,70,54
1657247907221,COGS 101A,A01,083621,Davis; Joshua Daniel,9,0,68,59
1657247913244,COGS 101B,A01,091572,Allen; Michael Gordon,11,0,65,54
1657247919266,COGS 101C,A01,083625,Delgado; Tania,17,0,35,18
1657247925288,COGS 107A,A01,083627,Boyle; Mary E. T.,13,0,60,47
1657247931317,COGS 118A,A01,083075,Gupta; Anjum,16,0,76,60
1657247937348,CSE 3,A50,083646,Miranda; Gregory Joseph,24,0,50,26
1657247943371,CSE 8A,A50,083650,Miranda; Gregory Joseph,17,1,56,39
1657247949394,CSE 11,A01,083080,Cao; Yingjun,5,15,40,35
1657247955417,CSE 12,A01,083652,Krause-Levy; Sophia Louisa,26,1,120,94
1657247961440,CSE 15L,A01,083654,Morris; Justin Loren,9,0,50,41
1657247961440,CSE 15L,A02,083655,Morris; Justin Loren,9,0,50,41
1657247967466,CSE 20,A01,083657,Tran; Khoa Dang,38,0,80,42
1657247973570,CSE 21,A01,095574,Bach; Quang Tran,22,0,48,26
1657247979598,CSE 30,A01,083084,Eldon; John,4,0,80,76
1657247979598,CSE 30,B01,095061,Bhaskar; Nishant,8,0,50,42
1657247985618,CSE 100,A01,083659,Cao; Yingjun,4,4,70,66
1657247991648,CSE 134B,A01,083661,Powell; Thomas Allan,21,0,100,79
1657247997670,CSE 140,A01,083663,Gungor; Onat,13,0,85,72
1657248003702,CSE 140L,A01,083088,Eldon; John,18,0,100,82
1657248009732,CSE 175,A01,083665,Kumar; Rakesh,3,0,25,22
1657248015755,CSE 190,A00,092507,Dubnov; Shlomo,7,0,20,13
1657248021778,ECE 45,A01,083139,Congero; Spencer William,5,0,75,70
1657248027815,ECE 65,A50,083695,Saad; Andrew S,12,0,30,18
1657248027815,ECE 65,A51,095125,Saad; Andrew S,25,0,26,1
1657248033839,ECE 109,A01,091882,Touri; Behrouz,19,0,70,51
1657248039872,ECE 180,A00,083140,Abi Samra; Nicholas Camill,1,0,30,29
1657248039872,ECE 180,B00,083141,Abi Samra; Nicholas Camill,0,0,30,30
1657248045899,MATH 10A,A01,083735,Patchell; Gregory David,2,0,30,28
1657248045899,MATH 10A,A02,083736,Patchell; Gregory David,20,0,30,10
1657248045899,MATH 10A,A03,083737,Patchell; Gregory David,16,0,30,14
1657248051927,MATH 10B,A01,083207,Lim; Seonhee,7,0,34,27
1657248051927,MATH 10B,A02,083208,Lim; Seonhee,9,0,35,26
1657248051927,MATH 10B,A03,093472,Lim; Seonhee,5,0,34,29
1657248051927,MATH 10B,B01,083739,Sinha; Shubham,11,0,30,19
1657248057956,MATH 18,A01,083743,Cinel; Cameron Alexander,6,0,30,24
1657248057956,MATH 18,A02,083744,Cinel; Cameron Alexander,17,0,30,13
1657248057956,MATH 18,A03,083745,Cinel; Cameron Alexander,8,0,30,22
1657248057956,MATH 18,B01,083748,Rideout; David Porter,4,0,37,33
1657248057956,MATH 18,B02,083749,Rideout; David Porter,4,0,36,32
1657248057956,MATH 18,B03,083750,Rideout; David Porter,2,0,37,35
1657248057956,MATH 18,B04,083751,Rideout; David Porter,6,0,36,30
1657248057956,MATH 18,B05,093473,Rideout; David Porter,5,0,36,31
1657248057956,MATH 18,B06,093474,Rideout; David Porter,5,0,36,31
1657248063982,MATH 20A,A01,083754,Zheng; Zequn,14,0,40,26
1657248070008,MATH 20B,A01,083756,Briones; Jor-el Thomas Caparas,3,0,36,33
1657248070008,MATH 20B,A02,083757,Briones; Jor-el Thomas Caparas,1,0,36,35
1657248070008,MATH 20B,A03,093475,Briones; Jor-el Thomas Caparas,2,0,36,34
1657248076037,MATH 20C,A01,083760,Briones; Jor-el Thomas Caparas,1,0,35,34
1657248076037,MATH 20C,A02,083761,Briones; Jor-el Thomas Caparas,8,0,35,27
1657248076037,MATH 20C,A03,093476,Briones; Jor-el Thomas Caparas,0,1,36,36
1657248076037,MATH 20C,B01,083762,Bach; Quang Tran,1,0,30,29
1657248082062,MATH 20D,A01,083765,Tran; Brian Kha,4,0,30,26
1657248082062,MATH 20D,A02,083766,Tran; Brian Kha,5,0,30,25
1657248082062,MATH 20D,A03,083767,Tran; Brian Kha,4,0,30,26
1657248088085,MATH 20E,A01,083771,Ganguly; Soumya,7,0,32,25
1657248088085,MATH 20E,A02,083772,Ganguly; Soumya,7,0,32,25
1657248088085,MATH 20E,B01,083773,Ciotti; Benjamin,19,0,35,16
1657248088085,MATH 20E,B02,083774,Ciotti; Benjamin,17,0,35,18
1657248094112,MATH 103A,A01,083777,Greenfeld; Be'Eri,3,0,36,33
1657248094112,MATH 103A,A02,083778,Greenfeld; Be'Eri,5,0,36,31
1657248094112,MATH 103A,A03,093561,Greenfeld; Be'Eri,4,0,36,32
1657248094112,MATH 103A,B01,083779,Greenfeld; Be'Eri,6,0,36,30
1657248094112,MATH 103A,B02,083780,Greenfeld; Be'Eri,3,0,36,33
1657248094112,MATH 103A,B03,093562,Greenfeld; Be'Eri,3,0,36,33
1657248100137,MATH 105,A01,085443,Carter; Anne Toulson,15,0,35,20
1657248100137,MATH 105,A02,093477,Carter; Anne Toulson,20,0,35,15
1657248106166,MATH 109,A01,083213,Ganzberger; Geoffrey Michael,2,0,34,32
1657248106166,MATH 109,A02,083214,Ganzberger; Geoffrey Michael,4,0,34,30
1657248106166,MATH 109,A03,093478,Ganzberger; Geoffrey Michael,2,0,34,32
1657248106166,MATH 109,B01,083215,Ganzberger; Geoffrey Michael,1,0,32,31
1657248106166,MATH 109,B02,083216,Ganzberger; Geoffrey Michael,1,0,32,31
1657248106166,MATH 109,B03,093479,Ganzberger; Geoffrey Michael,8,0,32,24
1657248112195,MATH 142A,A01,083219,Chow; Bennett,6,0,32,26
1657248112195,MATH 142A,A02,083220,Chow; Bennett,10,0,32,22
1657248112195,MATH 142A,A03,093480,Chow; Bennett,7,0,32,25
1657248112195,MATH 142A,B03,093481,Chow; Bennett,8,0,32,24
1657248112195,MATH 142A,B04,093558,Chow; Bennett,12,0,32,20
1657248112195,MATH 142A,B05,093559,Chow; Bennett,6,0,32,26
1657248118223,MATH 193A,A01,083224,Rotar; Vladimir,7,0,34,27
1657248118223,MATH 193A,A02,083225,Rotar; Vladimir,6,0,34,28
1657248118223,MATH 193A,A03,083781,Rotar; Vladimir,2,0,34,32
1657248118223,MATH 193A,A04,083782,Rotar; Vladimir,8,0,34,26
1657248118223,MATH 193A,A05,093482,Rotar; Vladimir,6,0,34,28
1657248124246,MATH 197,001,091859,McAuley; Julian John,9999,0,9999,0
1657248124246,MATH 197,002,095566,Kedlaya; Kiran S.,9997,0,9999,2
1657248124246,MATH 197,003,095567,Xiao; Ming,9999,0,9999,0
1657248124246,MATH 197,004,095571,Perols; Johan Lars,9998,0,9999,1
1657248131299,COGS 9,A01,083615,Shannon; Kyle Michael,8,0,75,67
1657248137322,COGS 11,A01,083617,Boyle; Mary E. T.,22,0,48,26
1657248143349,COGS 13,A01,083071,Bastos; Amalia Pinkusfeld,8,0,71,63
1657248149378,COGS 14A,A01,092681,Semenuks; Arturs,2,1,100,98
1657248155404,COGS 14B,A01,083073,Cheng; Tzu-Han,6,0,63,57
1657248161444,COGS 17,A01,092677,Semenuks; Arturs,5,0,81,76
1657248167468,COGS 100,A01,083619,Allen; Michael Gordon,16,0,70,54
1657248173514,COGS 101A,A01,083621,Davis; Joshua Daniel,9,0,68,59
1657248179535,COGS 101B,A01,091572,Allen; Michael Gordon,11,0,65,54
1657248185563,COGS 101C,A01,083625,Delgado; Tania,17,0,35,18
1657248191589,COGS 107A,A01,083627,Boyle; Mary E. T.,13,0,60,47
1657248197612,COGS 118A,A01,083075,Gupta; Anjum,16,0,76,60
1657248203649,CSE 3,A50,083646,Miranda; Gregory Joseph,24,0,50,26
1657248209682,CSE 8A,A50,083650,Miranda; Gregory Joseph,17,1,56,39
1657248215721,CSE 11,A01,083080,Cao; Yingjun,5,15,40,35
1657248221744,CSE 12,A01,083652,Krause-Levy; Sophia Louisa,26,1,120,94
1657248227770,CSE 15L,A01,083654,Morris; Justin Loren,9,0,50,41
1657248227770,CSE 15L,A02,083655,Morris; Justin Loren,9,0,50,41
1657248233797,CSE 20,A01,083657,Tran; Khoa Dang,38,0,80,42
1657248239828,CSE 21,A01,095574,Bach; Quang Tran,22,0,48,26
1657248245869,CSE 30,A01,083084,Eldon; John,4,0,80,76
1657248245869,CSE 30,B01,095061,Bhaskar; Nishant,8,0,50,42
1657248251894,CSE 100,A01,083659,Cao; Yingjun,4,4,70,66
1657248257924,CSE 134B,A01,083661,Powell; Thomas Allan,21,0,100,79
1657248263950,CSE 140,A01,083663,Gungor; Onat,13,0,85,72
1657248269972,CSE 140L,A01,083088,Eldon; John,18,0,100,82
1657248276000,CSE 175,A01,083665,Kumar; Rakesh,3,0,25,22
1657248282028,CSE 190,A00,092507,Dubnov; Shlomo,7,0,20,13
1657248288051,ECE 45,A01,083139,Congero; Spencer William,5,0,75,70
1657248294075,ECE 65,A50,083695,Saad; Andrew S,12,0,30,18
1657248294075,ECE 65,A51,095125,Saad; Andrew S,25,0,26,1
1657248300096,ECE 109,A01,091882,Touri; Behrouz,19,0,70,51
1657248306124,ECE 180,A00,083140,Abi Samra; Nicholas Camill,1,0,30,29
1657248306124,ECE 180,B00,083141,Abi Samra; Nicholas Camill,0,0,30,30
1657248312159,MATH 10A,A01,083735,Patchell; Gregory David,2,0,30,28
1657248312159,MATH 10A,A02,083736,Patchell; Gregory David,20,0,30,10
1657248312159,MATH 10A,A03,083737,Patchell; Gregory David,16,0,30,14
1657248318182,MATH 10B,A01,083207,Lim; Seonhee,7,0,34,27
1657248318182,MATH 10B,A02,083208,Lim; Seonhee,9,0,35,26
1657248318182,MATH 10B,A03,093472,Lim; Seonhee,5,0,34,29
1657248318182,MATH 10B,B01,083739,Sinha; Shubham,11,0,30,19
1657248324208,MATH 18,A01,083743,Cinel; Cameron Alexander,6,0,30,24
1657248324208,MATH 18,A02,083744,Cinel; Cameron Alexander,17,0,30,13
1657248324208,MATH 18,A03,083745,Cinel; Cameron Alexander,8,0,30,22
1657248324208,MATH 18,B01,083748,Rideout; David Porter,4,0,37,33
1657248324208,MATH 18,B02,083749,Rideout; David Porter,4,0,36,32
1657248324208,MATH 18,B03,083750,Rideout; David Porter,2,0,37,35
1657248324208,MATH 18,B04,083751,Rideout; David Porter,6,0,36,30
1657248324208,MATH 18,B05,093473,Rideout; David Porter,5,0,36,31
1657248324208,MATH 18,B06,093474,Rideout; David Porter,5,0,36,31
1657248330236,MATH 20A,A01,083754,Zheng; Zequn,14,0,40,26
1657248336260,MATH 20B,A01,083756,Briones; Jor-el Thomas Caparas,3,0,36,33
1657248336260,MATH 20B,A02,083757,Briones; Jor-el Thomas Caparas,1,0,36,35
1657248336260,MATH 20B,A03,093475,Briones; Jor-el Thomas Caparas,2,0,36,34
1657248342287,MATH 20C,A01,083760,Briones; Jor-el Thomas Caparas,1,0,35,34
1657248342287,MATH 20C,A02,083761,Briones; Jor-el Thomas Caparas,8,0,35,27
1657248342287,MATH 20C,A03,093476,Briones; Jor-el Thomas Caparas,0,1,36,36
1657248342287,MATH 20C,B01,083762,Bach; Quang Tran,1,0,30,29
1657248348315,MATH 20D,A01,083765,Tran; Brian Kha,4,0,30,26
1657248348315,MATH 20D,A02,083766,Tran; Brian Kha,5,0,30,25
1657248348315,MATH 20D,A03,083767,Tran; Brian Kha,4,0,30,26
1657248354344,MATH 20E,A01,083771,Ganguly; Soumya,7,0,32,25
1657248354344,MATH 20E,A02,083772,Ganguly; Soumya,7,0,32,25
1657248354344,MATH 20E,B01,083773,Ciotti; Benjamin,19,0,35,16
1657248354344,MATH 20E,B02,083774,Ciotti; Benjamin,17,0,35,18
1657248360372,MATH 103A,A01,083777,Greenfeld; Be'Eri,3,0,36,33
1657248360372,MATH 103A,A02,083778,Greenfeld; Be'Eri,5,0,36,31
1657248360372,MATH 103A,A03,093561,Greenfeld; Be'Eri,4,0,36,32
1657248360372,MATH 103A,B01,083779,Greenfeld; Be'Eri,6,0,36,30
1657248360372,MATH 103A,B02,083780,Greenfeld; Be'Eri,3,0,36,33
1657248360372,MATH 103A,B03,093562,Greenfeld; Be'Eri,3,0,36,33
1657248366396,MATH 105,A01,085443,Carter; Anne Toulson,15,0,35,20
1657248366396,MATH 105,A02,093477,Carter; Anne Toulson,20,0,35,15
1657248372421,MATH 109,A01,083213,Ganzberger; Geoffrey Michael,2,0,34,32
1657248372421,MATH 109,A02,083214,Ganzberger; Geoffrey Michael,4,0,34,30
1657248372421,MATH 109,A03,093478,Ganzberger; Geoffrey Michael,2,0,34,32
1657248372421,MATH 109,B01,083215,Ganzberger; Geoffrey Michael,1,0,32,31
1657248372421,MATH 109,B02,083216,Ganzberger; Geoffrey Michael,1,0,32,31
1657248372421,MATH 109,B03,093479,Ganzberger; Geoffrey Michael,8,0,32,24
1657248378447,MATH 142A,A01,083219,Chow; Bennett,6,0,32,26
1657248378447,MATH 142A,A02,083220,Chow; Bennett,10,0,32,22
1657248378447,MATH 142A,A03,093480,Chow; Bennett,7,0,32,25
1657248378447,MATH 142A,B03,093481,Chow; Bennett,8,0,32,24
1657248378447,MATH 142A,B04,093558,Chow; Bennett,12,0,32,20
1657248378447,MATH 142A,B05,093559,Chow; Bennett,6,0,32,26
1657248384470,MATH 193A,A01,083224,Rotar; Vladimir,7,0,34,27
1657248384470,MATH 193A,A02,083225,Rotar; Vladimir,6,0,34,28
1657248384470,MATH 193A,A03,083781,Rotar; Vladimir,2,0,34,32
1657248384470,MATH 193A,A04,083782,Rotar; Vladimir,8,0,34,26
1657248384470,MATH 193A,A05,093482,Rotar; Vladimir,6,0,34,28
1657248390494,MATH 197,001,091859,McAuley; Julian John,9999,0,9999,0
1657248390494,MATH 197,002,095566,Kedlaya; Kiran S.,9997,0,9999,2
1657248390494,MATH 197,003,095567,Xiao; Ming,9999,0,9999,0
1657248390494,MATH 197,004,095571,Perols; Johan Lars,9998,0,9999,1
1657248397544,COGS 9,A01,083615,Shannon; Kyle Michael,8,0,75,67
1657248403567,COGS 11,A01,083617,Boyle; Mary E. T.,22,0,48,26
1657248409593,COGS 13,A01,083071,Bastos; Amalia Pinkusfeld,8,0,71,63
1657248415617,COGS 14A,A01,092681,Semenuks; Arturs,2,1,100,98
1657248421645,COGS 14B,A01,083073,Cheng; Tzu-Han,6,0,63,57
1657248427667,COGS 17,A01,092677,Semenuks; Arturs,5,0,81,76
1657248433694,COGS 100,A01,083619,Allen; Michael Gordon,16,0,70,54
1657248439720,COGS 101A,A01,083621,Davis; Joshua Daniel,9,0,68,59
1657248445747,COGS 101B,A01,091572,Allen; Michael Gordon,11,0,65,54
1657248451777,COGS 101C,A01,083625,Delgado; Tania,17,0,35,18
1657248457805,COGS 107A,A01,083627,Boyle; Mary E. T.,13,0,60,47
1657248463828,COGS 118A,A01,083075,Gupta; Anjum,16,0,76,60
1657248469851,CSE 3,A50,083646,Miranda; Gregory Joseph,24,0,50,26
1657248475876,CSE 8A,A50,083650,Miranda; Gregory Joseph,17,1,56,39
1657248481900,CSE 11,A01,083080,Cao; Yingjun,5,15,40,35
1657248487927,CSE 12,A01,083652,Krause-Levy; Sophia Louisa,26,1,120,94
1657248493949,CSE 15L,A01,083654,Morris; Justin Loren,9,0,50,41
1657248493949,CSE 15L,A02,083655,Morris; Justin Loren,9,0,50,41
1657248499971,CSE 20,A01,083657,Tran; Khoa Dang,38,0,80,42
1657248505997,CSE 21,A01,095574,Bach; Quang Tran,22,0,48,26
1657248512025,CSE 30,A01,083084,Eldon; John,4,0,80,76
1657248512025,CSE 30,B01,095061,Bhaskar; Nishant,8,0,50,42
1657248518054,CSE 100,A01,083659,Cao; Yingjun,4,4,70,66
1657248524079,CSE 134B,A01,083661,Powell; Thomas Allan,21,0,100,79
1657248530101,CSE 140,A01,083663,Gungor; Onat,13,0,85,72
1657248536129,CSE 140L,A01,083088,Eldon; John,18,0,100,82
1657248542156,CSE 175,A01,083665,Kumar; Rakesh,3,0,25,22
1657248548191,CSE 190,A00,092507,Dubnov; Shlomo,7,0,20,13
1657248554218,ECE 45,A01,083139,Congero; Spencer William,5,0,75,70
1657248560241,ECE 65,A50,083695,Saad; Andrew S,12,0,30,18
1657248560241,ECE 65,A51,095125,Saad; Andrew S,25,0,26,1
1657248566268,ECE 109,A01,091882,Touri; Behrouz,19,0,70,51
1657248572372,ECE 180,A00,083140,Abi Samra; Nicholas Camill,1,0,30,29
1657248572372,ECE 180,B00,083141,Abi Samra; Nicholas Camill,0,0,30,30
1657248578402,MATH 10A,A01,083735,Patchell; Gregory David,2,0,30,28
1657248578402,MATH 10A,A02,083736,Patchell; Gregory David,20,0,30,10
1657248578402,MATH 10A,A03,083737,Patchell; Gregory David,16,0,30,14
1657248584426,MATH 10B,A01,083207,Lim; Seonhee,7,0,34,27
1657248584426,MATH 10B,A02,083208,Lim; Seonhee,9,0,35,26
1657248584426,MATH 10B,A03,093472,Lim; Seonhee,5,0,34,29
1657248584426,MATH 10B,B01,083739,Sinha; Shubham,11,0,30,19
1657248590457,MATH 18,A01,083743,Cinel; Cameron Alexander,6,0,30,24
1657248590457,MATH 18,A02,083744,Cinel; Cameron Alexander,17,0,30,13
1657248590457,MATH 18,A03,083745,Cinel; Cameron Alexander,8,0,30,22
1657248590457,MATH 18,B01,083748,Rideout; David Porter,4,0,37,33
1657248590457,MATH 18,B02,083749,Rideout; David Porter,4,0,36,32
1657248590457,MATH 18,B03,083750,Rideout; David Porter,2,0,37,35
1657248590457,MATH 18,B04,083751,Rideout; David Porter,6,0,36,30
1657248590457,MATH 18,B05,093473,Rideout; David Porter,5,0,36,31
1657248590457,MATH 18,B06,093474,Rideout; David Porter,5,0,36,31
1657248596480,MATH 20A,A01,083754,Zheng; Zequn,14,0,40,26
1657248602509,MATH 20B,A01,083756,Briones; Jor-el Thomas Caparas,3,0,36,33
1657248602509,MATH 20B,A02,083757,Briones; Jor-el Thomas Caparas,1,0,36,35
1657248602509,MATH 20B,A03,093475,Briones; Jor-el Thomas Caparas,2,0,36,34
1657248608533,MATH 20C,A01,083760,Briones; Jor-el Thomas Caparas,1,0,35,34
1657248608533,MATH 20C,A02,083761,Briones; Jor-el Thomas Caparas,8,0,35,27
1657248608533,MATH 20C,A03,093476,Briones; Jor-el Thomas Caparas,0,1,36,36
1657248608533,MATH 20C,B01,083762,Bach; Quang Tran,1,0,30,29
1657248614556,MATH 20D,A01,083765,Tran; Brian Kha,4,0,30,26
1657248614556,MATH 20D,A02,083766,Tran; Brian Kha,5,0,30,25
1657248614556,MATH 20D,A03,083767,Tran; Brian Kha,4,0,30,26
1657248620580,MATH 20E,A01,083771,Ganguly; Soumya,7,0,32,25
1657248620580,MATH 20E,A02,083772,Ganguly; Soumya,7,0,32,25
1657248620580,MATH 20E,B01,083773,Ciotti; Benjamin,19,0,35,16
1657248620580,MATH 20E,B02,083774,Ciotti; Benjamin,17,0,35,18
1657248626603,MATH 103A,A01,083777,Greenfeld; Be'Eri,3,0,36,33
1657248626603,MATH 103A,A02,083778,Greenfeld; Be'Eri,5,0,36,31
1657248626603,MATH 103A,A03,093561,Greenfeld; Be'Eri,4,0,36,32
1657248626603,MATH 103A,B01,083779,Greenfeld; Be'Eri,6,0,36,30
1657248626603,MATH 103A,B02,083780,Greenfeld; Be'Eri,3,0,36,33
1657248626603,MATH 103A,B03,093562,Greenfeld; Be'Eri,3,0,36,33
1657248632626,MATH 105,A01,085443,Carter; Anne Toulson,15,0,35,20
1657248632626,MATH 105,A02,093477,Carter; Anne Toulson,20,0,35,15
1657248638654,MATH 109,A01,083213,Ganzberger; Geoffrey Michael,2,0,34,32
1657248638654,MATH 109,A02,083214,Ganzberger; Geoffrey Michael,4,0,34,30
1657248638654,MATH 109,A03,093478,Ganzberger; Geoffrey Michael,2,0,34,32
1657248638654,MATH 109,B01,083215,Ganzberger; Geoffrey Michael,1,0,32,31
1657248638654,MATH 109,B02,083216,Ganzberger; Geoffrey Michael,1,0,32,31
1657248638654,MATH 109,B03,093479,Ganzberger; Geoffrey Michael,8,0,32,24
1657248644679,MATH 142A,A01,083219,Chow; Bennett,6,0,32,26
1657248644679,MATH 142A,A02,083220,Chow; Bennett,10,0,32,22
1657248644679,MATH 142A,A03,093480,Chow; Bennett,7,0,32,25
1657248644679,MATH 142A,B03,093481,Chow; Bennett,8,0,32,24
1657248644679,MATH 142A,B04,093558,Chow; Bennett,12,0,32,20
1657248644679,MATH 142A,B05,093559,Chow; Bennett,6,0,32,26
1657248650708,MATH 193A,A01,083224,Rotar; Vladimir,7,0,34,27
1657248650708,MATH 193A,A02,083225,Rotar; Vladimir,6,0,34,28
1657248650708,MATH 193A,A03,083781,Rotar; Vladimir,2,0,34,32
1657248650708,MATH 193A,A04,083782,Rotar; Vladimir,8,0,34,26
1657248650708,MATH 193A,A05,093482,Rotar; Vladimir,6,0,34,28
1657248656731,MATH 197,001,091859,McAuley; Julian John,9999,0,9999,0
1657248656731,MATH 197,002,095566,Kedlaya; Kiran S.,9997,0,9999,2
1657248656731,MATH 197,003,095567,Xiao; Ming,9999,0,9999,0
1657248656731,MATH 197,004,095571,Perols; Johan Lars,9998,0,9999,1
1657248663784,COGS 9,A01,083615,Shannon; Kyle Michael,8,0,75,67
1657248669806,COGS 11,A01,083617,Boyle; Mary E. T.,22,0,48,26
1657248675830,COGS 13,A01,083071,Bastos; Amalia Pinkusfeld,8,0,71,63
1657248681857,COGS 14A,A01,092681,Semenuks; Arturs,2,1,100,98
1657248687882,COGS 14B,A01,083073,Cheng; Tzu-Han,6,0,63,57
1657248693905,COGS 17,A01,092677,Semenuks; Arturs,5,0,81,76
1657248699948,COGS 100,A01,083619,Allen; Michael Gordon,16,0,70,54
1657248705978,COGS 101A,A01,083621,Davis; Joshua Daniel,9,0,68,59
1657248712005,COGS 101B,A01,091572,Allen; Michael Gordon,11,0,65,54
1657248718032,COGS 101C,A01,083625,Delgado; Tania,17,0,35,18
1657248724067,COGS 107A,A01,083627,Boyle; Mary E. T.,13,0,60,47
1657248730089,COGS 118A,A01,083075,Gupta; Anjum,17,0,76,59
1657248736112,CSE 3,A50,083646,Miranda; Gregory Joseph,24,0,50,26
1657248742138,CSE 8A,A50,083650,Miranda; Gregory Joseph,17,1,56,39
1657248748161,CSE 11,A01,083080,Cao; Yingjun,5,15,40,35
1657248754185,CSE 12,A01,083652,Krause-Levy; Sophia Louisa,26,1,120,94
1657248760212,CSE 15L,A01,083654,Morris; Justin Loren,9,0,50,41
1657248760212,CSE 15L,A02,083655,Morris; Justin Loren,9,0,50,41
1657248766238,CSE 20,A01,083657,Tran; Khoa Dang,38,0,80,42
1657248772261,CSE 21,A01,095574,Bach; Quang Tran,22,0,48,26
1657248778288,CSE 30,A01,083084,Eldon; John,4,0,80,76
1657248778288,CSE 30,B01,095061,Bhaskar; Nishant,8,0,50,42
1657248784311,CSE 100,A01,083659,Cao; Yingjun,4,4,70,66
1657248790334,CSE 134B,A01,083661,Powell; Thomas Allan,21,0,100,79
1657248796372,CSE 140,A01,083663,Gungor; Onat,13,0,85,72
1657248802402,CSE 140L,A01,083088,Eldon; John,18,0,100,82
1657248808425,CSE 175,A01,083665,Kumar; Rakesh,3,0,25,22
1657248814446,CSE 190,A00,092507,Dubnov; Shlomo,7,0,20,13
1657248820471,ECE 45,A01,083139,Congero; Spencer William,5,0,75,70
1657248826498,ECE 65,A50,083695,Saad; Andrew S,12,0,30,18
1657248826498,ECE 65,A51,095125,Saad; Andrew S,25,0,26,1
1657248832522,ECE 109,A01,091882,Touri; Behrouz,19,0,70,51
1657248838544,ECE 180,A00,083140,Abi Samra; Nicholas Camill,1,0,30,29
1657248838544,ECE 180,B00,083141,Abi Samra; Nicholas Camill,0,0,30,30
1657248844572,MATH 10A,A01,083735,Patchell; Gregory David,2,0,30,28
1657248844572,MATH 10A,A02,083736,Patchell; Gregory David,20,0,30,10
1657248844572,MATH 10A,A03,083737,Patchell; Gregory David,16,0,30,14
1657248850599,MATH 10B,A01,083207,Lim; Seonhee,7,0,34,27
1657248850599,MATH 10B,A02,083208,Lim; Seonhee,9,0,35,26
1657248850599,MATH 10B,A03,093472,Lim; Seonhee,5,0,34,29
1657248850599,MATH 10B,B01,083739,Sinha; Shubham,11,0,30,19
1657248856634,MATH 18,A01,083743,Cinel; Cameron Alexander,6,0,30,24
1657248856634,MATH 18,A02,083744,Cinel; Cameron Alexander,17,0,30,13
1657248856634,MATH 18,A03,083745,Cinel; Cameron Alexander,8,0,30,22
1657248856634,MATH 18,B01,083748,Rideout; David Porter,4,0,37,33
1657248856634,MATH 18,B02,083749,Rideout; David Porter,4,0,36,32
1657248856634,MATH 18,B03,083750,Rideout; David Porter,2,0,37,35
1657248856634,MATH 18,B04,083751,Rideout; David Porter,6,0,36,30
1657248856634,MATH 18,B05,093473,Rideout; David Porter,5,0,36,31
1657248856634,MATH 18,B06,093474,Rideout; David Porter,5,0,36,31
1657248862656,MATH 20A,A01,083754,Zheng; Zequn,14,0,40,26
1657248868684,MATH 20B,A01,083756,Briones; Jor-el Thomas Caparas,3,0,36,33
1657248868684,MATH 20B,A02,083757,Briones; Jor-el Thomas Caparas,1,0,36,35
1657248868684,MATH 20B,A03,093475,Briones; Jor-el Thomas Caparas,2,0,36,34
1657248874709,MATH 20C,A01,083760,Briones; Jor-el Thomas Caparas,1,0,35,34
1657248874709,MATH 20C,A02,083761,Briones; Jor-el Thomas Caparas,8,0,35,27
1657248874709,MATH 20C,A03,093476,Briones; Jor-el Thomas Caparas,0,1,36,36
1657248874709,MATH 20C,B01,083762,Bach; Quang Tran,1,0,30,29
1657248880730,MATH 20D,A01,083765,Tran; Brian Kha,4,0,30,26
1657248880730,MATH 20D,A02,083766,Tran; Brian Kha,5,0,30,25
1657248880730,MATH 20D,A03,083767,Tran; Brian Kha,4,0,30,26
1657248886754,MATH 20E,A01,083771,Ganguly; Soumya,7,0,32,25
1657248886754,MATH 20E,A02,083772,Ganguly; Soumya,7,0,32,25
1657248886754,MATH 20E,B01,083773,Ciotti; Benjamin,19,0,35,16
1657248886754,MATH 20E,B02,083774,Ciotti; Benjamin,17,0,35,18
1657248892776,MATH 103A,A01,083777,Greenfeld; Be'Eri,3,0,36,33
1657248892776,MATH 103A,A02,083778,Greenfeld; Be'Eri,5,0,36,31
1657248892776,MATH 103A,A03,093561,Greenfeld; Be'Eri,4,0,36,32
1657248892776,MATH 103A,B01,083779,Greenfeld; Be'Eri,6,0,36,30
1657248892776,MATH 103A,B02,083780,Greenfeld; Be'Eri,3,0,36,33
1657248892776,MATH 103A,B03,093562,Greenfeld; Be'Eri,3,0,36,33
1657248898809,MATH 105,A01,085443,Carter; Anne Toulson,15,0,35,20
1657248898809,MATH 105,A02,093477,Carter; Anne Toulson,20,0,35,15
1657248904838,MATH 109,A01,083213,Ganzberger; Geoffrey Michael,2,0,34,32
1657248904838,MATH 109,A02,083214,Ganzberger; Geoffrey Michael,4,0,34,30
1657248904838,MATH 109,A03,093478,Ganzberger; Geoffrey Michael,2,0,34,32
1657248904838,MATH 109,B01,083215,Ganzberger; Geoffrey Michael,1,0,32,31
1657248904838,MATH 109,B02,083216,Ganzberger; Geoffrey Michael,1,0,32,31
1657248904838,MATH 109,B03,093479,Ganzberger; Geoffrey Michael,8,0,32,24
1657248910860,MATH 142A,A01,083219,Chow; Bennett,6,0,32,26
1657248910860,MATH 142A,A02,083220,Chow; Bennett,10,0,32,22
1657248910860,MATH 142A,A03,093480,Chow; Bennett,7,0,32,25
1657248910860,MATH 142A,B03,093481,Chow; Bennett,8,0,32,24
1657248910860,MATH 142A,B04,093558,Chow; Bennett,12,0,32,20
1657248910860,MATH 142A,B05,093559,Chow; Bennett,6,0,32,26
1657248916890,MATH 193A,A01,083224,Rotar; Vladimir,7,0,34,27
1657248916890,MATH 193A,A02,083225,Rotar; Vladimir,6,0,34,28
1657248916890,MATH 193A,A03,083781,Rotar; Vladimir,2,0,34,32
1657248916890,MATH 193A,A04,083782,Rotar; Vladimir,8,0,34,26
1657248916890,MATH 193A,A05,093482,Rotar; Vladimir,6,0,34,28
1657248922917,MATH 197,001,091859,McAuley; Julian John,9999,0,9999,0
1657248922917,MATH 197,002,095566,Kedlaya; Kiran S.,9997,0,9999,2
1657248922917,MATH 197,003,095567,Xiao; Ming,9999,0,9999,0
1657248922917,MATH 197,004,095571,Perols; Johan Lars,9998,0,9999,1
1657248929971,COGS 9,A01,083615,Shannon; Kyle Michael,8,0,75,67
1657248935994,COGS 11,A01,083617,Boyle; Mary E. T.,22,0,48,26
1657248942016,COGS 13,A01,083071,Bastos; Amalia Pinkusfeld,8,0,71,63
1657248948041,COGS 14A,A01,092681,Semenuks; Arturs,2,1,100,98
1657248954066,COGS 14B,A01,083073,Cheng; Tzu-Han,6,0,63,57
1657248960101,COGS 17,A01,092677,Semenuks; Arturs,5,0,81,76
1657248966130,COGS 100,A01,083619,Allen; Michael Gordon,16,0,70,54
1657248972155,COGS 101A,A01,083621,Davis; Joshua Daniel,9,0,68,59
1657248978179,COGS 101B,A01,091572,Allen; Michael Gordon,11,0,65,54
1657248984203,COGS 101C,A01,083625,Delgado; Tania,17,0,35,18
1657248990232,COGS 107A,A01,083627,Boyle; Mary E. T.,13,0,60,47
1657248996258,COGS 118A,A01,083075,Gupta; Anjum,17,0,76,59
1657249002283,CSE 3,A50,083646,Miranda; Gregory Joseph,24,0,50,26
1657249008307,CSE 8A,A50,083650,Miranda; Gregory Joseph,17,1,56,39
1657249014341,CSE 11,A01,083080,Cao; Yingjun,5,15,40,35
1657249020374,CSE 12,A01,083652,Krause-Levy; Sophia Louisa,26,1,120,94
1657249026402,CSE 15L,A01,083654,Morris; Justin Loren,9,0,50,41
1657249026402,CSE 15L,A02,083655,Morris; Justin Loren,9,0,50,41
1657249032432,CSE 20,A01,083657,Tran; Khoa Dang,38,0,80,42
1657249038460,CSE 21,A01,095574,Bach; Quang Tran,22,0,48,26
1657249044494,CSE 30,A01,083084,Eldon; John,4,0,80,76
1657249044494,CSE 30,B01,095061,Bhaskar; Nishant,8,0,50,42
1657249050517,CSE 100,A01,083659,Cao; Yingjun,4,4,70,66
1657249056543,CSE 134B,A01,083661,Powell; Thomas Allan,21,0,100,79
1657249062565,CSE 140,A01,083663,Gungor; Onat,13,0,85,72
1657249068589,CSE 140L,A01,083088,Eldon; John,18,0,100,82
1657249074616,CSE 175,A01,083665,Kumar; Rakesh,3,0,25,22
1657249080641,CSE 190,A00,092507,Dubnov; Shlomo,7,0,20,13
1657249086663,ECE 45,A01,083139,Congero; Spencer William,5,0,75,70
1657249092693,ECE 65,A50,083695,Saad; Andrew S,12,0,30,18
1657249092693,ECE 65,A51,095125,Saad; Andrew S,25,0,26,1
1657249098725,ECE 109,A01,091882,Touri; Behrouz,19,0,70,51
1657249104748,ECE 180,A00,083140,Abi Samra; Nicholas Camill,1,0,30,29
1657249104748,ECE 180,B00,083141,Abi Samra; Nicholas Camill,0,0,30,30
1657249110770,MATH 10A,A01,083735,Patchell; Gregory David,2,0,30,28
1657249110770,MATH 10A,A02,083736,Patchell; Gregory David,20,0,30,10
1657249110770,MATH 10A,A03,083737,Patchell; Gregory David,16,0,30,14
1657249116796,MATH 10B,A01,083207,Lim; Seonhee,7,0,34,27
1657249116796,MATH 10B,A02,083208,Lim; Seonhee,9,0,35,26
1657249116796,MATH 10B,A03,093472,Lim; Seonhee,5,0,34,29
1657249116796,MATH 10B,B01,083739,Sinha; Shubham,11,0,30,19
1657249122827,MATH 18,A01,083743,Cinel; Cameron Alexander,6,0,30,24
1657249122827,MATH 18,A02,083744,Cinel; Cameron Alexander,17,0,30,13
1657249122827,MATH 18,A03,083745,Cinel; Cameron Alexander,8,0,30,22
1657249122827,MATH 18,B01,083748,Rideout; David Porter,4,0,37,33
1657249122827,MATH 18,B02,083749,Rideout; David Porter,4,0,36,32
1657249122827,MATH 18,B03,083750,Rideout; David Porter,2,0,37,35
1657249122827,MATH 18,B04,083751,Rideout; David Porter,6,0,36,30
1657249122827,MATH 18,B05,093473,Rideout; David Porter,5,0,36,31
1657249122827,MATH 18,B06,093474,Rideout; David Porter,5,0,36,31
1657249128855,MATH 20A,A01,083754,Zheng; Zequn,14,0,40,26
1657249134877,MATH 20B,A01,083756,Briones; Jor-el Thomas Caparas,3,0,36,33
1657249134877,MATH 20B,A02,083757,Briones; Jor-el Thomas Caparas,1,0,36,35
1657249134877,MATH 20B,A03,093475,Briones; Jor-el Thomas Caparas,2,0,36,34
1657249140900,MATH 20C,A01,083760,Briones; Jor-el Thomas Caparas,1,0,35,34
1657249140900,MATH 20C,A02,083761,Briones; Jor-el Thomas Caparas,8,0,35,27
1657249140900,MATH 20C,A03,093476,Briones; Jor-el Thomas Caparas,0,1,36,36
1657249140900,MATH 20C,B01,083762,Bach; Quang Tran,1,0,30,29
1657249146931,MATH 20D,A01,083765,Tran; Brian Kha,4,0,30,26
1657249146931,MATH 20D,A02,083766,Tran; Brian Kha,5,0,30,25
1657249146931,MATH 20D,A03,083767,Tran; Brian Kha,4,0,30,26
1657249152954,MATH 20E,A01,083771,Ganguly; Soumya,7,0,32,25
1657249152954,MATH 20E,A02,083772,Ganguly; Soumya,7,0,32,25
1657249152954,MATH 20E,B01,083773,Ciotti; Benjamin,19,0,35,16
1657249152954,MATH 20E,B02,083774,Ciotti; Benjamin,17,0,35,18
1657249158983,MATH 103A,A01,083777,Greenfeld; Be'Eri,3,0,36,33
1657249158983,MATH 103A,A02,083778,Greenfeld; Be'Eri,5,0,36,31
1657249158983,MATH 103A,A03,093561,Greenfeld; Be'Eri,4,0,36,32
1657249158983,MATH 103A,B01,083779,Greenfeld; Be'Eri,6,0,36,30
1657249158983,MATH 103A,B02,083780,Greenfeld; Be'Eri,3,0,36,33
1657249158983,MATH 103A,B03,093562,Greenfeld; Be'Eri,3,0,36,33
1657249165005,MATH 105,A01,085443,Carter; Anne Toulson,15,0,35,20
1657249165005,MATH 105,A02,093477,Carter; Anne Toulson,20,0,35,15
1657249171105,MATH 109,A01,083213,Ganzberger; Geoffrey Michael,2,0,34,32
1657249171105,MATH 109,A02,083214,Ganzberger; Geoffrey Michael,4,0,34,30
1657249171105,MATH 109,A03,093478,Ganzberger; Geoffrey Michael,2,0,34,32
1657249171105,MATH 109,B01,083215,Ganzberger; Geoffrey Michael,1,0,32,31
1657249171105,MATH 109,B02,083216,Ganzberger; Geoffrey Michael,1,0,32,31
1657249171105,MATH 109,B03,093479,Ganzberger; Geoffrey Michael,8,0,32,24
1657249177129,MATH 142A,A01,083219,Chow; Bennett,6,0,32,26
1657249177129,MATH 142A,A02,083220,Chow; Bennett,10,0,32,22
1657249177129,MATH 142A,A03,093480,Chow; Bennett,7,0,32,25
1657249177129,MATH 142A,B03,093481,Chow; Bennett,8,0,32,24
1657249177129,MATH 142A,B04,093558,Chow; Bennett,12,0,32,20
1657249177129,MATH 142A,B05,093559,Chow; Bennett,6,0,32,26
1657249183157,MATH 193A,A01,083224,Rotar; Vladimir,7,0,34,27
1657249183157,MATH 193A,A02,083225,Rotar; Vladimir,6,0,34,28
1657249183157,MATH 193A,A03,083781,Rotar; Vladimir,2,0,34,32
1657249183157,MATH 193A,A04,083782,Rotar; Vladimir,8,0,34,26
1657249183157,MATH 193A,A05,093482,Rotar; Vladimir,6,0,34,28
1657249189182,MATH 197,001,091859,McAuley; Julian John,9999,0,9999,0
1657249189182,MATH 197,002,095566,Kedlaya; Kiran S.,9997,0,9999,2
1657249189182,MATH 197,003,095567,Xiao; Ming,9999,0,9999,0
1657249189182,MATH 197,004,095571,Perols; Johan Lars,9998,0,9999,1
1657249196238,COGS 9,A01,083615,Shannon; Kyle Michael,8,0,75,67
1657249202261,COGS 11,A01,083617,Boyle; Mary E. T.,22,0,48,26
1657249208284,COGS 13,A01,083071,Bastos; Amalia Pinkusfeld,8,0,71,63
1657249214307,COGS 14A,A01,092681,Semenuks; Arturs,2,1,100,98
1657249220329,COGS 14B,A01,083073,Cheng; Tzu-Han,6,0,63,57
1657249226350,COGS 17,A01,092677,Semenuks; Arturs,5,0,81,76
1657249232372,COGS 100,A01,083619,Allen; Michael Gordon,16,0,70,54
1657249238400,COGS 101A,A01,083621,Davis; Joshua Daniel,9,0,68,59
1657249244424,COGS 101B,A01,091572,Allen; Michael Gordon,11,0,65,54
1657249250450,COGS 101C,A01,083625,Delgado; Tania,17,0,35,18
1657249256472,COGS 107A,A01,083627,Boyle; Mary E. T.,13,0,60,47
1657249262494,COGS 118A,A01,083075,Gupta; Anjum,17,0,76,59
1657249268523,CSE 3,A50,083646,Miranda; Gregory Joseph,24,0,50,26
1657249274549,CSE 8A,A50,083650,Miranda; Gregory Joseph,17,1,56,39
1657249280576,CSE 11,A01,083080,Cao; Yingjun,5,15,40,35
1657249286598,CSE 12,A01,083652,Krause-Levy; Sophia Louisa,26,1,120,94
1657249292624,CSE 15L,A01,083654,Morris; Justin Loren,9,0,50,41
1657249292624,CSE 15L,A02,083655,Morris; Justin Loren,9,0,50,41
1657249298647,CSE 20,A01,083657,Tran; Khoa Dang,38,0,80,42
1657249304671,CSE 21,A01,095574,Bach; Quang Tran,22,0,48,26
1657249310694,CSE 30,A01,083084,Eldon; John,4,0,80,76
1657249310694,CSE 30,B01,095061,Bhaskar; Nishant,8,0,50,42
1657249316718,CSE 100,A01,083659,Cao; Yingjun,4,4,70,66
1657249322745,CSE 134B,A01,083661,Powell; Thomas Allan,21,0,100,79
1657249328768,CSE 140,A01,083663,Gungor; Onat,13,0,85,72
1657249334791,CSE 140L,A01,083088,Eldon; John,18,0,100,82
1657249340813,CSE 175,A01,083665,Kumar; Rakesh,3,0,25,22
1657249346835,CSE 190,A00,092507,Dubnov; Shlomo,7,0,20,13
1657249352861,ECE 45,A01,083139,Congero; Spencer William,5,0,75,70
1657249358884,ECE 65,A50,083695,Saad; Andrew S,12,0,30,18
1657249358884,ECE 65,A51,095125,Saad; Andrew S,25,0,26,1
1657249364913,ECE 109,A01,091882,Touri; Behrouz,19,0,70,51
1657249370937,ECE 180,A00,083140,Abi Samra; Nicholas Camill,1,0,30,29
1657249370937,ECE 180,B00,083141,Abi Samra; Nicholas Camill,0,0,30,30
1657249376963,MATH 10A,A01,083735,Patchell; Gregory David,2,0,30,28
1657249376963,MATH 10A,A02,083736,Patchell; Gregory David,20,0,30,10
1657249376963,MATH 10A,A03,083737,Patchell; Gregory David,16,0,30,14
1657249382992,MATH 10B,A01,083207,Lim; Seonhee,7,0,34,27
1657249382992,MATH 10B,A02,083208,Lim; Seonhee,9,0,35,26
1657249382992,MATH 10B,A03,093472,Lim; Seonhee,5,0,34,29
1657249382992,MATH 10B,B01,083739,Sinha; Shubham,11,0,30,19
1657249389020,MATH 18,A01,083743,Cinel; Cameron Alexander,6,0,30,24
1657249389020,MATH 18,A02,083744,Cinel; Cameron Alexander,17,0,30,13
1657249389020,MATH 18,A03,083745,Cinel; Cameron Alexander,8,0,30,22
1657249389020,MATH 18,B01,083748,Rideout; David Porter,4,0,37,33
1657249389020,MATH 18,B02,083749,Rideout; David Porter,4,0,36,32
1657249389020,MATH 18,B03,083750,Rideout; David Porter,2,0,37,35
1657249389020,MATH 18,B04,083751,Rideout; David Porter,6,0,36,30
1657249389020,MATH 18,B05,093473,Rideout; David Porter,5,0,36,31
1657249389020,MATH 18,B06,093474,Rideout; David Porter,5,0,36,31
1657249395052,MATH 20A,A01,083754,Zheng; Zequn,14,0,40,26
1657249401078,MATH 20B,A01,083756,Briones; Jor-el Thomas Caparas,3,0,36,33
1657249401078,MATH 20B,A02,083757,Briones; Jor-el Thomas Caparas,1,0,36,35
1657249401078,MATH 20B,A03,093475,Briones; Jor-el Thomas Caparas,2,0,36,34
1657249407100,MATH 20C,A01,083760,Briones; Jor-el Thomas Caparas,1,0,35,34
1657249407100,MATH 20C,A02,083761,Briones; Jor-el Thomas Caparas,8,0,35,27
1657249407100,MATH 20C,A03,093476,Briones; Jor-el Thomas Caparas,0,1,36,36
1657249407100,MATH 20C,B01,083762,Bach; Quang Tran,1,0,30,29
1657249413128,MATH 20D,A01,083765,Tran; Brian Kha,4,0,30,26
1657249413128,MATH 20D,A02,083766,Tran; Brian Kha,5,0,30,25
1657249413128,MATH 20D,A03,083767,Tran; Brian Kha,4,0,30,26
1657249419150,MATH 20E,A01,083771,Ganguly; Soumya,7,0,32,25
1657249419150,MATH 20E,A02,083772,Ganguly; Soumya,7,0,32,25
1657249419150,MATH 20E,B01,083773,Ciotti; Benjamin,19,0,35,16
1657249419150,MATH 20E,B02,083774,Ciotti; Benjamin,17,0,35,18
1657249425178,MATH 103A,A01,083777,Greenfeld; Be'Eri,3,0,36,33
1657249425178,MATH 103A,A02,083778,Greenfeld; Be'Eri,5,0,36,31
1657249425178,MATH 103A,A03,093561,Greenfeld; Be'Eri,4,0,36,32
1657249425178,MATH 103A,B01,083779,Greenfeld; Be'Eri,6,0,36,30
1657249425178,MATH 103A,B02,083780,Greenfeld; Be'Eri,3,0,36,33
1657249425178,MATH 103A,B03,093562,Greenfeld; Be'Eri,3,0,36,33
1657249431205,MATH 105,A01,085443,Carter; Anne Toulson,15,0,35,20
1657249431205,MATH 105,A02,093477,Carter; Anne Toulson,20,0,35,15
1657249437228,MATH 109,A01,083213,Ganzberger; Geoffrey Michael,2,0,34,32
1657249437228,MATH 109,A02,083214,Ganzberger; Geoffrey Michael,4,0,34,30
1657249437228,MATH 109,A03,093478,Ganzberger; Geoffrey Michael,2,0,34,32
1657249437228,MATH 109,B01,083215,Ganzberger; Geoffrey Michael,1,0,32,31
1657249437228,MATH 109,B02,083216,Ganzberger; Geoffrey Michael,1,0,32,31
1657249437228,MATH 109,B03,093479,Ganzberger; Geoffrey Michael,8,0,32,24
1657249443279,MATH 142A,A01,083219,Chow; Bennett,6,0,32,26
1657249443279,MATH 142A,A02,083220,Chow; Bennett,10,0,32,22
1657249443279,MATH 142A,A03,093480,Chow; Bennett,7,0,32,25
1657249443279,MATH 142A,B03,093481,Chow; Bennett,8,0,32,24
1657249443279,MATH 142A,B04,093558,Chow; Bennett,12,0,32,20
1657249443279,MATH 142A,B05,093559,Chow; Bennett,6,0,32,26
1657249449307,MATH 193A,A01,083224,Rotar; Vladimir,7,0,34,27
1657249449307,MATH 193A,A02,083225,Rotar; Vladimir,6,0,34,28
1657249449307,MATH 193A,A03,083781,Rotar; Vladimir,2,0,34,32
1657249449307,MATH 193A,A04,083782,Rotar; Vladimir,8,0,34,26
1657249449307,MATH 193A,A05,093482,Rotar; Vladimir,6,0,34,28
1657249455334,MATH 197,001,091859,McAuley; Julian John,9999,0,9999,0
1657249455334,MATH 197,002,095566,Kedlaya; Kiran S.,9997,0,9999,2
1657249455334,MATH 197,003,095567,Xiao; Ming,9999,0,9999,0
1657249455334,MATH 197,004,095571,Perols; Johan Lars,9998,0,9999,1
1657249462392,COGS 9,A01,083615,Shannon; Kyle Michael,8,0,75,67
1657249468414,COGS 11,A01,083617,Boyle; Mary E. T.,22,0,48,26
1657249474441,COGS 13,A01,083071,Bastos; Amalia Pinkusfeld,8,0,71,63
1657249480463,COGS 14A,A01,092681,Semenuks; Arturs,2,1,100,98
1657249486491,COGS 14B,A01,083073,Cheng; Tzu-Han,6,0,63,57
1657249492515,COGS 17,A01,092677,Semenuks; Arturs,5,0,81,76
1657249498538,COGS 100,A01,083619,Allen; Michael Gordon,16,0,70,54
1657249504566,COGS 101A,A01,083621,Davis; Joshua Daniel,9,0,68,59
1657249510590,COGS 101B,A01,091572,Allen; Michael Gordon,11,0,65,54
1657249516619,COGS 101C,A01,083625,Delgado; Tania,17,0,35,18
1657249522642,COGS 107A,A01,083627,Boyle; Mary E. T.,13,0,60,47
1657249528665,COGS 118A,A01,083075,Gupta; Anjum,17,0,76,59
1657249534700,CSE 3,A50,083646,Miranda; Gregory Joseph,24,0,50,26
1657249540724,CSE 8A,A50,083650,Miranda; Gregory Joseph,17,1,56,39
1657249546782,CSE 11,A01,083080,Cao; Yingjun,5,15,40,35
1657249552803,CSE 12,A01,083652,Krause-Levy; Sophia Louisa,26,1,120,94
1657249558825,CSE 15L,A01,083654,Morris; Justin Loren,9,0,50,41
1657249558825,CSE 15L,A02,083655,Morris; Justin Loren,9,0,50,41
1657249564847,CSE 20,A01,083657,Tran; Khoa Dang,38,0,80,42
1657249570873,CSE 21,A01,095574,Bach; Quang Tran,22,0,48,26
1657249576901,CSE 30,A01,083084,Eldon; John,4,0,80,76
1657249576901,CSE 30,B01,095061,Bhaskar; Nishant,8,0,50,42
1657249582923,CSE 100,A01,083659,Cao; Yingjun,4,4,70,66
1657249588949,CSE 134B,A01,083661,Powell; Thomas Allan,21,0,100,79
1657249594975,CSE 140,A01,083663,Gungor; Onat,13,0,85,72
1657249601002,CSE 140L,A01,083088,Eldon; John,18,0,100,82
1657249607027,CSE 175,A01,083665,Kumar; Rakesh,3,0,25,22
1657249613055,CSE 190,A00,092507,Dubnov; Shlomo,7,0,20,13
1657249619078,ECE 45,A01,083139,Congero; Spencer William,5,0,75,70
1657249625106,ECE 65,A50,083695,Saad; Andrew S,12,0,30,18
1657249625106,ECE 65,A51,095125,Saad; Andrew S,25,0,26,1
1657249631133,ECE 109,A01,091882,Touri; Behrouz,19,0,70,51
1657249637157,ECE 180,A00,083140,Abi Samra; Nicholas Camill,1,0,30,29
1657249637157,ECE 180,B00,083141,Abi Samra; Nicholas Camill,0,0,30,30
1657249643185,MATH 10A,A01,083735,Patchell; Gregory David,2,0,30,28
1657249643185,MATH 10A,A02,083736,Patchell; Gregory David,20,0,30,10
1657249643185,MATH 10A,A03,083737,Patchell; Gregory David,16,0,30,14
1657249649208,MATH 10B,A01,083207,Lim; Seonhee,7,0,34,27
1657249649208,MATH 10B,A02,083208,Lim; Seonhee,9,0,35,26
1657249649208,MATH 10B,A03,093472,Lim; Seonhee,5,0,34,29
1657249649208,MATH 10B,B01,083739,Sinha; Shubham,11,0,30,19
1657249655233,MATH 18,A01,083743,Cinel; Cameron Alexander,6,0,30,24
1657249655233,MATH 18,A02,083744,Cinel; Cameron Alexander,17,0,30,13
1657249655233,MATH 18,A03,083745,Cinel; Cameron Alexander,8,0,30,22
1657249655233,MATH 18,B01,083748,Rideout; David Porter,4,0,37,33
1657249655233,MATH 18,B02,083749,Rideout; David Porter,4,0,36,32
1657249655233,MATH 18,B03,083750,Rideout; David Porter,2,0,37,35
1657249655233,MATH 18,B04,083751,Rideout; David Porter,6,0,36,30
1657249655233,MATH 18,B05,093473,Rideout; David Porter,5,0,36,31
1657249655233,MATH 18,B06,093474,Rideout; David Porter,5,0,36,31
1657249661257,MATH 20A,A01,083754,Zheng; Zequn,14,0,40,26
1657249667284,MATH 20B,A01,083756,Briones; Jor-el Thomas Caparas,3,0,36,33
1657249667284,MATH 20B,A02,083757,Briones; Jor-el Thomas Caparas,1,0,36,35
1657249667284,MATH 20B,A03,093475,Briones; Jor-el Thomas Caparas,2,0,36,34
1657249673312,MATH 20C,A01,083760,Briones; Jor-el Thomas Caparas,1,0,35,34
1657249673312,MATH 20C,A02,083761,Briones; Jor-el Thomas Caparas,8,0,35,27
1657249673312,MATH 20C,A03,093476,Briones; Jor-el Thomas Caparas,0,1,36,36
1657249673312,MATH 20C,B01,083762,Bach; Quang Tran,1,0,30,29
1657249679336,MATH 20D,A01,083765,Tran; Brian Kha,4,0,30,26
1657249679336,MATH 20D,A02,083766,Tran; Brian Kha,5,0,30,25
1657249679336,MATH 20D,A03,083767,Tran; Brian Kha,4,0,30,26
1657249685361,MATH 20E,A01,083771,Ganguly; Soumya,7,0,32,25
1657249685361,MATH 20E,A02,083772,Ganguly; Soumya,7,0,32,25
1657249685361,MATH 20E,B01,083773,Ciotti; Benjamin,19,0,35,16
1657249685361,MATH 20E,B02,083774,Ciotti; Benjamin,17,0,35,18
1657249691389,MATH 103A,A01,083777,Greenfeld; Be'Eri,3,0,36,33
1657249691389,MATH 103A,A02,083778,Greenfeld; Be'Eri,5,0,36,31
1657249691389,MATH 103A,A03,093561,Greenfeld; Be'Eri,4,0,36,32
1657249691389,MATH 103A,B01,083779,Greenfeld; Be'Eri,6,0,36,30
1657249691389,MATH 103A,B02,083780,Greenfeld; Be'Eri,3,0,36,33
1657249691389,MATH 103A,B03,093562,Greenfeld; Be'Eri,3,0,36,33
1657249697415,MATH 105,A01,085443,Carter; Anne Toulson,15,0,35,20
1657249697415,MATH 105,A02,093477,Carter; Anne Toulson,20,0,35,15
1657249703444,MATH 109,A01,083213,Ganzberger; Geoffrey Michael,2,0,34,32
1657249703444,MATH 109,A02,083214,Ganzberger; Geoffrey Michael,4,0,34,30
1657249703444,MATH 109,A03,093478,Ganzberger; Geoffrey Michael,2,0,34,32
1657249703444,MATH 109,B01,083215,Ganzberger; Geoffrey Michael,1,0,32,31
1657249703444,MATH 109,B02,083216,Ganzberger; Geoffrey Michael,1,0,32,31
1657249703444,MATH 109,B03,093479,Ganzberger; Geoffrey Michael,8,0,32,24
1657249709470,MATH 142A,A01,083219,Chow; Bennett,6,0,32,26
1657249709470,MATH 142A,A02,083220,Chow; Bennett,10,0,32,22
1657249709470,MATH 142A,A03,093480,Chow; Bennett,7,0,32,25
1657249709470,MATH 142A,B03,093481,Chow; Bennett,8,0,32,24
1657249709470,MATH 142A,B04,093558,Chow; Bennett,12,0,32,20
1657249709470,MATH 142A,B05,093559,Chow; Bennett,6,0,32,26
1657249715494,MATH 193A,A01,083224,Rotar; Vladimir,7,0,34,27
1657249715494,MATH 193A,A02,083225,Rotar; Vladimir,6,0,34,28
1657249715494,MATH 193A,A03,083781,Rotar; Vladimir,2,0,34,32
1657249715494,MATH 193A,A04,083782,Rotar; Vladimir,8,0,34,26
1657249715494,MATH 193A,A05,093482,Rotar; Vladimir,6,0,34,28
1657249721517,MATH 197,001,091859,McAuley; Julian John,9999,0,9999,0
1657249721517,MATH 197,002,095566,Kedlaya; Kiran S.,9997,0,9999,2
1657249721517,MATH 197,003,095567,Xiao; Ming,9999,0,9999,0
1657249721517,MATH 197,004,095571,Perols; Johan Lars,9998,0,9999,1
1657249728582,COGS 9,A01,083615,Shannon; Kyle Michael,8,0,75,67
1657249734606,COGS 11,A01,083617,Boyle; Mary E. T.,22,0,48,26
1657249740647,COGS 13,A01,083071,Bastos; Amalia Pinkusfeld,8,0,71,63
1657249746669,COGS 14A,A01,092681,Semenuks; Arturs,2,1,100,98
1657249752692,COGS 14B,A01,083073,Cheng; Tzu-Han,6,0,63,57
1657249758730,COGS 17,A01,092677,Semenuks; Arturs,5,0,81,76
1657249764825,COGS 100,A01,083619,Allen; Michael Gordon,16,0,70,54
1657249770850,COGS 101A,A01,083621,Davis; Joshua Daniel,9,0,68,59
1657249776877,COGS 101B,A01,091572,Allen; Michael Gordon,11,0,65,54
1657249782907,COGS 101C,A01,083625,Delgado; Tania,17,0,35,18
1657249788938,COGS 107A,A01,083627,Boyle; Mary E. T.,13,0,60,47
1657249794962,COGS 118A,A01,083075,Gupta; Anjum,17,0,76,59
1657249800986,CSE 3,A50,083646,Miranda; Gregory Joseph,24,0,50,26
1657249807008,CSE 8A,A50,083650,Miranda; Gregory Joseph,17,1,56,39
1657249813037,CSE 11,A01,083080,Cao; Yingjun,5,15,40,35
1657249819061,CSE 12,A01,083652,Krause-Levy; Sophia Louisa,26,1,120,94
1657249825090,CSE 15L,A01,083654,Morris; Justin Loren,9,0,50,41
1657249825090,CSE 15L,A02,083655,Morris; Justin Loren,9,0,50,41
1657249831113,CSE 20,A01,083657,Tran; Khoa Dang,38,0,80,42
1657249837141,CSE 21,A01,095574,Bach; Quang Tran,22,0,48,26
1657249843163,CSE 30,A01,083084,Eldon; John,4,0,80,76
1657249843163,CSE 30,B01,095061,Bhaskar; Nishant,8,0,50,42
1657249849187,CSE 100,A01,083659,Cao; Yingjun,4,4,70,66
1657249855218,CSE 134B,A01,083661,Powell; Thomas Allan,21,0,100,79
1657249861246,CSE 140,A01,083663,Gungor; Onat,13,0,85,72
1657249867271,CSE 140L,A01,083088,Eldon; John,18,0,100,82
1657249873295,CSE 175,A01,083665,Kumar; Rakesh,3,0,25,22
1657249879317,CSE 190,A00,092507,Dubnov; Shlomo,7,0,20,13
1657249885344,ECE 45,A01,083139,Congero; Spencer William,5,0,75,70
1657249891366,ECE 65,A50,083695,Saad; Andrew S,12,0,30,18
1657249891366,ECE 65,A51,095125,Saad; Andrew S,25,0,26,1
1657249897389,ECE 109,A01,091882,Touri; Behrouz,19,0,70,51
1657249903416,ECE 180,A00,083140,Abi Samra; Nicholas Camill,1,0,30,29
1657249903416,ECE 180,B00,083141,Abi Samra; Nicholas Camill,0,0,30,30
1657249909440,MATH 10A,A01,083735,Patchell; Gregory David,2,0,30,28
1657249909440,MATH 10A,A02,083736,Patchell; Gregory David,20,0,30,10
1657249909440,MATH 10A,A03,083737,Patchell; Gregory David,16,0,30,14
1657249915463,MATH 10B,A01,083207,Lim; Seonhee,7,0,34,27
1657249915463,MATH 10B,A02,083208,Lim; Seonhee,9,0,35,26
1657249915463,MATH 10B,A03,093472,Lim; Seonhee,5,0,34,29
1657249915463,MATH 10B,B01,083739,Sinha; Shubham,11,0,30,19
1657249921495,MATH 18,A01,083743,Cinel; Cameron Alexander,6,0,30,24
1657249921495,MATH 18,A02,083744,Cinel; Cameron Alexander,17,0,30,13
1657249921495,MATH 18,A03,083745,Cinel; Cameron Alexander,8,0,30,22
1657249921495,MATH 18,B01,083748,Rideout; David Porter,4,0,37,33
1657249921495,MATH 18,B02,083749,Rideout; David Porter,4,0,36,32
1657249921495,MATH 18,B03,083750,Rideout; David Porter,2,0,37,35
1657249921495,MATH 18,B04,083751,Rideout; David Porter,6,0,36,30
1657249921495,MATH 18,B05,093473,Rideout; David Porter,5,0,36,31
1657249921495,MATH 18,B06,093474,Rideout; David Porter,5,0,36,31
1657249927520,MATH 20A,A01,083754,Zheng; Zequn,14,0,40,26
1657249933559,MATH 20B,A01,083756,Briones; Jor-el Thomas Caparas,3,0,36,33
1657249933559,MATH 20B,A02,083757,Briones; Jor-el Thomas Caparas,1,0,36,35
1657249933559,MATH 20B,A03,093475,Briones; Jor-el Thomas Caparas,2,0,36,34
1657249939590,MATH 20C,A01,083760,Briones; Jor-el Thomas Caparas,1,0,35,34
1657249939590,MATH 20C,A02,083761,Briones; Jor-el Thomas Caparas,8,0,35,27
1657249939590,MATH 20C,A03,093476,Briones; Jor-el Thomas Caparas,0,1,36,36
1657249939590,MATH 20C,B01,083762,Bach; Quang Tran,1,0,30,29
1657249945617,MATH 20D,A01,083765,Tran; Brian Kha,4,0,30,26
1657249945617,MATH 20D,A02,083766,Tran; Brian Kha,5,0,30,25
1657249945617,MATH 20D,A03,083767,Tran; Brian Kha,4,0,30,26
1657249951648,MATH 20E,A01,083771,Ganguly; Soumya,7,0,32,25
1657249951648,MATH 20E,A02,083772,Ganguly; Soumya,7,0,32,25
1657249951648,MATH 20E,B01,083773,Ciotti; Benjamin,19,0,35,16
1657249951648,MATH 20E,B02,083774,Ciotti; Benjamin,17,0,35,18
1657249957671,MATH 103A,A01,083777,Greenfeld; Be'Eri,3,0,36,33
1657249957671,MATH 103A,A02,083778,Greenfeld; Be'Eri,5,0,36,31
1657249957671,MATH 103A,A03,093561,Greenfeld; Be'Eri,4,0,36,32
1657249957671,MATH 103A,B01,083779,Greenfeld; Be'Eri,6,0,36,30
1657249957671,MATH 103A,B02,083780,Greenfeld; Be'Eri,3,0,36,33
1657249957671,MATH 103A,B03,093562,Greenfeld; Be'Eri,3,0,36,33
1657249963699,MATH 105,A01,085443,Carter; Anne Toulson,15,0,35,20
1657249963699,MATH 105,A02,093477,Carter; Anne Toulson,20,0,35,15
1657249969722,MATH 109,A01,083213,Ganzberger; Geoffrey Michael,2,0,34,32
1657249969722,MATH 109,A02,083214,Ganzberger; Geoffrey Michael,4,0,34,30
1657249969722,MATH 109,A03,093478,Ganzberger; Geoffrey Michael,2,0,34,32
1657249969722,MATH 109,B01,083215,Ganzberger; Geoffrey Michael,1,0,32,31
1657249969722,MATH 109,B02,083216,Ganzberger; Geoffrey Michael,1,0,32,31
1657249969722,MATH 109,B03,093479,Ganzberger; Geoffrey Michael,8,0,32,24
1657249975752,MATH 142A,A01,083219,Chow; Bennett,6,0,32,26
1657249975752,MATH 142A,A02,083220,Chow; Bennett,10,0,32,22
1657249975752,MATH 142A,A03,093480,Chow; Bennett,7,0,32,25
1657249975752,MATH 142A,B03,093481,Chow; Bennett,8,0,32,24
1657249975752,MATH 142A,B04,093558,Chow; Bennett,12,0,32,20
1657249975752,MATH 142A,B05,093559,Chow; Bennett,6,0,32,26
1657249981776,MATH 193A,A01,083224,Rotar; Vladimir,7,0,34,27
1657249981776,MATH 193A,A02,083225,Rotar; Vladimir,6,0,34,28
1657249981776,MATH 193A,A03,083781,Rotar; Vladimir,2,0,34,32
1657249981776,MATH 193A,A04,083782,Rotar; Vladimir,8,0,34,26
1657249981776,MATH 193A,A05,093482,Rotar; Vladimir,6,0,34,28
1657249987809,MATH 197,001,091859,McAuley; Julian John,9999,0,9999,0
1657249987809,MATH 197,002,095566,Kedlaya; Kiran S.,9997,0,9999,2
1657249987809,MATH 197,003,095567,Xiao; Ming,9999,0,9999,0
1657249987809,MATH 197,004,095571,Perols; Johan Lars,9998,0,9999,1
1657249994869,COGS 9,A01,083615,Shannon; Kyle Michael,8,0,75,67
1657250000891,COGS 11,A01,083617,Boyle; Mary E. T.,22,0,48,26
1657250006915,COGS 13,A01,083071,Bastos; Amalia Pinkusfeld,8,0,71,63
1657250012939,COGS 14A,A01,092681,Semenuks; Arturs,2,1,100,98
1657250018970,COGS 14B,A01,083073,Cheng; Tzu-Han,6,0,63,57
1657250024993,COGS 17,A01,092677,Semenuks; Arturs,5,0,81,76
1657250031020,COGS 100,A01,083619,Allen; Michael Gordon,16,0,70,54
1657250037044,COGS 101A,A01,083621,Davis; Joshua Daniel,9,0,68,59
1657250043067,COGS 101B,A01,091572,Allen; Michael Gordon,11,0,65,54
1657250049089,COGS 101C,A01,083625,Delgado; Tania,17,0,35,18
1657250055120,COGS 107A,A01,083627,Boyle; Mary E. T.,13,0,60,47
1657250061144,COGS 118A,A01,083075,Gupta; Anjum,17,0,76,59
1657250067171,CSE 3,A50,083646,Miranda; Gregory Joseph,24,0,50,26
1657250073194,CSE 8A,A50,083650,Miranda; Gregory Joseph,17,1,56,39
1657250079220,CSE 11,A01,083080,Cao; Yingjun,5,15,40,35
1657250085244,CSE 12,A01,083652,Krause-Levy; Sophia Louisa,26,1,120,94
1657250091273,CSE 15L,A01,083654,Morris; Justin Loren,9,0,50,41
1657250091273,CSE 15L,A02,083655,Morris; Justin Loren,9,0,50,41
1657250097296,CSE 20,A01,083657,Tran; Khoa Dang,38,0,80,42
1657250103330,CSE 21,A01,095574,Bach; Quang Tran,22,0,48,26
1657250109354,CSE 30,A01,083084,Eldon; John,4,0,80,76
1657250109354,CSE 30,B01,095061,Bhaskar; Nishant,8,0,50,42
1657250115375,CSE 100,A01,083659,Cao; Yingjun,4,4,70,66
1657250121398,CSE 134B,A01,083661,Powell; Thomas Allan,21,0,100,79
1657250127426,CSE 140,A01,083663,Gungor; Onat,13,0,85,72
1657250133451,CSE 140L,A01,083088,Eldon; John,18,0,100,82
1657250139478,CSE 175,A01,083665,Kumar; Rakesh,3,0,25,22
1657250145503,CSE 190,A00,092507,Dubnov; Shlomo,7,0,20,13
1657250151527,ECE 45,A01,083139,Congero; Spencer William,5,0,75,70
1657250157558,ECE 65,A50,083695,Saad; Andrew S,12,0,30,18
1657250157558,ECE 65,A51,095125,Saad; Andrew S,25,0,26,1
1657250163579,ECE 109,A01,091882,Touri; Behrouz,19,0,70,51
1657250169606,ECE 180,A00,083140,Abi Samra; Nicholas Camill,1,0,30,29
1657250169606,ECE 180,B00,083141,Abi Samra; Nicholas Camill,0,0,30,30
1657250175634,MATH 10A,A01,083735,Patchell; Gregory David,2,0,30,28
1657250175634,MATH 10A,A02,083736,Patchell; Gregory David,20,0,30,10
1657250175634,MATH 10A,A03,083737,Patchell; Gregory David,16,0,30,14
1657250181671,MATH 10B,A01,083207,Lim; Seonhee,7,0,34,27
1657250181671,MATH 10B,A02,083208,Lim; Seonhee,9,0,35,26
1657250181671,MATH 10B,A03,093472,Lim; Seonhee,5,0,34,29
1657250181671,MATH 10B,B01,083739,Sinha; Shubham,11,0,30,19
1657250187697,MATH 18,A01,083743,Cinel; Cameron Alexander,6,0,30,24
1657250187697,MATH 18,A02,083744,Cinel; Cameron Alexander,17,0,30,13
1657250187697,MATH 18,A03,083745,Cinel; Cameron Alexander,8,0,30,22
1657250187697,MATH 18,B01,083748,Rideout; David Porter,4,0,37,33
1657250187697,MATH 18,B02,083749,Rideout; David Porter,4,0,36,32
1657250187697,MATH 18,B03,083750,Rideout; David Porter,2,0,37,35
1657250187697,MATH 18,B04,083751,Rideout; David Porter,6,0,36,30
1657250187697,MATH 18,B05,093473,Rideout; David Porter,5,0,36,31
1657250187697,MATH 18,B06,093474,Rideout; David Porter,5,0,36,31
1657250193719,MATH 20A,A01,083754,Zheng; Zequn,14,0,40,26
1657250199748,MATH 20B,A01,083756,Briones; Jor-el Thomas Caparas,3,0,36,33
1657250199748,MATH 20B,A02,083757,Briones; Jor-el Thomas Caparas,1,0,36,35
1657250199748,MATH 20B,A03,093475,Briones; Jor-el Thomas Caparas,2,0,36,34
1657250205775,MATH 20C,A01,083760,Briones; Jor-el Thomas Caparas,1,0,35,34
1657250205775,MATH 20C,A02,083761,Briones; Jor-el Thomas Caparas,8,0,35,27
1657250205775,MATH 20C,A03,093476,Briones; Jor-el Thomas Caparas,0,1,36,36
1657250205775,MATH 20C,B01,083762,Bach; Quang Tran,1,0,30,29
1657250211804,MATH 20D,A01,083765,Tran; Brian Kha,4,0,30,26
1657250211804,MATH 20D,A02,083766,Tran; Brian Kha,5,0,30,25
1657250211804,MATH 20D,A03,083767,Tran; Brian Kha,4,0,30,26
1657250217829,MATH 20E,A01,083771,Ganguly; Soumya,7,0,32,25
1657250217829,MATH 20E,A02,083772,Ganguly; Soumya,7,0,32,25
1657250217829,MATH 20E,B01,083773,Ciotti; Benjamin,19,0,35,16
1657250217829,MATH 20E,B02,083774,Ciotti; Benjamin,17,0,35,18
1657250223870,MATH 103A,A01,083777,Greenfeld; Be'Eri,3,0,36,33
1657250223870,MATH 103A,A02,083778,Greenfeld; Be'Eri,5,0,36,31
1657250223870,MATH 103A,A03,093561,Greenfeld; Be'Eri,4,0,36,32
1657250223870,MATH 103A,B01,083779,Greenfeld; Be'Eri,6,0,36,30
1657250223870,MATH 103A,B02,083780,Greenfeld; Be'Eri,3,0,36,33
1657250223870,MATH 103A,B03,093562,Greenfeld; Be'Eri,3,0,36,33
1657250229893,MATH 105,A01,085443,Carter; Anne Toulson,15,0,35,20
1657250229893,MATH 105,A02,093477,Carter; Anne Toulson,20,0,35,15
1657250235916,MATH 109,A01,083213,Ganzberger; Geoffrey Michael,2,0,34,32
1657250235916,MATH 109,A02,083214,Ganzberger; Geoffrey Michael,4,0,34,30
1657250235916,MATH 109,A03,093478,Ganzberger; Geoffrey Michael,2,0,34,32
1657250235916,MATH 109,B01,083215,Ganzberger; Geoffrey Michael,1,0,32,31
1657250235916,MATH 109,B02,083216,Ganzberger; Geoffrey Michael,1,0,32,31
1657250235916,MATH 109,B03,093479,Ganzberger; Geoffrey Michael,8,0,32,24
1657250241939,MATH 142A,A01,083219,Chow; Bennett,6,0,32,26
1657250241939,MATH 142A,A02,083220,Chow; Bennett,10,0,32,22
1657250241939,MATH 142A,A03,093480,Chow; Bennett,7,0,32,25
1657250241939,MATH 142A,B03,093481,Chow; Bennett,8,0,32,24
1657250241939,MATH 142A,B04,093558,Chow; Bennett,12,0,32,20
1657250241939,MATH 142A,B05,093559,Chow; Bennett,6,0,32,26
1657250247966,MATH 193A,A01,083224,Rotar; Vladimir,7,0,34,27
1657250247966,MATH 193A,A02,083225,Rotar; Vladimir,6,0,34,28
1657250247966,MATH 193A,A03,083781,Rotar; Vladimir,2,0,34,32
1657250247966,MATH 193A,A04,083782,Rotar; Vladimir,8,0,34,26
1657250247966,MATH 193A,A05,093482,Rotar; Vladimir,6,0,34,28
1657250253989,MATH 197,001,091859,McAuley; Julian John,9999,0,9999,0
1657250253989,MATH 197,002,095566,Kedlaya; Kiran S.,9997,0,9999,2
1657250253989,MATH 197,003,095567,Xiao; Ming,9999,0,9999,0
1657250253989,MATH 197,004,095571,Perols; Johan Lars,9998,0,9999,1
1657250261054,COGS 9,A01,083615,Shannon; Kyle Michael,8,0,75,67
1657250267081,COGS 11,A01,083617,Boyle; Mary E. T.,22,0,48,26
1657250273105,COGS 13,A01,083071,Bastos; Amalia Pinkusfeld,8,0,71,63
1657250279135,COGS 14A,A01,092681,Semenuks; Arturs,2,1,100,98
1657250285158,COGS 14B,A01,083073,Cheng; Tzu-Han,6,0,63,57
1657250291182,COGS 17,A01,092677,Semenuks; Arturs,5,0,81,76
1657250297224,COGS 100,A01,083619,Allen; Michael Gordon,16,0,70,54
1657250303251,COGS 101A,A01,083621,Davis; Joshua Daniel,9,0,68,59
1657250309276,COGS 101B,A01,091572,Allen; Michael Gordon,11,0,65,54
1657250315305,COGS 101C,A01,083625,Delgado; Tania,17,0,35,18
1657250321328,COGS 107A,A01,083627,Boyle; Mary E. T.,13,0,60,47
1657250327356,COGS 118A,A01,083075,Gupta; Anjum,17,0,76,59
1657250333385,CSE 3,A50,083646,Miranda; Gregory Joseph,24,0,50,26
1657250339416,CSE 8A,A50,083650,Miranda; Gregory Joseph,17,1,56,39
1657250345439,CSE 11,A01,083080,Cao; Yingjun,5,15,40,35
1657250351466,CSE 12,A01,083652,Krause-Levy; Sophia Louisa,26,1,120,94
1657250357489,CSE 15L,A01,083654,Morris; Justin Loren,9,0,50,41
1657250357489,CSE 15L,A02,083655,Morris; Justin Loren,9,0,50,41
1657250363588,CSE 20,A01,083657,Tran; Khoa Dang,38,0,80,42
1657250369616,CSE 21,A01,095574,Bach; Quang Tran,22,0,48,26
1657250375645,CSE 30,A01,083084,Eldon; John,4,0,80,76
1657250375645,CSE 30,B01,095061,Bhaskar; Nishant,8,0,50,42
1657250381668,CSE 100,A01,083659,Cao; Yingjun,4,4,70,66
1657250387692,CSE 134B,A01,083661,Powell; Thomas Allan,21,0,100,79
1657250393716,CSE 140,A01,083663,Gungor; Onat,13,0,85,72
1657250399739,CSE 140L,A01,083088,Eldon; John,18,0,100,82
1657250405769,CSE 175,A01,083665,Kumar; Rakesh,3,0,25,22
1657250411793,CSE 190,A00,092507,Dubnov; Shlomo,7,0,20,13
1657250417817,ECE 45,A01,083139,Congero; Spencer William,5,0,75,70
1657250423842,ECE 65,A50,083695,Saad; Andrew S,12,0,30,18
1657250423842,ECE 65,A51,095125,Saad; Andrew S,25,0,26,1
1657250429866,ECE 109,A01,091882,Touri; Behrouz,19,0,70,51
1657250435889,ECE 180,A00,083140,Abi Samra; Nicholas Camill,1,0,30,29
1657250435889,ECE 180,B00,083141,Abi Samra; Nicholas Camill,0,0,30,30
1657250441912,MATH 10A,A01,083735,Patchell; Gregory David,2,0,30,28
1657250441912,MATH 10A,A02,083736,Patchell; Gregory David,20,0,30,10
1657250441912,MATH 10A,A03,083737,Patchell; Gregory David,16,0,30,14
1657250447941,MATH 10B,A01,083207,Lim; Seonhee,7,0,34,27
1657250447941,MATH 10B,A02,083208,Lim; Seonhee,9,0,35,26
1657250447941,MATH 10B,A03,093472,Lim; Seonhee,5,0,34,29
1657250447941,MATH 10B,B01,083739,Sinha; Shubham,11,0,30,19
1657250453965,MATH 18,A01,083743,Cinel; Cameron Alexander,6,0,30,24
1657250453965,MATH 18,A02,083744,Cinel; Cameron Alexander,17,0,30,13
1657250453965,MATH 18,A03,083745,Cinel; Cameron Alexander,8,0,30,22
1657250453965,MATH 18,B01,083748,Rideout; David Porter,4,0,37,33
1657250453965,MATH 18,B02,083749,Rideout; David Porter,4,0,36,32
1657250453965,MATH 18,B03,083750,Rideout; David Porter,2,0,37,35
1657250453965,MATH 18,B04,083751,Rideout; David Porter,6,0,36,30
1657250453965,MATH 18,B05,093473,Rideout; David Porter,5,0,36,31
1657250453965,MATH 18,B06,093474,Rideout; David Porter,5,0,36,31
1657250459991,MATH 20A,A01,083754,Zheng; Zequn,14,0,40,26
1657250466013,MATH 20B,A01,083756,Briones; Jor-el Thomas Caparas,3,0,36,33
1657250466013,MATH 20B,A02,083757,Briones; Jor-el Thomas Caparas,1,0,36,35
1657250466013,MATH 20B,A03,093475,Briones; Jor-el Thomas Caparas,2,0,36,34
1657250472037,MATH 20C,A01,083760,Briones; Jor-el Thomas Caparas,1,0,35,34
1657250472037,MATH 20C,A02,083761,Briones; Jor-el Thomas Caparas,8,0,35,27
1657250472037,MATH 20C,A03,093476,Briones; Jor-el Thomas Caparas,0,1,36,36
1657250472037,MATH 20C,B01,083762,Bach; Quang Tran,1,0,30,29
1657250478067,MATH 20D,A01,083765,Tran; Brian Kha,4,0,30,26
1657250478067,MATH 20D,A02,083766,Tran; Brian Kha,5,0,30,25
1657250478067,MATH 20D,A03,083767,Tran; Brian Kha,4,0,30,26
1657250484089,MATH 20E,A01,083771,Ganguly; Soumya,7,0,32,25
1657250484089,MATH 20E,A02,083772,Ganguly; Soumya,7,0,32,25
1657250484089,MATH 20E,B01,083773,Ciotti; Benjamin,19,0,35,16
1657250484089,MATH 20E,B02,083774,Ciotti; Benjamin,17,0,35,18
1657250490114,MATH 103A,A01,083777,Greenfeld; Be'Eri,3,0,36,33
1657250490114,MATH 103A,A02,083778,Greenfeld; Be'Eri,5,0,36,31
1657250490114,MATH 103A,A03,093561,Greenfeld; Be'Eri,4,0,36,32
1657250490114,MATH 103A,B01,083779,Greenfeld; Be'Eri,6,0,36,30
1657250490114,MATH 103A,B02,083780,Greenfeld; Be'Eri,3,0,36,33
1657250490114,MATH 103A,B03,093562,Greenfeld; Be'Eri,3,0,36,33
1657250496140,MATH 105,A01,085443,Carter; Anne Toulson,15,0,35,20
1657250496140,MATH 105,A02,093477,Carter; Anne Toulson,20,0,35,15
1657250502183,MATH 109,A01,083213,Ganzberger; Geoffrey Michael,2,0,34,32
1657250502183,MATH 109,A02,083214,Ganzberger; Geoffrey Michael,4,0,34,30
1657250502183,MATH 109,A03,093478,Ganzberger; Geoffrey Michael,2,0,34,32
1657250502183,MATH 109,B01,083215,Ganzberger; Geoffrey Michael,1,0,32,31
1657250502183,MATH 109,B02,083216,Ganzberger; Geoffrey Michael,1,0,32,31
1657250502183,MATH 109,B03,093479,Ganzberger; Geoffrey Michael,8,0,32,24
1657250508211,MATH 142A,A01,083219,Chow; Bennett,6,0,32,26
1657250508211,MATH 142A,A02,083220,Chow; Bennett,10,0,32,22
1657250508211,MATH 142A,A03,093480,Chow; Bennett,7,0,32,25
1657250508211,MATH 142A,B03,093481,Chow; Bennett,8,0,32,24
1657250508211,MATH 142A,B04,093558,Chow; Bennett,12,0,32,20
1657250508211,MATH 142A,B05,093559,Chow; Bennett,6,0,32,26
1657250514239,MATH 193A,A01,083224,Rotar; Vladimir,7,0,34,27
1657250514239,MATH 193A,A02,083225,Rotar; Vladimir,6,0,34,28
1657250514239,MATH 193A,A03,083781,Rotar; Vladimir,2,0,34,32
1657250514239,MATH 193A,A04,083782,Rotar; Vladimir,8,0,34,26
1657250514239,MATH 193A,A05,093482,Rotar; Vladimir,6,0,34,28
1657250520263,MATH 197,001,091859,McAuley; Julian John,9999,0,9999,0
1657250520263,MATH 197,002,095566,Kedlaya; Kiran S.,9997,0,9999,2
1657250520263,MATH 197,003,095567,Xiao; Ming,9999,0,9999,0
1657250520263,MATH 197,004,095571,Perols; Johan Lars,9998,0,9999,1
1657250527328,COGS 9,A01,083615,Shannon; Kyle Michael,8,0,75,67
1657250533351,COGS 11,A01,083617,Boyle; Mary E. T.,22,0,48,26
1657250539378,COGS 13,A01,083071,Bastos; Amalia Pinkusfeld,8,0,71,63
1657250545402,COGS 14A,A01,092681,Semenuks; Arturs,2,1,100,98
1657250551426,COGS 14B,A01,083073,Cheng; Tzu-Han,6,0,63,57
1657250557453,COGS 17,A01,092677,Semenuks; Arturs,5,0,81,76
1657250563477,COGS 100,A01,083619,Allen; Michael Gordon,16,0,70,54
1657250569500,COGS 101A,A01,083621,Davis; Joshua Daniel,9,0,68,59
1657250575521,COGS 101B,A01,091572,Allen; Michael Gordon,11,0,65,54
1657250581547,COGS 101C,A01,083625,Delgado; Tania,17,0,35,18
1657250587571,COGS 107A,A01,083627,Boyle; Mary E. T.,13,0,60,47
1657250593592,COGS 118A,A01,083075,Gupta; Anjum,17,0,76,59
1657250599616,CSE 3,A50,083646,Miranda; Gregory Joseph,24,0,50,26
1657250605642,CSE 8A,A50,083650,Miranda; Gregory Joseph,17,1,56,39
1657250611677,CSE 11,A01,083080,Cao; Yingjun,5,15,40,35
1657250617704,CSE 12,A01,083652,Krause-Levy; Sophia Louisa,26,1,120,94
1657250623735,CSE 15L,A01,083654,Morris; Justin Loren,9,0,50,41
1657250623735,CSE 15L,A02,083655,Morris; Justin Loren,9,0,50,41
1657250629765,CSE 20,A01,083657,Tran; Khoa Dang,38,0,80,42
1657250635787,CSE 21,A01,095574,Bach; Quang Tran,22,0,48,26
1657250641810,CSE 30,A01,083084,Eldon; John,4,0,80,76
1657250641810,CSE 30,B01,095061,Bhaskar; Nishant,8,0,50,42
1657250647837,CSE 100,A01,083659,Cao; Yingjun,4,4,70,66
1657250653864,CSE 134B,A01,083661,Powell; Thomas Allan,21,0,100,79
1657250659887,CSE 140,A01,083663,Gungor; Onat,13,0,85,72
1657250665912,CSE 140L,A01,083088,Eldon; John,18,0,100,82
1657250671935,CSE 175,A01,083665,Kumar; Rakesh,3,0,25,22
1657250677957,CSE 190,A00,092507,Dubnov; Shlomo,7,0,20,13
1657250683980,ECE 45,A01,083139,Congero; Spencer William,5,0,75,70
1657250690006,ECE 65,A50,083695,Saad; Andrew S,12,0,30,18
1657250690006,ECE 65,A51,095125,Saad; Andrew S,25,0,26,1
1657250696032,ECE 109,A01,091882,Touri; Behrouz,19,0,70,51
1657250702056,ECE 180,A00,083140,Abi Samra; Nicholas Camill,1,0,30,29
1657250702056,ECE 180,B00,083141,Abi Samra; Nicholas Camill,0,0,30,30
1657250708079,MATH 10A,A01,083735,Patchell; Gregory David,2,0,30,28
1657250708079,MATH 10A,A02,083736,Patchell; Gregory David,20,0,30,10
1657250708079,MATH 10A,A03,083737,Patchell; Gregory David,16,0,30,14
1657250714103,MATH 10B,A01,083207,Lim; Seonhee,7,0,34,27
1657250714103,MATH 10B,A02,083208,Lim; Seonhee,9,0,35,26
1657250714103,MATH 10B,A03,093472,Lim; Seonhee,5,0,34,29
1657250714103,MATH 10B,B01,083739,Sinha; Shubham,11,0,30,19
1657250720126,MATH 18,A01,083743,Cinel; Cameron Alexander,6,0,30,24
1657250720126,MATH 18,A02,083744,Cinel; Cameron Alexander,17,0,30,13
1657250720126,MATH 18,A03,083745,Cinel; Cameron Alexander,8,0,30,22
1657250720126,MATH 18,B01,083748,Rideout; David Porter,4,0,37,33
1657250720126,MATH 18,B02,083749,Rideout; David Porter,4,0,36,32
1657250720126,MATH 18,B03,083750,Rideout; David Porter,2,0,37,35
1657250720126,MATH 18,B04,083751,Rideout; David Porter,6,0,36,30
1657250720126,MATH 18,B05,093473,Rideout; David Porter,5,0,36,31
1657250720126,MATH 18,B06,093474,Rideout; David Porter,5,0,36,31
1657250726150,MATH 20A,A01,083754,Zheng; Zequn,14,0,40,26
1657250732175,MATH 20B,A01,083756,Briones; Jor-el Thomas Caparas,3,0,36,33
1657250732175,MATH 20B,A02,083757,Briones; Jor-el Thomas Caparas,1,0,36,35
1657250732175,MATH 20B,A03,093475,Briones; Jor-el Thomas Caparas,2,0,36,34
1657250738201,MATH 20C,A01,083760,Briones; Jor-el Thomas Caparas,1,0,35,34
1657250738201,MATH 20C,A02,083761,Briones; Jor-el Thomas Caparas,8,0,35,27
1657250738201,MATH 20C,A03,093476,Briones; Jor-el Thomas Caparas,0,1,36,36
1657250738201,MATH 20C,B01,083762,Bach; Quang Tran,1,0,30,29
1657250744226,MATH 20D,A01,083765,Tran; Brian Kha,4,0,30,26
1657250744226,MATH 20D,A02,083766,Tran; Brian Kha,5,0,30,25
1657250744226,MATH 20D,A03,083767,Tran; Brian Kha,4,0,30,26
1657250750250,MATH 20E,A01,083771,Ganguly; Soumya,7,0,32,25
1657250750250,MATH 20E,A02,083772,Ganguly; Soumya,7,0,32,25
1657250750250,MATH 20E,B01,083773,Ciotti; Benjamin,19,0,35,16
1657250750250,MATH 20E,B02,083774,Ciotti; Benjamin,17,0,35,18
1657250756277,MATH 103A,A01,083777,Greenfeld; Be'Eri,3,0,36,33
1657250756277,MATH 103A,A02,083778,Greenfeld; Be'Eri,5,0,36,31
1657250756277,MATH 103A,A03,093561,Greenfeld; Be'Eri,4,0,36,32
1657250756277,MATH 103A,B01,083779,Greenfeld; Be'Eri,6,0,36,30
1657250756277,MATH 103A,B02,083780,Greenfeld; Be'Eri,3,0,36,33
1657250756277,MATH 103A,B03,093562,Greenfeld; Be'Eri,3,0,36,33
1657250762306,MATH 105,A01,085443,Carter; Anne Toulson,15,0,35,20
1657250762306,MATH 105,A02,093477,Carter; Anne Toulson,20,0,35,15
1657250768328,MATH 109,A01,083213,Ganzberger; Geoffrey Michael,2,0,34,32
1657250768328,MATH 109,A02,083214,Ganzberger; Geoffrey Michael,4,0,34,30
1657250768328,MATH 109,A03,093478,Ganzberger; Geoffrey Michael,2,0,34,32
1657250768328,MATH 109,B01,083215,Ganzberger; Geoffrey Michael,1,0,32,31
1657250768328,MATH 109,B02,083216,Ganzberger; Geoffrey Michael,1,0,32,31
1657250768328,MATH 109,B03,093479,Ganzberger; Geoffrey Michael,8,0,32,24
1657250774358,MATH 142A,A01,083219,Chow; Bennett,6,0,32,26
1657250774358,MATH 142A,A02,083220,Chow; Bennett,10,0,32,22
1657250774358,MATH 142A,A03,093480,Chow; Bennett,7,0,32,25
1657250774358,MATH 142A,B03,093481,Chow; Bennett,8,0,32,24
1657250774358,MATH 142A,B04,093558,Chow; Bennett,12,0,32,20
1657250774358,MATH 142A,B05,093559,Chow; Bennett,6,0,32,26
1657250780381,MATH 193A,A01,083224,Rotar; Vladimir,7,0,34,27
1657250780381,MATH 193A,A02,083225,Rotar; Vladimir,6,0,34,28
1657250780381,MATH 193A,A03,083781,Rotar; Vladimir,2,0,34,32
1657250780381,MATH 193A,A04,083782,Rotar; Vladimir,8,0,34,26
1657250780381,MATH 193A,A05,093482,Rotar; Vladimir,6,0,34,28
1657250786408,MATH 197,001,091859,McAuley; Julian John,9999,0,9999,0
1657250786408,MATH 197,002,095566,Kedlaya; Kiran S.,9997,0,9999,2
1657250786408,MATH 197,003,095567,Xiao; Ming,9999,0,9999,0
1657250786408,MATH 197,004,095571,Perols; Johan Lars,9998,0,9999,1
1657250793461,COGS 9,A01,083615,Shannon; Kyle Michael,8,0,75,67
1657250799483,COGS 11,A01,083617,Boyle; Mary E. T.,22,0,48,26
1657250805506,COGS 13,A01,083071,Bastos; Amalia Pinkusfeld,8,0,71,63
1657250811529,COGS 14A,A01,092681,Semenuks; Arturs,2,1,100,98
1657250817552,COGS 14B,A01,083073,Cheng; Tzu-Han,6,0,63,57
1657250823576,COGS 17,A01,092677,Semenuks; Arturs,5,0,81,76
1657250829603,COGS 100,A01,083619,Allen; Michael Gordon,16,0,70,54
1657250835637,COGS 101A,A01,083621,Davis; Joshua Daniel,9,0,68,59
1657250841662,COGS 101B,A01,091572,Allen; Michael Gordon,11,0,65,54
1657250847686,COGS 101C,A01,083625,Delgado; Tania,17,0,35,18
1657250853713,COGS 107A,A01,083627,Boyle; Mary E. T.,13,0,60,47
1657250859740,COGS 118A,A01,083075,Gupta; Anjum,17,0,76,59
1657250865765,CSE 3,A50,083646,Miranda; Gregory Joseph,24,0,50,26
1657250871787,CSE 8A,A50,083650,Miranda; Gregory Joseph,17,1,56,39
1657250877811,CSE 11,A01,083080,Cao; Yingjun,5,15,40,35
1657250883839,CSE 12,A01,083652,Krause-Levy; Sophia Louisa,26,1,120,94
1657250889872,CSE 15L,A01,083654,Morris; Justin Loren,9,0,50,41
1657250889872,CSE 15L,A02,083655,Morris; Justin Loren,9,0,50,41
1657250895896,CSE 20,A01,083657,Tran; Khoa Dang,38,0,80,42
1657250901930,CSE 21,A01,095574,Bach; Quang Tran,22,0,48,26
1657250907956,CSE 30,A01,083084,Eldon; John,4,0,80,76
1657250907956,CSE 30,B01,095061,Bhaskar; Nishant,8,0,50,42
1657250913978,CSE 100,A01,083659,Cao; Yingjun,4,4,70,66
1657250920004,CSE 134B,A01,083661,Powell; Thomas Allan,21,0,100,79
1657250926027,CSE 140,A01,083663,Gungor; Onat,13,0,85,72
1657250932057,CSE 140L,A01,083088,Eldon; John,18,0,100,82
1657250938079,CSE 175,A01,083665,Kumar; Rakesh,3,0,25,22
1657250944105,CSE 190,A00,092507,Dubnov; Shlomo,7,0,20,13
1657250950130,ECE 45,A01,083139,Congero; Spencer William,5,0,75,70
1657250956154,ECE 65,A50,083695,Saad; Andrew S,12,0,30,18
1657250956154,ECE 65,A51,095125,Saad; Andrew S,25,0,26,1
1657250962251,ECE 109,A01,091882,Touri; Behrouz,19,0,70,51
1657250968277,ECE 180,A00,083140,Abi Samra; Nicholas Camill,1,0,30,29
1657250968277,ECE 180,B00,083141,Abi Samra; Nicholas Camill,0,0,30,30
1657250974306,MATH 10A,A01,083735,Patchell; Gregory David,2,0,30,28
1657250974306,MATH 10A,A02,083736,Patchell; Gregory David,20,0,30,10
1657250974306,MATH 10A,A03,083737,Patchell; Gregory David,16,0,30,14
1657250980337,MATH 10B,A01,083207,Lim; Seonhee,7,0,34,27
1657250980337,MATH 10B,A02,083208,Lim; Seonhee,9,0,35,26
1657250980337,MATH 10B,A03,093472,Lim; Seonhee,5,0,34,29
1657250980337,MATH 10B,B01,083739,Sinha; Shubham,11,0,30,19
1657250986360,MATH 18,A01,083743,Cinel; Cameron Alexander,6,0,30,24
1657250986360,MATH 18,A02,083744,Cinel; Cameron Alexander,17,0,30,13
1657250986360,MATH 18,A03,083745,Cinel; Cameron Alexander,8,0,30,22
1657250986360,MATH 18,B01,083748,Rideout; David Porter,4,0,37,33
1657250986360,MATH 18,B02,083749,Rideout; David Porter,4,0,36,32
1657250986360,MATH 18,B03,083750,Rideout; David Porter,2,0,37,35
1657250986360,MATH 18,B04,083751,Rideout; David Porter,6,0,36,30
1657250986360,MATH 18,B05,093473,Rideout; David Porter,5,0,36,31
1657250986360,MATH 18,B06,093474,Rideout; David Porter,5,0,36,31
1657250992392,MATH 20A,A01,083754,Zheng; Zequn,14,0,40,26
1657250998424,MATH 20B,A01,083756,Briones; Jor-el Thomas Caparas,3,0,36,33
1657250998424,MATH 20B,A02,083757,Briones; Jor-el Thomas Caparas,1,0,36,35
1657250998424,MATH 20B,A03,093475,Briones; Jor-el Thomas Caparas,2,0,36,34
1657251004451,MATH 20C,A01,083760,Briones; Jor-el Thomas Caparas,1,0,35,34
1657251004451,MATH 20C,A02,083761,Briones; Jor-el Thomas Caparas,8,0,35,27
1657251004451,MATH 20C,A03,093476,Briones; Jor-el Thomas Caparas,0,1,36,36
1657251004451,MATH 20C,B01,083762,Bach; Quang Tran,1,0,30,29
1657251010474,MATH 20D,A01,083765,Tran; Brian Kha,4,0,30,26
1657251010474,MATH 20D,A02,083766,Tran; Brian Kha,5,0,30,25
1657251010474,MATH 20D,A03,083767,Tran; Brian Kha,4,0,30,26
1657251016499,MATH 20E,A01,083771,Ganguly; Soumya,7,0,32,25
1657251016499,MATH 20E,A02,083772,Ganguly; Soumya,7,0,32,25
1657251016499,MATH 20E,B01,083773,Ciotti; Benjamin,19,0,35,16
1657251016499,MATH 20E,B02,083774,Ciotti; Benjamin,17,0,35,18
1657251022525,MATH 103A,A01,083777,Greenfeld; Be'Eri,3,0,36,33
1657251022525,MATH 103A,A02,083778,Greenfeld; Be'Eri,5,0,36,31
1657251022525,MATH 103A,A03,093561,Greenfeld; Be'Eri,4,0,36,32
1657251022525,MATH 103A,B01,083779,Greenfeld; Be'Eri,6,0,36,30
1657251022525,MATH 103A,B02,083780,Greenfeld; Be'Eri,3,0,36,33
1657251022525,MATH 103A,B03,093562,Greenfeld; Be'Eri,3,0,36,33
1657251028552,MATH 105,A01,085443,Carter; Anne Toulson,15,0,35,20
1657251028552,MATH 105,A02,093477,Carter; Anne Toulson,20,0,35,15
1657251034575,MATH 109,A01,083213,Ganzberger; Geoffrey Michael,2,0,34,32
1657251034575,MATH 109,A02,083214,Ganzberger; Geoffrey Michael,4,0,34,30
1657251034575,MATH 109,A03,093478,Ganzberger; Geoffrey Michael,2,0,34,32
1657251034575,MATH 109,B01,083215,Ganzberger; Geoffrey Michael,1,0,32,31
1657251034575,MATH 109,B02,083216,Ganzberger; Geoffrey Michael,1,0,32,31
1657251034575,MATH 109,B03,093479,Ganzberger; Geoffrey Michael,8,0,32,24
1657251040598,MATH 142A,A01,083219,Chow; Bennett,6,0,32,26
1657251040598,MATH 142A,A02,083220,Chow; Bennett,10,0,32,22
1657251040598,MATH 142A,A03,093480,Chow; Bennett,7,0,32,25
1657251040598,MATH 142A,B03,093481,Chow; Bennett,8,0,32,24
1657251040598,MATH 142A,B04,093558,Chow; Bennett,12,0,32,20
1657251040598,MATH 142A,B05,093559,Chow; Bennett,6,0,32,26
1657251046629,MATH 193A,A01,083224,Rotar; Vladimir,7,0,34,27
1657251046629,MATH 193A,A02,083225,Rotar; Vladimir,6,0,34,28
1657251046629,MATH 193A,A03,083781,Rotar; Vladimir,2,0,34,32
1657251046629,MATH 193A,A04,083782,Rotar; Vladimir,8,0,34,26
1657251046629,MATH 193A,A05,093482,Rotar; Vladimir,6,0,34,28
1657251052653,MATH 197,001,091859,McAuley; Julian John,9999,0,9999,0
1657251052653,MATH 197,002,095566,Kedlaya; Kiran S.,9997,0,9999,2
1657251052653,MATH 197,003,095567,Xiao; Ming,9999,0,9999,0
1657251052653,MATH 197,004,095571,Perols; Johan Lars,9998,0,9999,1
1657251059716,COGS 9,A01,083615,Shannon; Kyle Michael,8,0,75,67
1657251065741,COGS 11,A01,083617,Boyle; Mary E. T.,22,0,48,26
1657251071768,COGS 13,A01,083071,Bastos; Amalia Pinkusfeld,8,0,71,63
1657251077793,COGS 14A,A01,092681,Semenuks; Arturs,2,1,100,98
1657251083819,COGS 14B,A01,083073,Cheng; Tzu-Han,6,0,63,57
1657251089843,COGS 17,A01,092677,Semenuks; Arturs,5,0,81,76
1657251095868,COGS 100,A01,083619,Allen; Michael Gordon,16,0,70,54
1657251101898,COGS 101A,A01,083621,Davis; Joshua Daniel,9,0,68,59
1657251107921,COGS 101B,A01,091572,Allen; Michael Gordon,11,0,65,54
1657251113950,COGS 101C,A01,083625,Delgado; Tania,17,0,35,18
1657251119982,COGS 107A,A01,083627,Boyle; Mary E. T.,13,0,60,47
1657251126005,COGS 118A,A01,083075,Gupta; Anjum,17,0,76,59
1657251132033,CSE 3,A50,083646,Miranda; Gregory Joseph,24,0,50,26
1657251138061,CSE 8A,A50,083650,Miranda; Gregory Joseph,17,1,56,39
1657251144090,CSE 11,A01,083080,Cao; Yingjun,5,15,40,35
1657251150114,CSE 12,A01,083652,Krause-Levy; Sophia Louisa,26,1,120,94
1657251156142,CSE 15L,A01,083654,Morris; Justin Loren,9,0,50,41
1657251156142,CSE 15L,A02,083655,Morris; Justin Loren,9,0,50,41
1657251162171,CSE 20,A01,083657,Tran; Khoa Dang,38,0,80,42
1657251168195,CSE 21,A01,095574,Bach; Quang Tran,22,0,48,26
1657251174218,CSE 30,A01,083084,Eldon; John,4,0,80,76
1657251174218,CSE 30,B01,095061,Bhaskar; Nishant,8,0,50,42
1657251180252,CSE 100,A01,083659,Cao; Yingjun,4,4,70,66
1657251186279,CSE 134B,A01,083661,Powell; Thomas Allan,21,0,100,79
1657251192300,CSE 140,A01,083663,Gungor; Onat,13,0,85,72
1657251198323,CSE 140L,A01,083088,Eldon; John,18,0,100,82
1657251204348,CSE 175,A01,083665,Kumar; Rakesh,3,0,25,22
1657251210372,CSE 190,A00,092507,Dubnov; Shlomo,7,0,20,13
1657251216395,ECE 45,A01,083139,Congero; Spencer William,5,0,75,70
1657251222433,ECE 65,A50,083695,Saad; Andrew S,12,0,30,18
1657251222433,ECE 65,A51,095125,Saad; Andrew S,25,0,26,1
1657251228458,ECE 109,A01,091882,Touri; Behrouz,19,0,70,51
1657251234486,ECE 180,A00,083140,Abi Samra; Nicholas Camill,1,0,30,29
1657251234486,ECE 180,B00,083141,Abi Samra; Nicholas Camill,0,0,30,30
1657251240509,MATH 10A,A01,083735,Patchell; Gregory David,2,0,30,28
1657251240509,MATH 10A,A02,083736,Patchell; Gregory David,20,0,30,10
1657251240509,MATH 10A,A03,083737,Patchell; Gregory David,16,0,30,14
1657251246537,MATH 10B,A01,083207,Lim; Seonhee,7,0,34,27
1657251246537,MATH 10B,A02,083208,Lim; Seonhee,9,0,35,26
1657251246537,MATH 10B,A03,093472,Lim; Seonhee,5,0,34,29
1657251246537,MATH 10B,B01,083739,Sinha; Shubham,11,0,30,19
1657251252563,MATH 18,A01,083743,Cinel; Cameron Alexander,6,0,30,24
1657251252563,MATH 18,A02,083744,Cinel; Cameron Alexander,17,0,30,13
1657251252563,MATH 18,A03,083745,Cinel; Cameron Alexander,8,0,30,22
1657251252563,MATH 18,B01,083748,Rideout; David Porter,4,0,37,33
1657251252563,MATH 18,B02,083749,Rideout; David Porter,4,0,36,32
1657251252563,MATH 18,B03,083750,Rideout; David Porter,2,0,37,35
1657251252563,MATH 18,B04,083751,Rideout; David Porter,6,0,36,30
1657251252563,MATH 18,B05,093473,Rideout; David Porter,5,0,36,31
1657251252563,MATH 18,B06,093474,Rideout; David Porter,5,0,36,31
1657251258584,MATH 20A,A01,083754,Zheng; Zequn,14,0,40,26
1657251264608,MATH 20B,A01,083756,Briones; Jor-el Thomas Caparas,3,0,36,33
1657251264608,MATH 20B,A02,083757,Briones; Jor-el Thomas Caparas,1,0,36,35
1657251264608,MATH 20B,A03,093475,Briones; Jor-el Thomas Caparas,2,0,36,34
1657251270636,MATH 20C,A01,083760,Briones; Jor-el Thomas Caparas,1,0,35,34
1657251270636,MATH 20C,A02,083761,Briones; Jor-el Thomas Caparas,8,0,35,27
1657251270636,MATH 20C,A03,093476,Briones; Jor-el Thomas Caparas,0,1,36,36
1657251270636,MATH 20C,B01,083762,Bach; Quang Tran,1,0,30,29
1657251276659,MATH 20D,A01,083765,Tran; Brian Kha,4,0,30,26
1657251276659,MATH 20D,A02,083766,Tran; Brian Kha,5,0,30,25
1657251276659,MATH 20D,A03,083767,Tran; Brian Kha,4,0,30,26
1657251282684,MATH 20E,A01,083771,Ganguly; Soumya,7,0,32,25
1657251282684,MATH 20E,A02,083772,Ganguly; Soumya,7,0,32,25
1657251282684,MATH 20E,B01,083773,Ciotti; Benjamin,19,0,35,16
1657251282684,MATH 20E,B02,083774,Ciotti; Benjamin,17,0,35,18
1657251288713,MATH 103A,A01,083777,Greenfeld; Be'Eri,3,0,36,33
1657251288713,MATH 103A,A02,083778,Greenfeld; Be'Eri,5,0,36,31
1657251288713,MATH 103A,A03,093561,Greenfeld; Be'Eri,4,0,36,32
1657251288713,MATH 103A,B01,083779,Greenfeld; Be'Eri,6,0,36,30
1657251288713,MATH 103A,B02,083780,Greenfeld; Be'Eri,3,0,36,33
1657251288713,MATH 103A,B03,093562,Greenfeld; Be'Eri,3,0,36,33
1657251294736,MATH 105,A01,085443,Carter; Anne Toulson,15,0,35,20
1657251294736,MATH 105,A02,093477,Carter; Anne Toulson,20,0,35,15
1657251300759,MATH 109,A01,083213,Ganzberger; Geoffrey Michael,2,0,34,32
1657251300759,MATH 109,A02,083214,Ganzberger; Geoffrey Michael,4,0,34,30
1657251300759,MATH 109,A03,093478,Ganzberger; Geoffrey Michael,2,0,34,32
1657251300759,MATH 109,B01,083215,Ganzberger; Geoffrey Michael,1,0,32,31
1657251300759,MATH 109,B02,083216,Ganzberger; Geoffrey Michael,1,0,32,31
1657251300759,MATH 109,B03,093479,Ganzberger; Geoffrey Michael,8,0,32,24
1657251306792,MATH 142A,A01,083219,Chow; Bennett,6,0,32,26
1657251306792,MATH 142A,A02,083220,Chow; Bennett,10,0,32,22
1657251306792,MATH 142A,A03,093480,Chow; Bennett,7,0,32,25
1657251306792,MATH 142A,B03,093481,Chow; Bennett,8,0,32,24
1657251306792,MATH 142A,B04,093558,Chow; Bennett,12,0,32,20
1657251306792,MATH 142A,B05,093559,Chow; Bennett,6,0,32,26
1657251312824,MATH 193A,A01,083224,Rotar; Vladimir,7,0,34,27
1657251312824,MATH 193A,A02,083225,Rotar; Vladimir,6,0,34,28
1657251312824,MATH 193A,A03,083781,Rotar; Vladimir,2,0,34,32
1657251312824,MATH 193A,A04,083782,Rotar; Vladimir,8,0,34,26
1657251312824,MATH 193A,A05,093482,Rotar; Vladimir,6,0,34,28
1657251318848,MATH 197,001,091859,McAuley; Julian John,9999,0,9999,0
1657251318848,MATH 197,002,095566,Kedlaya; Kiran S.,9997,0,9999,2
1657251318848,MATH 197,003,095567,Xiao; Ming,9999,0,9999,0
1657251318848,MATH 197,004,095571,Perols; Johan Lars,9998,0,9999,1
1657251325900,COGS 9,A01,083615,Shannon; Kyle Michael,8,0,75,67
1657251331928,COGS 11,A01,083617,Boyle; Mary E. T.,22,0,48,26
1657251337955,COGS 13,A01,083071,Bastos; Amalia Pinkusfeld,8,0,71,63
1657251343977,COGS 14A,A01,092681,Semenuks; Arturs,2,1,100,98
1657251350004,COGS 14B,A01,083073,Cheng; Tzu-Han,6,0,63,57
1657251356028,COGS 17,A01,092677,Semenuks; Arturs,5,0,81,76
1657251362054,COGS 100,A01,083619,Allen; Michael Gordon,16,0,70,54
1657251368078,COGS 101A,A01,083621,Davis; Joshua Daniel,9,0,68,59
1657251374106,COGS 101B,A01,091572,Allen; Michael Gordon,11,0,65,54
1657251380129,COGS 101C,A01,083625,Delgado; Tania,17,0,35,18
1657251386152,COGS 107A,A01,083627,Boyle; Mary E. T.,13,0,60,47
1657251392179,COGS 118A,A01,083075,Gupta; Anjum,17,0,76,59
1657251398203,CSE 3,A50,083646,Miranda; Gregory Joseph,24,0,50,26
1657251404226,CSE 8A,A50,083650,Miranda; Gregory Joseph,17,1,56,39
1657251410249,CSE 11,A01,083080,Cao; Yingjun,5,15,40,35
1657251416277,CSE 12,A01,083652,Krause-Levy; Sophia Louisa,26,1,120,94
1657251422306,CSE 15L,A01,083654,Morris; Justin Loren,9,0,50,41
1657251422306,CSE 15L,A02,083655,Morris; Justin Loren,9,0,50,41
1657251428329,CSE 20,A01,083657,Tran; Khoa Dang,38,0,80,42
1657251434354,CSE 21,A01,095574,Bach; Quang Tran,22,0,48,26
1657251440388,CSE 30,A01,083084,Eldon; John,4,0,80,76
1657251440388,CSE 30,B01,095061,Bhaskar; Nishant,8,0,50,42
1657251446411,CSE 100,A01,083659,Cao; Yingjun,4,4,70,66
1657251452434,CSE 134B,A01,083661,Powell; Thomas Allan,21,0,100,79
1657251458463,CSE 140,A01,083663,Gungor; Onat,13,0,85,72
1657251464489,CSE 140L,A01,083088,Eldon; John,18,0,100,82
1657251470511,CSE 175,A01,083665,Kumar; Rakesh,3,0,25,22
1657251476538,CSE 190,A00,092507,Dubnov; Shlomo,7,0,20,13
1657251482567,ECE 45,A01,083139,Congero; Spencer William,5,0,75,70
1657251488595,ECE 65,A50,083695,Saad; Andrew S,12,0,30,18
1657251488595,ECE 65,A51,095125,Saad; Andrew S,25,0,26,1
1657251494619,ECE 109,A01,091882,Touri; Behrouz,19,0,70,51
1657251500642,ECE 180,A00,083140,Abi Samra; Nicholas Camill,1,0,30,29
1657251500642,ECE 180,B00,083141,Abi Samra; Nicholas Camill,0,0,30,30
1657251506668,MATH 10A,A01,083735,Patchell; Gregory David,2,0,30,28
1657251506668,MATH 10A,A02,083736,Patchell; Gregory David,20,0,30,10
1657251506668,MATH 10A,A03,083737,Patchell; Gregory David,16,0,30,14
1657251512697,MATH 10B,A01,083207,Lim; Seonhee,7,0,34,27
1657251512697,MATH 10B,A02,083208,Lim; Seonhee,9,0,35,26
1657251512697,MATH 10B,A03,093472,Lim; Seonhee,5,0,34,29
1657251512697,MATH 10B,B01,083739,Sinha; Shubham,11,0,30,19
1657251518727,MATH 18,A01,083743,Cinel; Cameron Alexander,6,0,30,24
1657251518727,MATH 18,A02,083744,Cinel; Cameron Alexander,17,0,30,13
1657251518727,MATH 18,A03,083745,Cinel; Cameron Alexander,8,0,30,22
1657251518727,MATH 18,B01,083748,Rideout; David Porter,4,0,37,33
1657251518727,MATH 18,B02,083749,Rideout; David Porter,4,0,36,32
1657251518727,MATH 18,B03,083750,Rideout; David Porter,2,0,37,35
1657251518727,MATH 18,B04,083751,Rideout; David Porter,6,0,36,30
1657251518727,MATH 18,B05,093473,Rideout; David Porter,5,0,36,31
1657251518727,MATH 18,B06,093474,Rideout; David Porter,5,0,36,31
1657251524754,MATH 20A,A01,083754,Zheng; Zequn,14,0,40,26
1657251530781,MATH 20B,A01,083756,Briones; Jor-el Thomas Caparas,3,0,36,33
1657251530781,MATH 20B,A02,083757,Briones; Jor-el Thomas Caparas,1,0,36,35
1657251530781,MATH 20B,A03,093475,Briones; Jor-el Thomas Caparas,2,0,36,34
1657251536809,MATH 20C,A01,083760,Briones; Jor-el Thomas Caparas,1,0,35,34
1657251536809,MATH 20C,A02,083761,Briones; Jor-el Thomas Caparas,8,0,35,27
1657251536809,MATH 20C,A03,093476,Briones; Jor-el Thomas Caparas,0,1,36,36
1657251536809,MATH 20C,B01,083762,Bach; Quang Tran,1,0,30,29
1657251542840,MATH 20D,A01,083765,Tran; Brian Kha,4,0,30,26
1657251542840,MATH 20D,A02,083766,Tran; Brian Kha,5,0,30,25
1657251542840,MATH 20D,A03,083767,Tran; Brian Kha,4,0,30,26
1657251548865,MATH 20E,A01,083771,Ganguly; Soumya,7,0,32,25
1657251548865,MATH 20E,A02,083772,Ganguly; Soumya,7,0,32,25
1657251548865,MATH 20E,B01,083773,Ciotti; Benjamin,19,0,35,16
1657251548865,MATH 20E,B02,083774,Ciotti; Benjamin,17,0,35,18
1657251554889,MATH 103A,A01,083777,Greenfeld; Be'Eri,3,0,36,33
1657251554889,MATH 103A,A02,083778,Greenfeld; Be'Eri,5,0,36,31
1657251554889,MATH 103A,A03,093561,Greenfeld; Be'Eri,4,0,36,32
1657251554889,MATH 103A,B01,083779,Greenfeld; Be'Eri,6,0,36,30
1657251554889,MATH 103A,B02,083780,Greenfeld; Be'Eri,3,0,36,33
1657251554889,MATH 103A,B03,093562,Greenfeld; Be'Eri,3,0,36,33
1657251560985,MATH 105,A01,085443,Carter; Anne Toulson,15,0,35,20
1657251560985,MATH 105,A02,093477,Carter; Anne Toulson,20,0,35,15
1657251567023,MATH 109,A01,083213,Ganzberger; Geoffrey Michael,2,0,34,32
1657251567023,MATH 109,A02,083214,Ganzberger; Geoffrey Michael,4,0,34,30
1657251567023,MATH 109,A03,093478,Ganzberger; Geoffrey Michael,2,0,34,32
1657251567023,MATH 109,B01,083215,Ganzberger; Geoffrey Michael,1,0,32,31
1657251567023,MATH 109,B02,083216,Ganzberger; Geoffrey Michael,1,0,32,31
1657251567023,MATH 109,B03,093479,Ganzberger; Geoffrey Michael,8,0,32,24
1657251573050,MATH 142A,A01,083219,Chow; Bennett,6,0,32,26
1657251573050,MATH 142A,A02,083220,Chow; Bennett,10,0,32,22
1657251573050,MATH 142A,A03,093480,Chow; Bennett,7,0,32,25
1657251573050,MATH 142A,B03,093481,Chow; Bennett,8,0,32,24
1657251573050,MATH 142A,B04,093558,Chow; Bennett,12,0,32,20
1657251573050,MATH 142A,B05,093559,Chow; Bennett,6,0,32,26
1657251579079,MATH 193A,A01,083224,Rotar; Vladimir,7,0,34,27
1657251579079,MATH 193A,A02,083225,Rotar; Vladimir,6,0,34,28
1657251579079,MATH 193A,A03,083781,Rotar; Vladimir,2,0,34,32
1657251579079,MATH 193A,A04,083782,Rotar; Vladimir,8,0,34,26
1657251579079,MATH 193A,A05,093482,Rotar; Vladimir,6,0,34,28
1657251585105,MATH 197,001,091859,McAuley; Julian John,9999,0,9999,0
1657251585105,MATH 197,002,095566,Kedlaya; Kiran S.,9997,0,9999,2
1657251585105,MATH 197,003,095567,Xiao; Ming,9999,0,9999,0
1657251585105,MATH 197,004,095571,Perols; Johan Lars,9998,0,9999,1
1657251592164,COGS 9,A01,083615,Shannon; Kyle Michael,8,0,75,67
1657251598196,COGS 11,A01,083617,Boyle; Mary E. T.,22,0,48,26
1657251604222,COGS 13,A01,083071,Bastos; Amalia Pinkusfeld,8,0,71,63
1657251610247,COGS 14A,A01,092681,Semenuks; Arturs,2,1,100,98
1657251616280,COGS 14B,A01,083073,Cheng; Tzu-Han,6,0,63,57
1657251622308,COGS 17,A01,092677,Semenuks; Arturs,5,0,81,76
1657251628331,COGS 100,A01,083619,Allen; Michael Gordon,16,0,70,54
1657251634360,COGS 101A,A01,083621,Davis; Joshua Daniel,9,0,68,59
1657251640382,COGS 101B,A01,091572,Allen; Michael Gordon,11,0,65,54
1657251646405,COGS 101C,A01,083625,Delgado; Tania,17,0,35,18
1657251652495,COGS 107A,A01,083627,Boyle; Mary E. T.,13,0,60,47
1657251658523,COGS 118A,A01,083075,Gupta; Anjum,17,0,76,59
1657251664546,CSE 3,A50,083646,Miranda; Gregory Joseph,24,0,50,26
1657251670570,CSE 8A,A50,083650,Miranda; Gregory Joseph,17,1,56,39
1657251676593,CSE 11,A01,083080,Cao; Yingjun,5,15,40,35
1657251682615,CSE 12,A01,083652,Krause-Levy; Sophia Louisa,26,1,120,94
1657251688636,CSE 15L,A01,083654,Morris; Justin Loren,9,0,50,41
1657251688636,CSE 15L,A02,083655,Morris; Justin Loren,9,0,50,41
1657251694663,CSE 20,A01,083657,Tran; Khoa Dang,38,0,80,42
1657251700685,CSE 21,A01,095574,Bach; Quang Tran,22,0,48,26
1657251706708,CSE 30,A01,083084,Eldon; John,4,0,80,76
1657251706708,CSE 30,B01,095061,Bhaskar; Nishant,8,0,50,42
1657251712733,CSE 100,A01,083659,Cao; Yingjun,4,4,70,66
1657251718755,CSE 134B,A01,083661,Powell; Thomas Allan,21,0,100,79
1657251724778,CSE 140,A01,083663,Gungor; Onat,13,0,85,72
1657251730804,CSE 140L,A01,083088,Eldon; John,18,0,100,82
1657251736837,CSE 175,A01,083665,Kumar; Rakesh,3,0,25,22
1657251742860,CSE 190,A00,092507,Dubnov; Shlomo,7,0,20,13
1657251748887,ECE 45,A01,083139,Congero; Spencer William,5,0,75,70
1657251754911,ECE 65,A50,083695,Saad; Andrew S,12,0,30,18
1657251754911,ECE 65,A51,095125,Saad; Andrew S,25,0,26,1
1657251760938,ECE 109,A01,091882,Touri; Behrouz,19,0,70,51
1657251766966,ECE 180,A00,083140,Abi Samra; Nicholas Camill,1,0,30,29
1657251766966,ECE 180,B00,083141,Abi Samra; Nicholas Camill,0,0,30,30
1657251772988,MATH 10A,A01,083735,Patchell; Gregory David,2,0,30,28
1657251772988,MATH 10A,A02,083736,Patchell; Gregory David,20,0,30,10
1657251772988,MATH 10A,A03,083737,Patchell; Gregory David,16,0,30,14
1657251779012,MATH 10B,A01,083207,Lim; Seonhee,7,0,34,27
1657251779012,MATH 10B,A02,083208,Lim; Seonhee,9,0,35,26
1657251779012,MATH 10B,A03,093472,Lim; Seonhee,5,0,34,29
1657251779012,MATH 10B,B01,083739,Sinha; Shubham,11,0,30,19
1657251785044,MATH 18,A01,083743,Cinel; Cameron Alexander,6,0,30,24
1657251785044,MATH 18,A02,083744,Cinel; Cameron Alexander,17,0,30,13
1657251785044,MATH 18,A03,083745,Cinel; Cameron Alexander,8,0,30,22
1657251785044,MATH 18,B01,083748,Rideout; David Porter,4,0,37,33
1657251785044,MATH 18,B02,083749,Rideout; David Porter,4,0,36,32
1657251785044,MATH 18,B03,083750,Rideout; David Porter,2,0,37,35
1657251785044,MATH 18,B04,083751,Rideout; David Porter,6,0,36,30
1657251785044,MATH 18,B05,093473,Rideout; David Porter,5,0,36,31
1657251785044,MATH 18,B06,093474,Rideout; David Porter,5,0,36,31
1657251791069,MATH 20A,A01,083754,Zheng; Zequn,14,0,40,26
1657251797093,MATH 20B,A01,083756,Briones; Jor-el Thomas Caparas,3,0,36,33
1657251797093,MATH 20B,A02,083757,Briones; Jor-el Thomas Caparas,1,0,36,35
1657251797093,MATH 20B,A03,093475,Briones; Jor-el Thomas Caparas,2,0,36,34
1657251803126,MATH 20C,A01,083760,Briones; Jor-el Thomas Caparas,1,0,35,34
1657251803126,MATH 20C,A02,083761,Briones; Jor-el Thomas Caparas,8,0,35,27
1657251803126,MATH 20C,A03,093476,Briones; Jor-el Thomas Caparas,0,1,36,36
1657251803126,MATH 20C,B01,083762,Bach; Quang Tran,1,0,30,29
1657251809150,MATH 20D,A01,083765,Tran; Brian Kha,4,0,30,26
1657251809150,MATH 20D,A02,083766,Tran; Brian Kha,5,0,30,25
1657251809150,MATH 20D,A03,083767,Tran; Brian Kha,4,0,30,26
1657251815174,MATH 20E,A01,083771,Ganguly; Soumya,7,0,32,25
1657251815174,MATH 20E,A02,083772,Ganguly; Soumya,7,0,32,25
1657251815174,MATH 20E,B01,083773,Ciotti; Benjamin,19,0,35,16
1657251815174,MATH 20E,B02,083774,Ciotti; Benjamin,17,0,35,18
1657251821201,MATH 103A,A01,083777,Greenfeld; Be'Eri,3,0,36,33
1657251821201,MATH 103A,A02,083778,Greenfeld; Be'Eri,5,0,36,31
1657251821201,MATH 103A,A03,093561,Greenfeld; Be'Eri,4,0,36,32
1657251821201,MATH 103A,B01,083779,Greenfeld; Be'Eri,6,0,36,30
1657251821201,MATH 103A,B02,083780,Greenfeld; Be'Eri,3,0,36,33
1657251821201,MATH 103A,B03,093562,Greenfeld; Be'Eri,3,0,36,33
1657251827230,MATH 105,A01,085443,Carter; Anne Toulson,15,0,35,20
1657251827230,MATH 105,A02,093477,Carter; Anne Toulson,20,0,35,15
1657251833264,MATH 109,A01,083213,Ganzberger; Geoffrey Michael,2,0,34,32
1657251833264,MATH 109,A02,083214,Ganzberger; Geoffrey Michael,4,0,34,30
1657251833264,MATH 109,A03,093478,Ganzberger; Geoffrey Michael,2,0,34,32
1657251833264,MATH 109,B01,083215,Ganzberger; Geoffrey Michael,1,0,32,31
1657251833264,MATH 109,B02,083216,Ganzberger; Geoffrey Michael,1,0,32,31
1657251833264,MATH 109,B03,093479,Ganzberger; Geoffrey Michael,8,0,32,24
1657251839297,MATH 142A,A01,083219,Chow; Bennett,6,0,32,26
1657251839297,MATH 142A,A02,083220,Chow; Bennett,10,0,32,22
1657251839297,MATH 142A,A03,093480,Chow; Bennett,7,0,32,25
1657251839297,MATH 142A,B03,093481,Chow; Bennett,8,0,32,24
1657251839297,MATH 142A,B04,093558,Chow; Bennett,12,0,32,20
1657251839297,MATH 142A,B05,093559,Chow; Bennett,6,0,32,26
1657251845319,MATH 193A,A01,083224,Rotar; Vladimir,7,0,34,27
1657251845319,MATH 193A,A02,083225,Rotar; Vladimir,6,0,34,28
1657251845319,MATH 193A,A03,083781,Rotar; Vladimir,2,0,34,32
1657251845319,MATH 193A,A04,083782,Rotar; Vladimir,8,0,34,26
1657251845319,MATH 193A,A05,093482,Rotar; Vladimir,6,0,34,28
1657251851343,MATH 197,001,091859,McAuley; Julian John,9999,0,9999,0
1657251851343,MATH 197,002,095566,Kedlaya; Kiran S.,9997,0,9999,2
1657251851343,MATH 197,003,095567,Xiao; Ming,9999,0,9999,0
1657251851343,MATH 197,004,095571,Perols; Johan Lars,9998,0,9999,1
1657251858397,COGS 9,A01,083615,Shannon; Kyle Michael,8,0,75,67
1657251864419,COGS 11,A01,083617,Boyle; Mary E. T.,22,0,48,26
1657251870447,COGS 13,A01,083071,Bastos; Amalia Pinkusfeld,8,0,71,63
1657251876476,COGS 14A,A01,092681,Semenuks; Arturs,2,1,100,98
1657251882500,COGS 14B,A01,083073,Cheng; Tzu-Han,6,0,63,57
1657251888522,COGS 17,A01,092677,Semenuks; Arturs,5,0,81,76
1657251894545,COGS 100,A01,083619,Allen; Michael Gordon,16,0,70,54
1657251900567,COGS 101A,A01,083621,Davis; Joshua Daniel,9,0,68,59
1657251906589,COGS 101B,A01,091572,Allen; Michael Gordon,11,0,65,54
1657251912612,COGS 101C,A01,083625,Delgado; Tania,17,0,35,18
1657251918635,COGS 107A,A01,083627,Boyle; Mary E. T.,13,0,60,47
1657251924657,COGS 118A,A01,083075,Gupta; Anjum,17,0,76,59
1657251930687,CSE 3,A50,083646,Miranda; Gregory Joseph,24,0,50,26
1657251936712,CSE 8A,A50,083650,Miranda; Gregory Joseph,17,1,56,39
1657251942736,CSE 11,A01,083080,Cao; Yingjun,5,15,40,35
1657251948762,CSE 12,A01,083652,Krause-Levy; Sophia Louisa,26,1,120,94
1657251954786,CSE 15L,A01,083654,Morris; Justin Loren,9,0,50,41
1657251954786,CSE 15L,A02,083655,Morris; Justin Loren,9,0,50,41
1657251960813,CSE 20,A01,083657,Tran; Khoa Dang,38,0,80,42
1657251966836,CSE 21,A01,095574,Bach; Quang Tran,22,0,48,26
1657251972859,CSE 30,A01,083084,Eldon; John,4,0,80,76
1657251972859,CSE 30,B01,095061,Bhaskar; Nishant,8,0,50,42
1657251978885,CSE 100,A01,083659,Cao; Yingjun,4,4,70,66
1657251984913,CSE 134B,A01,083661,Powell; Thomas Allan,21,0,100,79
1657251990944,CSE 140,A01,083663,Gungor; Onat,13,0,85,72
1657251996966,CSE 140L,A01,083088,Eldon; John,18,0,100,82
1657252002989,CSE 175,A01,083665,Kumar; Rakesh,3,0,25,22
1657252009013,CSE 190,A00,092507,Dubnov; Shlomo,7,0,20,13
1657252015040,ECE 45,A01,083139,Congero; Spencer William,5,0,75,70
1657252021064,ECE 65,A50,083695,Saad; Andrew S,12,0,30,18
1657252021064,ECE 65,A51,095125,Saad; Andrew S,25,0,26,1
1657252027090,ECE 109,A01,091882,Touri; Behrouz,19,0,70,51
1657252033117,ECE 180,A00,083140,Abi Samra; Nicholas Camill,1,0,30,29
1657252033117,ECE 180,B00,083141,Abi Samra; Nicholas Camill,0,0,30,30
1657252039146,MATH 10A,A01,083735,Patchell; Gregory David,2,0,30,28
1657252039146,MATH 10A,A02,083736,Patchell; Gregory David,20,0,30,10
1657252039146,MATH 10A,A03,083737,Patchell; Gregory David,16,0,30,14
1657252045172,MATH 10B,A01,083207,Lim; Seonhee,7,0,34,27
1657252045172,MATH 10B,A02,083208,Lim; Seonhee,9,0,35,26
1657252045172,MATH 10B,A03,093472,Lim; Seonhee,5,0,34,29
1657252045172,MATH 10B,B01,083739,Sinha; Shubham,11,0,30,19
1657252051196,MATH 18,A01,083743,Cinel; Cameron Alexander,6,0,30,24
1657252051196,MATH 18,A02,083744,Cinel; Cameron Alexander,17,0,30,13
1657252051196,MATH 18,A03,083745,Cinel; Cameron Alexander,8,0,30,22
1657252051196,MATH 18,B01,083748,Rideout; David Porter,4,0,37,33
1657252051196,MATH 18,B02,083749,Rideout; David Porter,4,0,36,32
1657252051196,MATH 18,B03,083750,Rideout; David Porter,2,0,37,35
1657252051196,MATH 18,B04,083751,Rideout; David Porter,6,0,36,30
1657252051196,MATH 18,B05,093473,Rideout; David Porter,5,0,36,31
1657252051196,MATH 18,B06,093474,Rideout; David Porter,5,0,36,31
1657252057224,MATH 20A,A01,083754,Zheng; Zequn,14,0,40,26
1657252063251,MATH 20B,A01,083756,Briones; Jor-el Thomas Caparas,3,0,36,33
1657252063251,MATH 20B,A02,083757,Briones; Jor-el Thomas Caparas,1,0,36,35
1657252063251,MATH 20B,A03,093475,Briones; Jor-el Thomas Caparas,2,0,36,34
1657252069287,MATH 20C,A01,083760,Briones; Jor-el Thomas Caparas,1,0,35,34
1657252069287,MATH 20C,A02,083761,Briones; Jor-el Thomas Caparas,8,0,35,27
1657252069287,MATH 20C,A03,093476,Briones; Jor-el Thomas Caparas,0,1,36,36
1657252069287,MATH 20C,B01,083762,Bach; Quang Tran,1,0,30,29
1657252075309,MATH 20D,A01,083765,Tran; Brian Kha,4,0,30,26
1657252075309,MATH 20D,A02,083766,Tran; Brian Kha,5,0,30,25
1657252075309,MATH 20D,A03,083767,Tran; Brian Kha,4,0,30,26
1657252081336,MATH 20E,A01,083771,Ganguly; Soumya,7,0,32,25
1657252081336,MATH 20E,A02,083772,Ganguly; Soumya,7,0,32,25
1657252081336,MATH 20E,B01,083773,Ciotti; Benjamin,19,0,35,16
1657252081336,MATH 20E,B02,083774,Ciotti; Benjamin,17,0,35,18
1657252087365,MATH 103A,A01,083777,Greenfeld; Be'Eri,3,0,36,33
1657252087365,MATH 103A,A02,083778,Greenfeld; Be'Eri,5,0,36,31
1657252087365,MATH 103A,A03,093561,Greenfeld; Be'Eri,4,0,36,32
1657252087365,MATH 103A,B01,083779,Greenfeld; Be'Eri,6,0,36,30
1657252087365,MATH 103A,B02,083780,Greenfeld; Be'Eri,3,0,36,33
1657252087365,MATH 103A,B03,093562,Greenfeld; Be'Eri,3,0,36,33
1657252093393,MATH 105,A01,085443,Carter; Anne Toulson,15,0,35,20
1657252093393,MATH 105,A02,093477,Carter; Anne Toulson,20,0,35,15
1657252099416,MATH 109,A01,083213,Ganzberger; Geoffrey Michael,2,0,34,32
1657252099416,MATH 109,A02,083214,Ganzberger; Geoffrey Michael,4,0,34,30
1657252099416,MATH 109,A03,093478,Ganzberger; Geoffrey Michael,2,0,34,32
1657252099416,MATH 109,B01,083215,Ganzberger; Geoffrey Michael,1,0,32,31
1657252099416,MATH 109,B02,083216,Ganzberger; Geoffrey Michael,1,0,32,31
1657252099416,MATH 109,B03,093479,Ganzberger; Geoffrey Michael,8,0,32,24
1657252105446,MATH 142A,A01,083219,Chow; Bennett,6,0,32,26
1657252105446,MATH 142A,A02,083220,Chow; Bennett,10,0,32,22
1657252105446,MATH 142A,A03,093480,Chow; Bennett,7,0,32,25
1657252105446,MATH 142A,B03,093481,Chow; Bennett,8,0,32,24
1657252105446,MATH 142A,B04,093558,Chow; Bennett,12,0,32,20
1657252105446,MATH 142A,B05,093559,Chow; Bennett,6,0,32,26
1657252111474,MATH 193A,A01,083224,Rotar; Vladimir,7,0,34,27
1657252111474,MATH 193A,A02,083225,Rotar; Vladimir,6,0,34,28
1657252111474,MATH 193A,A03,083781,Rotar; Vladimir,2,0,34,32
1657252111474,MATH 193A,A04,083782,Rotar; Vladimir,8,0,34,26
1657252111474,MATH 193A,A05,093482,Rotar; Vladimir,6,0,34,28
1657252117500,MATH 197,001,091859,McAuley; Julian John,9999,0,9999,0
1657252117500,MATH 197,002,095566,Kedlaya; Kiran S.,9997,0,9999,2
1657252117500,MATH 197,003,095567,Xiao; Ming,9999,0,9999,0
1657252117500,MATH 197,004,095571,Perols; Johan Lars,9998,0,9999,1
1657252124551,COGS 9,A01,083615,Shannon; Kyle Michael,8,0,75,67
1657252130576,COGS 11,A01,083617,Boyle; Mary E. T.,22,0,48,26
1657252136603,COGS 13,A01,083071,Bastos; Amalia Pinkusfeld,8,0,71,63
1657252142626,COGS 14A,A01,092681,Semenuks; Arturs,2,1,100,98
1657252148649,COGS 14B,A01,083073,Cheng; Tzu-Han,6,0,63,57
1657252154760,COGS 17,A01,092677,Semenuks; Arturs,5,0,81,76
1657252160784,COGS 100,A01,083619,Allen; Michael Gordon,16,0,70,54
1657252166810,COGS 101A,A01,083621,Davis; Joshua Daniel,9,0,68,59
1657252172837,COGS 101B,A01,091572,Allen; Michael Gordon,11,0,65,54
1657252178860,COGS 101C,A01,083625,Delgado; Tania,17,0,35,18
1657252184882,COGS 107A,A01,083627,Boyle; Mary E. T.,13,0,60,47
1657252190907,COGS 118A,A01,083075,Gupta; Anjum,17,0,76,59
1657252196929,CSE 3,A50,083646,Miranda; Gregory Joseph,24,0,50,26
1657252202959,CSE 8A,A50,083650,Miranda; Gregory Joseph,17,1,56,39
1657252208984,CSE 11,A01,083080,Cao; Yingjun,5,15,40,35
1657252215009,CSE 12,A01,083652,Krause-Levy; Sophia Louisa,26,1,120,94
1657252221033,CSE 15L,A01,083654,Morris; Justin Loren,9,0,50,41
1657252221033,CSE 15L,A02,083655,Morris; Justin Loren,9,0,50,41
1657252227058,CSE 20,A01,083657,Tran; Khoa Dang,38,0,80,42
1657252233083,CSE 21,A01,095574,Bach; Quang Tran,22,0,48,26
1657252239107,CSE 30,A01,083084,Eldon; John,4,0,80,76
1657252239107,CSE 30,B01,095061,Bhaskar; Nishant,8,0,50,42
1657252245135,CSE 100,A01,083659,Cao; Yingjun,4,4,70,66
1657252251158,CSE 134B,A01,083661,Powell; Thomas Allan,21,0,100,79
1657252257192,CSE 140,A01,083663,Gungor; Onat,13,0,85,72
1657252263218,CSE 140L,A01,083088,Eldon; John,18,0,100,82
1657252269242,CSE 175,A01,083665,Kumar; Rakesh,3,0,25,22
1657252275271,CSE 190,A00,092507,Dubnov; Shlomo,7,0,20,13
1657252281294,ECE 45,A01,083139,Congero; Spencer William,5,0,75,70
1657252287316,ECE 65,A50,083695,Saad; Andrew S,12,0,30,18
1657252287316,ECE 65,A51,095125,Saad; Andrew S,25,0,26,1
1657252293339,ECE 109,A01,091882,Touri; Behrouz,19,0,70,51
1657252299362,ECE 180,A00,083140,Abi Samra; Nicholas Camill,1,0,30,29
1657252299362,ECE 180,B00,083141,Abi Samra; Nicholas Camill,0,0,30,30
1657252305387,MATH 10A,A01,083735,Patchell; Gregory David,2,0,30,28
1657252305387,MATH 10A,A02,083736,Patchell; Gregory David,20,0,30,10
1657252305387,MATH 10A,A03,083737,Patchell; Gregory David,16,0,30,14
1657252311418,MATH 10B,A01,083207,Lim; Seonhee,7,0,34,27
1657252311418,MATH 10B,A02,083208,Lim; Seonhee,9,0,35,26
1657252311418,MATH 10B,A03,093472,Lim; Seonhee,5,0,34,29
1657252311418,MATH 10B,B01,083739,Sinha; Shubham,11,0,30,19
1657252317447,MATH 18,A01,083743,Cinel; Cameron Alexander,6,0,30,24
1657252317447,MATH 18,A02,083744,Cinel; Cameron Alexander,17,0,30,13
1657252317447,MATH 18,A03,083745,Cinel; Cameron Alexander,8,0,30,22
1657252317447,MATH 18,B01,083748,Rideout; David Porter,4,0,37,33
1657252317447,MATH 18,B02,083749,Rideout; David Porter,4,0,36,32
1657252317447,MATH 18,B03,083750,Rideout; David Porter,2,0,37,35
1657252317447,MATH 18,B04,083751,Rideout; David Porter,6,0,36,30
1657252317447,MATH 18,B05,093473,Rideout; David Porter,5,0,36,31
1657252317447,MATH 18,B06,093474,Rideout; David Porter,5,0,36,31
1657252323477,MATH 20A,A01,083754,Zheng; Zequn,14,0,40,26
1657252329500,MATH 20B,A01,083756,Briones; Jor-el Thomas Caparas,3,0,36,33
1657252329500,MATH 20B,A02,083757,Briones; Jor-el Thomas Caparas,1,0,36,35
1657252329500,MATH 20B,A03,093475,Briones; Jor-el Thomas Caparas,2,0,36,34
1657252335524,MATH 20C,A01,083760,Briones; Jor-el Thomas Caparas,1,0,35,34
1657252335524,MATH 20C,A02,083761,Briones; Jor-el Thomas Caparas,8,0,35,27
1657252335524,MATH 20C,A03,093476,Briones; Jor-el Thomas Caparas,0,1,36,36
1657252335524,MATH 20C,B01,083762,Bach; Quang Tran,1,0,30,29
1657252341560,MATH 20D,A01,083765,Tran; Brian Kha,4,0,30,26
1657252341560,MATH 20D,A02,083766,Tran; Brian Kha,5,0,30,25
1657252341560,MATH 20D,A03,083767,Tran; Brian Kha,4,0,30,26
1657252347588,MATH 20E,A01,083771,Ganguly; Soumya,7,0,32,25
1657252347588,MATH 20E,A02,083772,Ganguly; Soumya,7,0,32,25
1657252347588,MATH 20E,B01,083773,Ciotti; Benjamin,19,0,35,16
1657252347588,MATH 20E,B02,083774,Ciotti; Benjamin,17,0,35,18
1657252353612,MATH 103A,A01,083777,Greenfeld; Be'Eri,3,0,36,33
1657252353612,MATH 103A,A02,083778,Greenfeld; Be'Eri,5,0,36,31
1657252353612,MATH 103A,A03,093561,Greenfeld; Be'Eri,4,0,36,32
1657252353612,MATH 103A,B01,083779,Greenfeld; Be'Eri,6,0,36,30
1657252353612,MATH 103A,B02,083780,Greenfeld; Be'Eri,3,0,36,33
1657252353612,MATH 103A,B03,093562,Greenfeld; Be'Eri,3,0,36,33
1657252359636,MATH 105,A01,085443,Carter; Anne Toulson,15,0,35,20
1657252359636,MATH 105,A02,093477,Carter; Anne Toulson,20,0,35,15
1657252365663,MATH 109,A01,083213,Ganzberger; Geoffrey Michael,2,0,34,32
1657252365663,MATH 109,A02,083214,Ganzberger; Geoffrey Michael,4,0,34,30
1657252365663,MATH 109,A03,093478,Ganzberger; Geoffrey Michael,2,0,34,32
1657252365663,MATH 109,B01,083215,Ganzberger; Geoffrey Michael,1,0,32,31
1657252365663,MATH 109,B02,083216,Ganzberger; Geoffrey Michael,1,0,32,31
1657252365663,MATH 109,B03,093479,Ganzberger; Geoffrey Michael,8,0,32,24
1657252371693,MATH 142A,A01,083219,Chow; Bennett,6,0,32,26
1657252371693,MATH 142A,A02,083220,Chow; Bennett,10,0,32,22
1657252371693,MATH 142A,A03,093480,Chow; Bennett,7,0,32,25
1657252371693,MATH 142A,B03,093481,Chow; Bennett,8,0,32,24
1657252371693,MATH 142A,B04,093558,Chow; Bennett,12,0,32,20
1657252371693,MATH 142A,B05,093559,Chow; Bennett,6,0,32,26
1657252377717,MATH 193A,A01,083224,Rotar; Vladimir,7,0,34,27
1657252377717,MATH 193A,A02,083225,Rotar; Vladimir,6,0,34,28
1657252377717,MATH 193A,A03,083781,Rotar; Vladimir,2,0,34,32
1657252377717,MATH 193A,A04,083782,Rotar; Vladimir,8,0,34,26
1657252377717,MATH 193A,A05,093482,Rotar; Vladimir,6,0,34,28
1657252383740,MATH 197,001,091859,McAuley; Julian John,9999,0,9999,0
1657252383740,MATH 197,002,095566,Kedlaya; Kiran S.,9997,0,9999,2
1657252383740,MATH 197,003,095567,Xiao; Ming,9999,0,9999,0
1657252383740,MATH 197,004,095571,Perols; Johan Lars,9998,0,9999,1
1657252390789,COGS 9,A01,083615,Shannon; Kyle Michael,8,0,75,67
1657252396812,COGS 11,A01,083617,Boyle; Mary E. T.,22,0,48,26
1657252402837,COGS 13,A01,083071,Bastos; Amalia Pinkusfeld,8,0,71,63
1657252408861,COGS 14A,A01,092681,Semenuks; Arturs,2,1,100,98
1657252414886,COGS 14B,A01,083073,Cheng; Tzu-Han,6,0,63,57
1657252420910,COGS 17,A01,092677,Semenuks; Arturs,5,0,81,76
1657252426935,COGS 100,A01,083619,Allen; Michael Gordon,16,0,70,54
1657252432957,COGS 101A,A01,083621,Davis; Joshua Daniel,9,0,68,59
1657252438983,COGS 101B,A01,091572,Allen; Michael Gordon,11,0,65,54
1657252445010,COGS 101C,A01,083625,Delgado; Tania,17,0,35,18
1657252451034,COGS 107A,A01,083627,Boyle; Mary E. T.,13,0,60,47
1657252457060,COGS 118A,A01,083075,Gupta; Anjum,17,0,76,59
1657252463083,CSE 3,A50,083646,Miranda; Gregory Joseph,24,0,50,26
1657252469111,CSE 8A,A50,083650,Miranda; Gregory Joseph,17,1,56,39
1657252475137,CSE 11,A01,083080,Cao; Yingjun,5,15,40,35
1657252481163,CSE 12,A01,083652,Krause-Levy; Sophia Louisa,26,1,120,94
1657252487190,CSE 15L,A01,083654,Morris; Justin Loren,9,0,50,41
1657252487190,CSE 15L,A02,083655,Morris; Justin Loren,9,0,50,41
1657252493212,CSE 20,A01,083657,Tran; Khoa Dang,38,0,80,42
1657252499235,CSE 21,A01,095574,Bach; Quang Tran,22,0,48,26
1657252505265,CSE 30,A01,083084,Eldon; John,4,0,80,76
1657252505265,CSE 30,B01,095061,Bhaskar; Nishant,8,0,50,42
1657252511286,CSE 100,A01,083659,Cao; Yingjun,4,4,70,66
1657252517313,CSE 134B,A01,083661,Powell; Thomas Allan,21,0,100,79
1657252523336,CSE 140,A01,083663,Gungor; Onat,13,0,85,72
1657252529365,CSE 140L,A01,083088,Eldon; John,18,0,100,82
1657252535390,CSE 175,A01,083665,Kumar; Rakesh,3,0,25,22
1657252541414,CSE 190,A00,092507,Dubnov; Shlomo,7,0,20,13
1657252547441,ECE 45,A01,083139,Congero; Spencer William,5,0,75,70
1657252553468,ECE 65,A50,083695,Saad; Andrew S,12,0,30,18
1657252553468,ECE 65,A51,095125,Saad; Andrew S,25,0,26,1
1657252559495,ECE 109,A01,091882,Touri; Behrouz,19,0,70,51
1657252565530,ECE 180,A00,083140,Abi Samra; Nicholas Camill,1,0,30,29
1657252565530,ECE 180,B00,083141,Abi Samra; Nicholas Camill,0,0,30,30
1657252571559,MATH 10A,A01,083735,Patchell; Gregory David,2,0,30,28
1657252571559,MATH 10A,A02,083736,Patchell; Gregory David,20,0,30,10
1657252571559,MATH 10A,A03,083737,Patchell; Gregory David,16,0,30,14
1657252577586,MATH 10B,A01,083207,Lim; Seonhee,7,0,34,27
1657252577586,MATH 10B,A02,083208,Lim; Seonhee,9,0,35,26
1657252577586,MATH 10B,A03,093472,Lim; Seonhee,5,0,34,29
1657252577586,MATH 10B,B01,083739,Sinha; Shubham,11,0,30,19
1657252583611,MATH 18,A01,083743,Cinel; Cameron Alexander,6,0,30,24
1657252583611,MATH 18,A02,083744,Cinel; Cameron Alexander,17,0,30,13
1657252583611,MATH 18,A03,083745,Cinel; Cameron Alexander,8,0,30,22
1657252583611,MATH 18,B01,083748,Rideout; David Porter,4,0,37,33
1657252583611,MATH 18,B02,083749,Rideout; David Porter,4,0,36,32
1657252583611,MATH 18,B03,083750,Rideout; David Porter,2,0,37,35
1657252583611,MATH 18,B04,083751,Rideout; David Porter,6,0,36,30
1657252583611,MATH 18,B05,093473,Rideout; David Porter,5,0,36,31
1657252583611,MATH 18,B06,093474,Rideout; David Porter,5,0,36,31
1657252589636,MATH 20A,A01,083754,Zheng; Zequn,14,0,40,26
1657252595662,MATH 20B,A01,083756,Briones; Jor-el Thomas Caparas,3,0,36,33
1657252595662,MATH 20B,A02,083757,Briones; Jor-el Thomas Caparas,1,0,36,35
1657252595662,MATH 20B,A03,093475,Briones; Jor-el Thomas Caparas,2,0,36,34
1657252601686,MATH 20C,A01,083760,Briones; Jor-el Thomas Caparas,1,0,35,34
1657252601686,MATH 20C,A02,083761,Briones; Jor-el Thomas Caparas,8,0,35,27
1657252601686,MATH 20C,A03,093476,Briones; Jor-el Thomas Caparas,0,1,36,36
1657252601686,MATH 20C,B01,083762,Bach; Quang Tran,1,0,30,29
1657252607714,MATH 20D,A01,083765,Tran; Brian Kha,4,0,30,26
1657252607714,MATH 20D,A02,083766,Tran; Brian Kha,5,0,30,25
1657252607714,MATH 20D,A03,083767,Tran; Brian Kha,4,0,30,26
1657252613743,MATH 20E,A01,083771,Ganguly; Soumya,7,0,32,25
1657252613743,MATH 20E,A02,083772,Ganguly; Soumya,7,0,32,25
1657252613743,MATH 20E,B01,083773,Ciotti; Benjamin,19,0,35,16
1657252613743,MATH 20E,B02,083774,Ciotti; Benjamin,17,0,35,18
1657252619768,MATH 103A,A01,083777,Greenfeld; Be'Eri,3,0,36,33
1657252619768,MATH 103A,A02,083778,Greenfeld; Be'Eri,5,0,36,31
1657252619768,MATH 103A,A03,093561,Greenfeld; Be'Eri,4,0,36,32
1657252619768,MATH 103A,B01,083779,Greenfeld; Be'Eri,6,0,36,30
1657252619768,MATH 103A,B02,083780,Greenfeld; Be'Eri,3,0,36,33
1657252619768,MATH 103A,B03,093562,Greenfeld; Be'Eri,3,0,36,33
1657252625797,MATH 105,A01,085443,Carter; Anne Toulson,15,0,35,20
1657252625797,MATH 105,A02,093477,Carter; Anne Toulson,20,0,35,15
1657252631825,MATH 109,A01,083213,Ganzberger; Geoffrey Michael,2,0,34,32
1657252631825,MATH 109,A02,083214,Ganzberger; Geoffrey Michael,4,0,34,30
1657252631825,MATH 109,A03,093478,Ganzberger; Geoffrey Michael,2,0,34,32
1657252631825,MATH 109,B01,083215,Ganzberger; Geoffrey Michael,1,0,32,31
1657252631825,MATH 109,B02,083216,Ganzberger; Geoffrey Michael,1,0,32,31
1657252631825,MATH 109,B03,093479,Ganzberger; Geoffrey Michael,8,0,32,24
1657252637854,MATH 142A,A01,083219,Chow; Bennett,6,0,32,26
1657252637854,MATH 142A,A02,083220,Chow; Bennett,10,0,32,22
1657252637854,MATH 142A,A03,093480,Chow; Bennett,7,0,32,25
1657252637854,MATH 142A,B03,093481,Chow; Bennett,8,0,32,24
1657252637854,MATH 142A,B04,093558,Chow; Bennett,12,0,32,20
1657252637854,MATH 142A,B05,093559,Chow; Bennett,6,0,32,26
1657252643883,MATH 193A,A01,083224,Rotar; Vladimir,7,0,34,27
1657252643883,MATH 193A,A02,083225,Rotar; Vladimir,6,0,34,28
1657252643883,MATH 193A,A03,083781,Rotar; Vladimir,2,0,34,32
1657252643883,MATH 193A,A04,083782,Rotar; Vladimir,8,0,34,26
1657252643883,MATH 193A,A05,093482,Rotar; Vladimir,6,0,34,28
1657252649909,MATH 197,001,091859,McAuley; Julian John,9999,0,9999,0
1657252649909,MATH 197,002,095566,Kedlaya; Kiran S.,9997,0,9999,2
1657252649909,MATH 197,003,095567,Xiao; Ming,9999,0,9999,0
1657252649909,MATH 197,004,095571,Perols; Johan Lars,9998,0,9999,1
1657252656976,COGS 9,A01,083615,Shannon; Kyle Michael,8,0,75,67
1657252662998,COGS 11,A01,083617,Boyle; Mary E. T.,22,0,48,26
1657252669028,COGS 13,A01,083071,Bastos; Amalia Pinkusfeld,8,0,71,63
1657252675062,COGS 14A,A01,092681,Semenuks; Arturs,2,1,100,98
1657252681097,COGS 14B,A01,083073,Cheng; Tzu-Han,6,0,63,57
1657252687123,COGS 17,A01,092677,Semenuks; Arturs,5,0,81,76
1657252693147,COGS 100,A01,083619,Allen; Michael Gordon,16,0,70,54
1657252699171,COGS 101A,A01,083621,Davis; Joshua Daniel,9,0,68,59
1657252705206,COGS 101B,A01,091572,Allen; Michael Gordon,11,0,65,54
1657252711228,COGS 101C,A01,083625,Delgado; Tania,17,0,35,18
1657252717254,COGS 107A,A01,083627,Boyle; Mary E. T.,13,0,60,47
1657252723276,COGS 118A,A01,083075,Gupta; Anjum,17,0,76,59
1657252729299,CSE 3,A50,083646,Miranda; Gregory Joseph,24,0,50,26
1657252735325,CSE 8A,A50,083650,Miranda; Gregory Joseph,17,1,56,39
1657252741352,CSE 11,A01,083080,Cao; Yingjun,5,15,40,35
1657252747375,CSE 12,A01,083652,Krause-Levy; Sophia Louisa,26,1,120,94
1657252753487,CSE 15L,A01,083654,Morris; Justin Loren,9,0,50,41
1657252753487,CSE 15L,A02,083655,Morris; Justin Loren,9,0,50,41
1657252759513,CSE 20,A01,083657,Tran; Khoa Dang,38,0,80,42
1657252765540,CSE 21,A01,095574,Bach; Quang Tran,22,0,48,26
1657252771567,CSE 30,A01,083084,Eldon; John,4,0,80,76
1657252771567,CSE 30,B01,095061,Bhaskar; Nishant,8,0,50,42
1657252777592,CSE 100,A01,083659,Cao; Yingjun,4,4,70,66
1657252783616,CSE 134B,A01,083661,Powell; Thomas Allan,21,0,100,79
1657252789643,CSE 140,A01,083663,Gungor; Onat,13,0,85,72
1657252795670,CSE 140L,A01,083088,Eldon; John,18,0,100,82
1657252801696,CSE 175,A01,083665,Kumar; Rakesh,3,0,25,22
1657252807717,CSE 190,A00,092507,Dubnov; Shlomo,7,0,20,13
1657252813739,ECE 45,A01,083139,Congero; Spencer William,5,0,75,70
1657252819765,ECE 65,A50,083695,Saad; Andrew S,12,0,30,18
1657252819765,ECE 65,A51,095125,Saad; Andrew S,25,0,26,1
1657252825790,ECE 109,A01,091882,Touri; Behrouz,19,0,70,51
1657252831817,ECE 180,A00,083140,Abi Samra; Nicholas Camill,1,0,30,29
1657252831817,ECE 180,B00,083141,Abi Samra; Nicholas Camill,0,0,30,30
1657252837844,MATH 10A,A01,083735,Patchell; Gregory David,2,0,30,28
1657252837844,MATH 10A,A02,083736,Patchell; Gregory David,20,0,30,10
1657252837844,MATH 10A,A03,083737,Patchell; Gregory David,16,0,30,14
1657252843878,MATH 10B,A01,083207,Lim; Seonhee,7,0,34,27
1657252843878,MATH 10B,A02,083208,Lim; Seonhee,9,0,35,26
1657252843878,MATH 10B,A03,093472,Lim; Seonhee,5,0,34,29
1657252843878,MATH 10B,B01,083739,Sinha; Shubham,11,0,30,19
1657252849912,MATH 18,A01,083743,Cinel; Cameron Alexander,6,0,30,24
1657252849912,MATH 18,A02,083744,Cinel; Cameron Alexander,17,0,30,13
1657252849912,MATH 18,A03,083745,Cinel; Cameron Alexander,8,0,30,22
1657252849912,MATH 18,B01,083748,Rideout; David Porter,4,0,37,33
1657252849912,MATH 18,B02,083749,Rideout; David Porter,4,0,36,32
1657252849912,MATH 18,B03,083750,Rideout; David Porter,2,0,37,35
1657252849912,MATH 18,B04,083751,Rideout; David Porter,6,0,36,30
1657252849912,MATH 18,B05,093473,Rideout; David Porter,5,0,36,31
1657252849912,MATH 18,B06,093474,Rideout; David Porter,5,0,36,31
1657252855947,MATH 20A,A01,083754,Zheng; Zequn,14,0,40,26
1657252861980,MATH 20B,A01,083756,Briones; Jor-el Thomas Caparas,3,0,36,33
1657252861980,MATH 20B,A02,083757,Briones; Jor-el Thomas Caparas,1,0,36,35
1657252861980,MATH 20B,A03,093475,Briones; Jor-el Thomas Caparas,2,0,36,34
1657252868004,MATH 20C,A01,083760,Briones; Jor-el Thomas Caparas,1,0,35,34
1657252868004,MATH 20C,A02,083761,Briones; Jor-el Thomas Caparas,8,0,35,27
1657252868004,MATH 20C,A03,093476,Briones; Jor-el Thomas Caparas,0,1,36,36
1657252868004,MATH 20C,B01,083762,Bach; Quang Tran,1,0,30,29
1657252874030,MATH 20D,A01,083765,Tran; Brian Kha,4,0,30,26
1657252874030,MATH 20D,A02,083766,Tran; Brian Kha,5,0,30,25
1657252874030,MATH 20D,A03,083767,Tran; Brian Kha,4,0,30,26
1657252880054,MATH 20E,A01,083771,Ganguly; Soumya,7,0,32,25
1657252880054,MATH 20E,A02,083772,Ganguly; Soumya,7,0,32,25
1657252880054,MATH 20E,B01,083773,Ciotti; Benjamin,19,0,35,16
1657252880054,MATH 20E,B02,083774,Ciotti; Benjamin,17,0,35,18
1657252886079,MATH 103A,A01,083777,Greenfeld; Be'Eri,3,0,36,33
1657252886079,MATH 103A,A02,083778,Greenfeld; Be'Eri,5,0,36,31
1657252886079,MATH 103A,A03,093561,Greenfeld; Be'Eri,4,0,36,32
1657252886079,MATH 103A,B01,083779,Greenfeld; Be'Eri,6,0,36,30
1657252886079,MATH 103A,B02,083780,Greenfeld; Be'Eri,3,0,36,33
1657252886079,MATH 103A,B03,093562,Greenfeld; Be'Eri,3,0,36,33
1657252892101,MATH 105,A01,085443,Carter; Anne Toulson,15,0,35,20
1657252892101,MATH 105,A02,093477,Carter; Anne Toulson,20,0,35,15
1657252898129,MATH 109,A01,083213,Ganzberger; Geoffrey Michael,2,0,34,32
1657252898129,MATH 109,A02,083214,Ganzberger; Geoffrey Michael,4,0,34,30
1657252898129,MATH 109,A03,093478,Ganzberger; Geoffrey Michael,2,0,34,32
1657252898129,MATH 109,B01,083215,Ganzberger; Geoffrey Michael,1,0,32,31
1657252898129,MATH 109,B02,083216,Ganzberger; Geoffrey Michael,1,0,32,31
1657252898129,MATH 109,B03,093479,Ganzberger; Geoffrey Michael,8,0,32,24
1657252904158,MATH 142A,A01,083219,Chow; Bennett,6,0,32,26
1657252904158,MATH 142A,A02,083220,Chow; Bennett,10,0,32,22
1657252904158,MATH 142A,A03,093480,Chow; Bennett,7,0,32,25
1657252904158,MATH 142A,B03,093481,Chow; Bennett,8,0,32,24
1657252904158,MATH 142A,B04,093558,Chow; Bennett,12,0,32,20
1657252904158,MATH 142A,B05,093559,Chow; Bennett,6,0,32,26
1657252910183,MATH 193A,A01,083224,Rotar; Vladimir,7,0,34,27
1657252910183,MATH 193A,A02,083225,Rotar; Vladimir,6,0,34,28
1657252910183,MATH 193A,A03,083781,Rotar; Vladimir,2,0,34,32
1657252910183,MATH 193A,A04,083782,Rotar; Vladimir,8,0,34,26
1657252910183,MATH 193A,A05,093482,Rotar; Vladimir,6,0,34,28
1657252916205,MATH 197,001,091859,McAuley; Julian John,9999,0,9999,0
1657252916205,MATH 197,002,095566,Kedlaya; Kiran S.,9997,0,9999,2
1657252916205,MATH 197,003,095567,Xiao; Ming,9999,0,9999,0
1657252916205,MATH 197,004,095571,Perols; Johan Lars,9998,0,9999,1
1657252923257,COGS 9,A01,083615,Shannon; Kyle Michael,8,0,75,67
1657252929280,COGS 11,A01,083617,Boyle; Mary E. T.,22,0,48,26
1657252935318,COGS 13,A01,083071,Bastos; Amalia Pinkusfeld,8,0,71,63
1657252941347,COGS 14A,A01,092681,Semenuks; Arturs,2,1,100,98
1657252947380,COGS 14B,A01,083073,Cheng; Tzu-Han,6,0,63,57
1657252953404,COGS 17,A01,092677,Semenuks; Arturs,5,0,81,76
1657252959428,COGS 100,A01,083619,Allen; Michael Gordon,16,0,70,54
1657252965451,COGS 101A,A01,083621,Davis; Joshua Daniel,9,0,68,59
1657252971476,COGS 101B,A01,091572,Allen; Michael Gordon,11,0,65,54
1657252977500,COGS 101C,A01,083625,Delgado; Tania,17,0,35,18
1657252983523,COGS 107A,A01,083627,Boyle; Mary E. T.,13,0,60,47
1657252989549,COGS 118A,A01,083075,Gupta; Anjum,17,0,76,59
1657252995574,CSE 3,A50,083646,Miranda; Gregory Joseph,24,0,50,26
1657253001597,CSE 8A,A50,083650,Miranda; Gregory Joseph,17,1,56,39
1657253007622,CSE 11,A01,083080,Cao; Yingjun,5,15,40,35
1657253013649,CSE 12,A01,083652,Krause-Levy; Sophia Louisa,26,1,120,94
1657253019672,CSE 15L,A01,083654,Morris; Justin Loren,9,0,50,41
1657253019672,CSE 15L,A02,083655,Morris; Justin Loren,9,0,50,41
1657253025699,CSE 20,A01,083657,Tran; Khoa Dang,38,0,80,42
1657253031733,CSE 21,A01,095574,Bach; Quang Tran,22,0,48,26
1657253037755,CSE 30,A01,083084,Eldon; John,4,0,80,76
1657253037755,CSE 30,B01,095061,Bhaskar; Nishant,8,0,50,42
1657253043777,CSE 100,A01,083659,Cao; Yingjun,4,4,70,66
1657253049801,CSE 134B,A01,083661,Powell; Thomas Allan,21,0,100,79
1657253055826,CSE 140,A01,083663,Gungor; Onat,13,0,85,72
1657253061858,CSE 140L,A01,083088,Eldon; John,18,0,100,82
1657253067885,CSE 175,A01,083665,Kumar; Rakesh,3,0,25,22
1657253073908,CSE 190,A00,092507,Dubnov; Shlomo,7,0,20,13
1657253079932,ECE 45,A01,083139,Congero; Spencer William,5,0,75,70
1657253085961,ECE 65,A50,083695,Saad; Andrew S,12,0,30,18
1657253085961,ECE 65,A51,095125,Saad; Andrew S,25,0,26,1
1657253091986,ECE 109,A01,091882,Touri; Behrouz,19,0,70,51
1657253098020,ECE 180,A00,083140,Abi Samra; Nicholas Camill,1,0,30,29
1657253098020,ECE 180,B00,083141,Abi Samra; Nicholas Camill,0,0,30,30
1657253104048,MATH 10A,A01,083735,Patchell; Gregory David,2,0,30,28
1657253104048,MATH 10A,A02,083736,Patchell; Gregory David,20,0,30,10
1657253104048,MATH 10A,A03,083737,Patchell; Gregory David,16,0,30,14
1657253110077,MATH 10B,A01,083207,Lim; Seonhee,7,0,34,27
1657253110077,MATH 10B,A02,083208,Lim; Seonhee,9,0,35,26
1657253110077,MATH 10B,A03,093472,Lim; Seonhee,5,0,34,29
1657253110077,MATH 10B,B01,083739,Sinha; Shubham,11,0,30,19
1657253116101,MATH 18,A01,083743,Cinel; Cameron Alexander,6,0,30,24
1657253116101,MATH 18,A02,083744,Cinel; Cameron Alexander,17,0,30,13
1657253116101,MATH 18,A03,083745,Cinel; Cameron Alexander,8,0,30,22
1657253116101,MATH 18,B01,083748,Rideout; David Porter,4,0,37,33
1657253116101,MATH 18,B02,083749,Rideout; David Porter,4,0,36,32
1657253116101,MATH 18,B03,083750,Rideout; David Porter,2,0,37,35
1657253116101,MATH 18,B04,083751,Rideout; David Porter,6,0,36,30
1657253116101,MATH 18,B05,093473,Rideout; David Porter,5,0,36,31
1657253116101,MATH 18,B06,093474,Rideout; David Porter,5,0,36,31
1657253122136,MATH 20A,A01,083754,Zheng; Zequn,14,0,40,26
1657253128179,MATH 20B,A01,083756,Briones; Jor-el Thomas Caparas,3,0,36,33
1657253128179,MATH 20B,A02,083757,Briones; Jor-el Thomas Caparas,1,0,36,35
1657253128179,MATH 20B,A03,093475,Briones; Jor-el Thomas Caparas,2,0,36,34
1657253134205,MATH 20C,A01,083760,Briones; Jor-el Thomas Caparas,1,0,35,34
1657253134205,MATH 20C,A02,083761,Briones; Jor-el Thomas Caparas,8,0,35,27
1657253134205,MATH 20C,A03,093476,Briones; Jor-el Thomas Caparas,0,1,36,36
1657253134205,MATH 20C,B01,083762,Bach; Quang Tran,1,0,30,29
1657253140236,MATH 20D,A01,083765,Tran; Brian Kha,4,0,30,26
1657253140236,MATH 20D,A02,083766,Tran; Brian Kha,5,0,30,25
1657253140236,MATH 20D,A03,083767,Tran; Brian Kha,4,0,30,26
1657253146260,MATH 20E,A01,083771,Ganguly; Soumya,7,0,32,25
1657253146260,MATH 20E,A02,083772,Ganguly; Soumya,7,0,32,25
1657253146260,MATH 20E,B01,083773,Ciotti; Benjamin,19,0,35,16
1657253146260,MATH 20E,B02,083774,Ciotti; Benjamin,17,0,35,18
1657253152291,MATH 103A,A01,083777,Greenfeld; Be'Eri,3,0,36,33
1657253152291,MATH 103A,A02,083778,Greenfeld; Be'Eri,5,0,36,31
1657253152291,MATH 103A,A03,093561,Greenfeld; Be'Eri,4,0,36,32
1657253152291,MATH 103A,B01,083779,Greenfeld; Be'Eri,6,0,36,30
1657253152291,MATH 103A,B02,083780,Greenfeld; Be'Eri,3,0,36,33
1657253152291,MATH 103A,B03,093562,Greenfeld; Be'Eri,3,0,36,33
1657253158319,MATH 105,A01,085443,Carter; Anne Toulson,15,0,35,20
1657253158319,MATH 105,A02,093477,Carter; Anne Toulson,20,0,35,15
1657253164344,MATH 109,A01,083213,Ganzberger; Geoffrey Michael,2,0,34,32
1657253164344,MATH 109,A02,083214,Ganzberger; Geoffrey Michael,4,0,34,30
1657253164344,MATH 109,A03,093478,Ganzberger; Geoffrey Michael,2,0,34,32
1657253164344,MATH 109,B01,083215,Ganzberger; Geoffrey Michael,1,0,32,31
1657253164344,MATH 109,B02,083216,Ganzberger; Geoffrey Michael,1,0,32,31
1657253164344,MATH 109,B03,093479,Ganzberger; Geoffrey Michael,8,0,32,24
1657253170369,MATH 142A,A01,083219,Chow; Bennett,6,0,32,26
1657253170369,MATH 142A,A02,083220,Chow; Bennett,10,0,32,22
1657253170369,MATH 142A,A03,093480,Chow; Bennett,7,0,32,25
1657253170369,MATH 142A,B03,093481,Chow; Bennett,8,0,32,24
1657253170369,MATH 142A,B04,093558,Chow; Bennett,12,0,32,20
1657253170369,MATH 142A,B05,093559,Chow; Bennett,6,0,32,26
1657253176392,MATH 193A,A01,083224,Rotar; Vladimir,7,0,34,27
1657253176392,MATH 193A,A02,083225,Rotar; Vladimir,6,0,34,28
1657253176392,MATH 193A,A03,083781,Rotar; Vladimir,2,0,34,32
1657253176392,MATH 193A,A04,083782,Rotar; Vladimir,8,0,34,26
1657253176392,MATH 193A,A05,093482,Rotar; Vladimir,6,0,34,28
1657253182415,MATH 197,001,091859,McAuley; Julian John,9999,0,9999,0
1657253182415,MATH 197,002,095566,Kedlaya; Kiran S.,9997,0,9999,2
1657253182415,MATH 197,003,095567,Xiao; Ming,9999,0,9999,0
1657253182415,MATH 197,004,095571,Perols; Johan Lars,9998,0,9999,1
1657253189466,COGS 9,A01,083615,Shannon; Kyle Michael,8,0,75,67
1657253195497,COGS 11,A01,083617,Boyle; Mary E. T.,22,0,48,26
1657253201520,COGS 13,A01,083071,Bastos; Amalia Pinkusfeld,8,0,71,63
1657253207542,COGS 14A,A01,092681,Semenuks; Arturs,2,1,100,98
1657253213571,COGS 14B,A01,083073,Cheng; Tzu-Han,6,0,63,57
1657253219596,COGS 17,A01,092677,Semenuks; Arturs,5,0,81,76
1657253225618,COGS 100,A01,083619,Allen; Michael Gordon,16,0,70,54
1657253231657,COGS 101A,A01,083621,Davis; Joshua Daniel,9,0,68,59
1657253237682,COGS 101B,A01,091572,Allen; Michael Gordon,11,0,65,54
1657253243719,COGS 101C,A01,083625,Delgado; Tania,17,0,35,18
1657253249742,COGS 107A,A01,083627,Boyle; Mary E. T.,13,0,60,47
1657253255778,COGS 118A,A01,083075,Gupta; Anjum,18,0,76,58
1657253261807,CSE 3,A50,083646,Miranda; Gregory Joseph,24,0,50,26
1657253267835,CSE 8A,A50,083650,Miranda; Gregory Joseph,17,1,56,39
1657253273862,CSE 11,A01,083080,Cao; Yingjun,5,15,40,35
1657253279884,CSE 12,A01,083652,Krause-Levy; Sophia Louisa,26,1,120,94
1657253285914,CSE 15L,A01,083654,Morris; Justin Loren,9,0,50,41
1657253285914,CSE 15L,A02,083655,Morris; Justin Loren,9,0,50,41
1657253291945,CSE 20,A01,083657,Tran; Khoa Dang,38,0,80,42
1657253297969,CSE 21,A01,095574,Bach; Quang Tran,22,0,48,26
1657253303991,CSE 30,A01,083084,Eldon; John,4,0,80,76
1657253303991,CSE 30,B01,095061,Bhaskar; Nishant,8,0,50,42
1657253310016,CSE 100,A01,083659,Cao; Yingjun,4,4,70,66
1657253316046,CSE 134B,A01,083661,Powell; Thomas Allan,21,0,100,79
1657253322070,CSE 140,A01,083663,Gungor; Onat,13,0,85,72
1657253328102,CSE 140L,A01,083088,Eldon; John,18,0,100,82
1657253334128,CSE 175,A01,083665,Kumar; Rakesh,3,0,25,22
1657253340159,CSE 190,A00,092507,Dubnov; Shlomo,7,0,20,13
1657253346187,ECE 45,A01,083139,Congero; Spencer William,5,0,75,70
1657253352300,ECE 65,A50,083695,Saad; Andrew S,12,0,30,18
1657253352300,ECE 65,A51,095125,Saad; Andrew S,25,0,26,1
1657253358326,ECE 109,A01,091882,Touri; Behrouz,19,0,70,51
1657253364354,ECE 180,A00,083140,Abi Samra; Nicholas Camill,1,0,30,29
1657253364354,ECE 180,B00,083141,Abi Samra; Nicholas Camill,0,0,30,30
1657253370379,MATH 10A,A01,083735,Patchell; Gregory David,2,0,30,28
1657253370379,MATH 10A,A02,083736,Patchell; Gregory David,20,0,30,10
1657253370379,MATH 10A,A03,083737,Patchell; Gregory David,16,0,30,14
1657253376408,MATH 10B,A01,083207,Lim; Seonhee,7,0,34,27
1657253376408,MATH 10B,A02,083208,Lim; Seonhee,9,0,35,26
1657253376408,MATH 10B,A03,093472,Lim; Seonhee,5,0,34,29
1657253376408,MATH 10B,B01,083739,Sinha; Shubham,11,0,30,19
1657253382433,MATH 18,A01,083743,Cinel; Cameron Alexander,6,0,30,24
1657253382433,MATH 18,A02,083744,Cinel; Cameron Alexander,17,0,30,13
1657253382433,MATH 18,A03,083745,Cinel; Cameron Alexander,8,0,30,22
1657253382433,MATH 18,B01,083748,Rideout; David Porter,4,0,37,33
1657253382433,MATH 18,B02,083749,Rideout; David Porter,4,0,36,32
1657253382433,MATH 18,B03,083750,Rideout; David Porter,2,0,37,35
1657253382433,MATH 18,B04,083751,Rideout; David Porter,6,0,36,30
1657253382433,MATH 18,B05,093473,Rideout; David Porter,5,0,36,31
1657253382433,MATH 18,B06,093474,Rideout; David Porter,5,0,36,31
1657253388456,MATH 20A,A01,083754,Zheng; Zequn,14,0,40,26
1657253394480,MATH 20B,A01,083756,Briones; Jor-el Thomas Caparas,3,0,36,33
1657253394480,MATH 20B,A02,083757,Briones; Jor-el Thomas Caparas,1,0,36,35
1657253394480,MATH 20B,A03,093475,Briones; Jor-el Thomas Caparas,2,0,36,34
1657253400515,MATH 20C,A01,083760,Briones; Jor-el Thomas Caparas,1,0,35,34
1657253400515,MATH 20C,A02,083761,Briones; Jor-el Thomas Caparas,8,0,35,27
1657253400515,MATH 20C,A03,093476,Briones; Jor-el Thomas Caparas,0,1,36,36
1657253400515,MATH 20C,B01,083762,Bach; Quang Tran,1,0,30,29
1657253406551,MATH 20D,A01,083765,Tran; Brian Kha,4,0,30,26
1657253406551,MATH 20D,A02,083766,Tran; Brian Kha,5,0,30,25
1657253406551,MATH 20D,A03,083767,Tran; Brian Kha,4,0,30,26
1657253412589,MATH 20E,A01,083771,Ganguly; Soumya,7,0,32,25
1657253412589,MATH 20E,A02,083772,Ganguly; Soumya,7,0,32,25
1657253412589,MATH 20E,B01,083773,Ciotti; Benjamin,19,0,35,16
1657253412589,MATH 20E,B02,083774,Ciotti; Benjamin,17,0,35,18
1657253418613,MATH 103A,A01,083777,Greenfeld; Be'Eri,3,0,36,33
1657253418613,MATH 103A,A02,083778,Greenfeld; Be'Eri,5,0,36,31
1657253418613,MATH 103A,A03,093561,Greenfeld; Be'Eri,4,0,36,32
1657253418613,MATH 103A,B01,083779,Greenfeld; Be'Eri,6,0,36,30
1657253418613,MATH 103A,B02,083780,Greenfeld; Be'Eri,3,0,36,33
1657253418613,MATH 103A,B03,093562,Greenfeld; Be'Eri,3,0,36,33
1657253424644,MATH 105,A01,085443,Carter; Anne Toulson,15,0,35,20
1657253424644,MATH 105,A02,093477,Carter; Anne Toulson,20,0,35,15
1657253430673,MATH 109,A01,083213,Ganzberger; Geoffrey Michael,2,0,34,32
1657253430673,MATH 109,A02,083214,Ganzberger; Geoffrey Michael,4,0,34,30
1657253430673,MATH 109,A03,093478,Ganzberger; Geoffrey Michael,2,0,34,32
1657253430673,MATH 109,B01,083215,Ganzberger; Geoffrey Michael,1,0,32,31
1657253430673,MATH 109,B02,083216,Ganzberger; Geoffrey Michael,1,0,32,31
1657253430673,MATH 109,B03,093479,Ganzberger; Geoffrey Michael,8,0,32,24
1657253436698,MATH 142A,A01,083219,Chow; Bennett,6,0,32,26
1657253436698,MATH 142A,A02,083220,Chow; Bennett,10,0,32,22
1657253436698,MATH 142A,A03,093480,Chow; Bennett,7,0,32,25
1657253436698,MATH 142A,B03,093481,Chow; Bennett,8,0,32,24
1657253436698,MATH 142A,B04,093558,Chow; Bennett,12,0,32,20
1657253436698,MATH 142A,B05,093559,Chow; Bennett,6,0,32,26
1657253442723,MATH 193A,A01,083224,Rotar; Vladimir,7,0,34,27
1657253442723,MATH 193A,A02,083225,Rotar; Vladimir,6,0,34,28
1657253442723,MATH 193A,A03,083781,Rotar; Vladimir,2,0,34,32
1657253442723,MATH 193A,A04,083782,Rotar; Vladimir,8,0,34,26
1657253442723,MATH 193A,A05,093482,Rotar; Vladimir,6,0,34,28
1657253448745,MATH 197,001,091859,McAuley; Julian John,9999,0,9999,0
1657253448745,MATH 197,002,095566,Kedlaya; Kiran S.,9997,0,9999,2
1657253448745,MATH 197,003,095567,Xiao; Ming,9999,0,9999,0
1657253448745,MATH 197,004,095571,Perols; Johan Lars,9998,0,9999,1
1657253455810,COGS 9,A01,083615,Shannon; Kyle Michael,8,0,75,67
1657253461839,COGS 11,A01,083617,Boyle; Mary E. T.,22,0,48,26
1657253467864,COGS 13,A01,083071,Bastos; Amalia Pinkusfeld,8,0,71,63
1657253473887,COGS 14A,A01,092681,Semenuks; Arturs,2,1,100,98
1657253479911,COGS 14B,A01,083073,Cheng; Tzu-Han,6,0,63,57
1657253485937,COGS 17,A01,092677,Semenuks; Arturs,5,0,81,76
1657253491961,COGS 100,A01,083619,Allen; Michael Gordon,16,0,70,54
1657253497984,COGS 101A,A01,083621,Davis; Joshua Daniel,9,0,68,59
1657253504010,COGS 101B,A01,091572,Allen; Michael Gordon,11,0,65,54
1657253510035,COGS 101C,A01,083625,Delgado; Tania,17,0,35,18
1657253516063,COGS 107A,A01,083627,Boyle; Mary E. T.,13,0,60,47
1657253522087,COGS 118A,A01,083075,Gupta; Anjum,18,0,76,58
1657253528111,CSE 3,A50,083646,Miranda; Gregory Joseph,24,0,50,26
1657253534135,CSE 8A,A50,083650,Miranda; Gregory Joseph,17,1,56,39
1657253540163,CSE 11,A01,083080,Cao; Yingjun,5,15,40,35
1657253546190,CSE 12,A01,083652,Krause-Levy; Sophia Louisa,26,1,120,94
1657253552214,CSE 15L,A01,083654,Morris; Justin Loren,9,0,50,41
1657253552214,CSE 15L,A02,083655,Morris; Justin Loren,9,0,50,41
1657253558238,CSE 20,A01,083657,Tran; Khoa Dang,38,0,80,42
1657253564263,CSE 21,A01,095574,Bach; Quang Tran,22,0,48,26
1657253570291,CSE 30,A01,083084,Eldon; John,4,0,80,76
1657253570291,CSE 30,B01,095061,Bhaskar; Nishant,8,0,50,42
1657253576318,CSE 100,A01,083659,Cao; Yingjun,4,4,70,66
1657253582342,CSE 134B,A01,083661,Powell; Thomas Allan,21,0,100,79
1657253588365,CSE 140,A01,083663,Gungor; Onat,13,0,85,72
1657253594387,CSE 140L,A01,083088,Eldon; John,18,0,100,82
1657253600410,CSE 175,A01,083665,Kumar; Rakesh,3,0,25,22
1657253606433,CSE 190,A00,092507,Dubnov; Shlomo,7,0,20,13
1657253612460,ECE 45,A01,083139,Congero; Spencer William,5,0,75,70
1657253618486,ECE 65,A50,083695,Saad; Andrew S,12,0,30,18
1657253618486,ECE 65,A51,095125,Saad; Andrew S,25,0,26,1
1657253624513,ECE 109,A01,091882,Touri; Behrouz,19,0,70,51
1657253630546,ECE 180,A00,083140,Abi Samra; Nicholas Camill,1,0,30,29
1657253630546,ECE 180,B00,083141,Abi Samra; Nicholas Camill,0,0,30,30
1657253636572,MATH 10A,A01,083735,Patchell; Gregory David,2,0,30,28
1657253636572,MATH 10A,A02,083736,Patchell; Gregory David,20,0,30,10
1657253636572,MATH 10A,A03,083737,Patchell; Gregory David,16,0,30,14
1657253642597,MATH 10B,A01,083207,Lim; Seonhee,7,0,34,27
1657253642597,MATH 10B,A02,083208,Lim; Seonhee,9,0,35,26
1657253642597,MATH 10B,A03,093472,Lim; Seonhee,5,0,34,29
1657253642597,MATH 10B,B01,083739,Sinha; Shubham,11,0,30,19
1657253648629,MATH 18,A01,083743,Cinel; Cameron Alexander,6,0,30,24
1657253648629,MATH 18,A02,083744,Cinel; Cameron Alexander,17,0,30,13
1657253648629,MATH 18,A03,083745,Cinel; Cameron Alexander,8,0,30,22
1657253648629,MATH 18,B01,083748,Rideout; David Porter,4,0,37,33
1657253648629,MATH 18,B02,083749,Rideout; David Porter,4,0,36,32
1657253648629,MATH 18,B03,083750,Rideout; David Porter,2,0,37,35
1657253648629,MATH 18,B04,083751,Rideout; David Porter,6,0,36,30
1657253648629,MATH 18,B05,093473,Rideout; David Porter,5,0,36,31
1657253648629,MATH 18,B06,093474,Rideout; David Porter,5,0,36,31
1657253654660,MATH 20A,A01,083754,Zheng; Zequn,14,0,40,26
1657253660683,MATH 20B,A01,083756,Briones; Jor-el Thomas Caparas,3,0,36,33
1657253660683,MATH 20B,A02,083757,Briones; Jor-el Thomas Caparas,1,0,36,35
1657253660683,MATH 20B,A03,093475,Briones; Jor-el Thomas Caparas,2,0,36,34
1657253666706,MATH 20C,A01,083760,Briones; Jor-el Thomas Caparas,1,0,35,34
1657253666706,MATH 20C,A02,083761,Briones; Jor-el Thomas Caparas,8,0,35,27
1657253666706,MATH 20C,A03,093476,Briones; Jor-el Thomas Caparas,0,1,36,36
1657253666706,MATH 20C,B01,083762,Bach; Quang Tran,1,0,30,29
1657253672731,MATH 20D,A01,083765,Tran; Brian Kha,4,0,30,26
1657253672731,MATH 20D,A02,083766,Tran; Brian Kha,5,0,30,25
1657253672731,MATH 20D,A03,083767,Tran; Brian Kha,4,0,30,26
1657253678754,MATH 20E,A01,083771,Ganguly; Soumya,7,0,32,25
1657253678754,MATH 20E,A02,083772,Ganguly; Soumya,7,0,32,25
1657253678754,MATH 20E,B01,083773,Ciotti; Benjamin,19,0,35,16
1657253678754,MATH 20E,B02,083774,Ciotti; Benjamin,17,0,35,18
1657253684778,MATH 103A,A01,083777,Greenfeld; Be'Eri,3,0,36,33
1657253684778,MATH 103A,A02,083778,Greenfeld; Be'Eri,5,0,36,31
1657253684778,MATH 103A,A03,093561,Greenfeld; Be'Eri,4,0,36,32
1657253684778,MATH 103A,B01,083779,Greenfeld; Be'Eri,6,0,36,30
1657253684778,MATH 103A,B02,083780,Greenfeld; Be'Eri,3,0,36,33
1657253684778,MATH 103A,B03,093562,Greenfeld; Be'Eri,3,0,36,33
1657253690806,MATH 105,A01,085443,Carter; Anne Toulson,15,0,35,20
1657253690806,MATH 105,A02,093477,Carter; Anne Toulson,20,0,35,15
1657253696830,MATH 109,A01,083213,Ganzberger; Geoffrey Michael,2,0,34,32
1657253696830,MATH 109,A02,083214,Ganzberger; Geoffrey Michael,4,0,34,30
1657253696830,MATH 109,A03,093478,Ganzberger; Geoffrey Michael,2,0,34,32
1657253696830,MATH 109,B01,083215,Ganzberger; Geoffrey Michael,1,0,32,31
1657253696830,MATH 109,B02,083216,Ganzberger; Geoffrey Michael,1,0,32,31
1657253696830,MATH 109,B03,093479,Ganzberger; Geoffrey Michael,8,0,32,24
1657253702853,MATH 142A,A01,083219,Chow; Bennett,6,0,32,26
1657253702853,MATH 142A,A02,083220,Chow; Bennett,10,0,32,22
1657253702853,MATH 142A,A03,093480,Chow; Bennett,7,0,32,25
1657253702853,MATH 142A,B03,093481,Chow; Bennett,8,0,32,24
1657253702853,MATH 142A,B04,093558,Chow; Bennett,12,0,32,20
1657253702853,MATH 142A,B05,093559,Chow; Bennett,6,0,32,26
1657253708876,MATH 193A,A01,083224,Rotar; Vladimir,7,0,34,27
1657253708876,MATH 193A,A02,083225,Rotar; Vladimir,6,0,34,28
1657253708876,MATH 193A,A03,083781,Rotar; Vladimir,2,0,34,32
1657253708876,MATH 193A,A04,083782,Rotar; Vladimir,8,0,34,26
1657253708876,MATH 193A,A05,093482,Rotar; Vladimir,6,0,34,28
1657253714899,MATH 197,001,091859,McAuley; Julian John,9999,0,9999,0
1657253714899,MATH 197,002,095566,Kedlaya; Kiran S.,9997,0,9999,2
1657253714899,MATH 197,003,095567,Xiao; Ming,9999,0,9999,0
1657253714899,MATH 197,004,095571,Perols; Johan Lars,9998,0,9999,1
1657253721959,COGS 9,A01,083615,Shannon; Kyle Michael,8,0,75,67
1657253727982,COGS 11,A01,083617,Boyle; Mary E. T.,22,0,48,26
1657253734012,COGS 13,A01,083071,Bastos; Amalia Pinkusfeld,8,0,71,63
1657253740036,COGS 14A,A01,092681,Semenuks; Arturs,2,1,100,98
1657253746062,COGS 14B,A01,083073,Cheng; Tzu-Han,6,0,63,57
1657253752087,COGS 17,A01,092677,Semenuks; Arturs,5,0,81,76
1657253758113,COGS 100,A01,083619,Allen; Michael Gordon,16,0,70,54
1657253764149,COGS 101A,A01,083621,Davis; Joshua Daniel,9,0,68,59
1657253770173,COGS 101B,A01,091572,Allen; Michael Gordon,11,0,65,54
1657253776197,COGS 101C,A01,083625,Delgado; Tania,17,0,35,18
1657253782228,COGS 107A,A01,083627,Boyle; Mary E. T.,13,0,60,47
1657253788256,COGS 118A,A01,083075,Gupta; Anjum,18,0,76,58
1657253794280,CSE 3,A50,083646,Miranda; Gregory Joseph,24,0,50,26
1657253800305,CSE 8A,A50,083650,Miranda; Gregory Joseph,17,1,56,39
1657253806332,CSE 11,A01,083080,Cao; Yingjun,5,15,40,35
1657253812354,CSE 12,A01,083652,Krause-Levy; Sophia Louisa,26,1,120,94
1657253818378,CSE 15L,A01,083654,Morris; Justin Loren,9,0,50,41
1657253818378,CSE 15L,A02,083655,Morris; Justin Loren,9,0,50,41
1657253824404,CSE 20,A01,083657,Tran; Khoa Dang,38,0,80,42
1657253830433,CSE 21,A01,095574,Bach; Quang Tran,22,0,48,26
1657253836460,CSE 30,A01,083084,Eldon; John,4,0,80,76
1657253836460,CSE 30,B01,095061,Bhaskar; Nishant,8,0,50,42
1657253842486,CSE 100,A01,083659,Cao; Yingjun,4,4,70,66
1657253848510,CSE 134B,A01,083661,Powell; Thomas Allan,21,0,100,79
1657253854533,CSE 140,A01,083663,Gungor; Onat,13,0,85,72
1657253860560,CSE 140L,A01,083088,Eldon; John,18,0,100,82
1657253866584,CSE 175,A01,083665,Kumar; Rakesh,3,0,25,22
1657253872611,CSE 190,A00,092507,Dubnov; Shlomo,7,0,20,13
1657253878639,ECE 45,A01,083139,Congero; Spencer William,5,0,75,70
1657253884661,ECE 65,A50,083695,Saad; Andrew S,12,0,30,18
1657253884661,ECE 65,A51,095125,Saad; Andrew S,25,0,26,1
1657253890688,ECE 109,A01,091882,Touri; Behrouz,19,0,70,51
1657253896715,ECE 180,A00,083140,Abi Samra; Nicholas Camill,1,0,30,29
1657253896715,ECE 180,B00,083141,Abi Samra; Nicholas Camill,0,0,30,30
1657253902737,MATH 10A,A01,083735,Patchell; Gregory David,2,0,30,28
1657253902737,MATH 10A,A02,083736,Patchell; Gregory David,20,0,30,10
1657253902737,MATH 10A,A03,083737,Patchell; Gregory David,16,0,30,14
1657253908765,MATH 10B,A01,083207,Lim; Seonhee,7,0,34,27
1657253908765,MATH 10B,A02,083208,Lim; Seonhee,9,0,35,26
1657253908765,MATH 10B,A03,093472,Lim; Seonhee,5,0,34,29
1657253908765,MATH 10B,B01,083739,Sinha; Shubham,11,0,30,19
1657253914795,MATH 18,A01,083743,Cinel; Cameron Alexander,6,0,30,24
1657253914795,MATH 18,A02,083744,Cinel; Cameron Alexander,17,0,30,13
1657253914795,MATH 18,A03,083745,Cinel; Cameron Alexander,8,0,30,22
1657253914795,MATH 18,B01,083748,Rideout; David Porter,4,0,37,33
1657253914795,MATH 18,B02,083749,Rideout; David Porter,4,0,36,32
1657253914795,MATH 18,B03,083750,Rideout; David Porter,2,0,37,35
1657253914795,MATH 18,B04,083751,Rideout; David Porter,6,0,36,30
1657253914795,MATH 18,B05,093473,Rideout; David Porter,5,0,36,31
1657253914795,MATH 18,B06,093474,Rideout; David Porter,5,0,36,31
1657253920821,MATH 20A,A01,083754,Zheng; Zequn,14,0,40,26
1657253926847,MATH 20B,A01,083756,Briones; Jor-el Thomas Caparas,3,0,36,33
1657253926847,MATH 20B,A02,083757,Briones; Jor-el Thomas Caparas,1,0,36,35
1657253926847,MATH 20B,A03,093475,Briones; Jor-el Thomas Caparas,2,0,36,34
1657253932874,MATH 20C,A01,083760,Briones; Jor-el Thomas Caparas,1,0,35,34
1657253932874,MATH 20C,A02,083761,Briones; Jor-el Thomas Caparas,8,0,35,27
1657253932874,MATH 20C,A03,093476,Briones; Jor-el Thomas Caparas,0,1,36,36
1657253932874,MATH 20C,B01,083762,Bach; Quang Tran,1,0,30,29
1657253938902,MATH 20D,A01,083765,Tran; Brian Kha,4,0,30,26
1657253938902,MATH 20D,A02,083766,Tran; Brian Kha,5,0,30,25
1657253938902,MATH 20D,A03,083767,Tran; Brian Kha,4,0,30,26
1657253944931,MATH 20E,A01,083771,Ganguly; Soumya,7,0,32,25
1657253944931,MATH 20E,A02,083772,Ganguly; Soumya,7,0,32,25
1657253944931,MATH 20E,B01,083773,Ciotti; Benjamin,19,0,35,16
1657253944931,MATH 20E,B02,083774,Ciotti; Benjamin,17,0,35,18
1657253951032,MATH 103A,A01,083777,Greenfeld; Be'Eri,3,0,36,33
1657253951032,MATH 103A,A02,083778,Greenfeld; Be'Eri,5,0,36,31
1657253951032,MATH 103A,A03,093561,Greenfeld; Be'Eri,4,0,36,32
1657253951032,MATH 103A,B01,083779,Greenfeld; Be'Eri,6,0,36,30
1657253951032,MATH 103A,B02,083780,Greenfeld; Be'Eri,3,0,36,33
1657253951032,MATH 103A,B03,093562,Greenfeld; Be'Eri,3,0,36,33
1657253957054,MATH 105,A01,085443,Carter; Anne Toulson,15,0,35,20
1657253957054,MATH 105,A02,093477,Carter; Anne Toulson,20,0,35,15
1657253963090,MATH 109,A01,083213,Ganzberger; Geoffrey Michael,2,0,34,32
1657253963090,MATH 109,A02,083214,Ganzberger; Geoffrey Michael,4,0,34,30
1657253963090,MATH 109,A03,093478,Ganzberger; Geoffrey Michael,2,0,34,32
1657253963090,MATH 109,B01,083215,Ganzberger; Geoffrey Michael,1,0,32,31
1657253963090,MATH 109,B02,083216,Ganzberger; Geoffrey Michael,1,0,32,31
1657253963090,MATH 109,B03,093479,Ganzberger; Geoffrey Michael,8,0,32,24
1657253969115,MATH 142A,A01,083219,Chow; Bennett,6,0,32,26
1657253969115,MATH 142A,A02,083220,Chow; Bennett,10,0,32,22
1657253969115,MATH 142A,A03,093480,Chow; Bennett,7,0,32,25
1657253969115,MATH 142A,B03,093481,Chow; Bennett,8,0,32,24
1657253969115,MATH 142A,B04,093558,Chow; Bennett,12,0,32,20
1657253969115,MATH 142A,B05,093559,Chow; Bennett,6,0,32,26
1657253975145,MATH 193A,A01,083224,Rotar; Vladimir,7,0,34,27
1657253975145,MATH 193A,A02,083225,Rotar; Vladimir,6,0,34,28
1657253975145,MATH 193A,A03,083781,Rotar; Vladimir,2,0,34,32
1657253975145,MATH 193A,A04,083782,Rotar; Vladimir,8,0,34,26
1657253975145,MATH 193A,A05,093482,Rotar; Vladimir,6,0,34,28
1657253981168,MATH 197,001,091859,McAuley; Julian John,9999,0,9999,0
1657253981168,MATH 197,002,095566,Kedlaya; Kiran S.,9997,0,9999,2
1657253981168,MATH 197,003,095567,Xiao; Ming,9999,0,9999,0
1657253981168,MATH 197,004,095571,Perols; Johan Lars,9998,0,9999,1
1657253988228,COGS 9,A01,083615,Shannon; Kyle Michael,8,0,75,67
1657253994255,COGS 11,A01,083617,Boyle; Mary E. T.,22,0,48,26
1657254000296,COGS 13,A01,083071,Bastos; Amalia Pinkusfeld,8,0,71,63
1657254006330,COGS 14A,A01,092681,Semenuks; Arturs,2,1,100,98
1657254012352,COGS 14B,A01,083073,Cheng; Tzu-Han,6,0,63,57
1657254018380,COGS 17,A01,092677,Semenuks; Arturs,5,0,81,76
1657254024406,COGS 100,A01,083619,Allen; Michael Gordon,16,0,70,54
1657254030435,COGS 101A,A01,083621,Davis; Joshua Daniel,9,0,68,59
1657254036469,COGS 101B,A01,091572,Allen; Michael Gordon,11,0,65,54
1657254042497,COGS 101C,A01,083625,Delgado; Tania,17,0,35,18
1657254048518,COGS 107A,A01,083627,Boyle; Mary E. T.,13,0,60,47
1657254054547,COGS 118A,A01,083075,Gupta; Anjum,18,0,76,58
1657254060573,CSE 3,A50,083646,Miranda; Gregory Joseph,24,0,50,26
1657254066600,CSE 8A,A50,083650,Miranda; Gregory Joseph,17,1,56,39
1657254072623,CSE 11,A01,083080,Cao; Yingjun,5,15,40,35
1657254078647,CSE 12,A01,083652,Krause-Levy; Sophia Louisa,26,1,120,94
1657254084673,CSE 15L,A01,083654,Morris; Justin Loren,9,0,50,41
1657254084673,CSE 15L,A02,083655,Morris; Justin Loren,9,0,50,41
1657254090700,CSE 20,A01,083657,Tran; Khoa Dang,38,0,80,42
1657254096728,CSE 21,A01,095574,Bach; Quang Tran,22,0,48,26
1657254102754,CSE 30,A01,083084,Eldon; John,4,0,80,76
1657254102754,CSE 30,B01,095061,Bhaskar; Nishant,8,0,50,42
1657254108778,CSE 100,A01,083659,Cao; Yingjun,4,4,70,66
1657254114804,CSE 134B,A01,083661,Powell; Thomas Allan,21,0,100,79
1657254120834,CSE 140,A01,083663,Gungor; Onat,13,0,85,72
1657254126862,CSE 140L,A01,083088,Eldon; John,18,0,100,82
1657254132888,CSE 175,A01,083665,Kumar; Rakesh,3,0,25,22
1657254138914,CSE 190,A00,092507,Dubnov; Shlomo,7,0,20,13
1657254144940,ECE 45,A01,083139,Congero; Spencer William,5,0,75,70
1657254150964,ECE 65,A50,083695,Saad; Andrew S,12,0,30,18
1657254150964,ECE 65,A51,095125,Saad; Andrew S,25,0,26,1
1657254156989,ECE 109,A01,091882,Touri; Behrouz,19,0,70,51
1657254163013,ECE 180,A00,083140,Abi Samra; Nicholas Camill,1,0,30,29
1657254163013,ECE 180,B00,083141,Abi Samra; Nicholas Camill,0,0,30,30
1657254169037,MATH 10A,A01,083735,Patchell; Gregory David,2,0,30,28
1657254169037,MATH 10A,A02,083736,Patchell; Gregory David,20,0,30,10
1657254169037,MATH 10A,A03,083737,Patchell; Gregory David,16,0,30,14
1657254175059,MATH 10B,A01,083207,Lim; Seonhee,7,0,34,27
1657254175059,MATH 10B,A02,083208,Lim; Seonhee,9,0,35,26
1657254175059,MATH 10B,A03,093472,Lim; Seonhee,5,0,34,29
1657254175059,MATH 10B,B01,083739,Sinha; Shubham,11,0,30,19
1657254181084,MATH 18,A01,083743,Cinel; Cameron Alexander,6,0,30,24
1657254181084,MATH 18,A02,083744,Cinel; Cameron Alexander,17,0,30,13
1657254181084,MATH 18,A03,083745,Cinel; Cameron Alexander,8,0,30,22
1657254181084,MATH 18,B01,083748,Rideout; David Porter,4,0,37,33
1657254181084,MATH 18,B02,083749,Rideout; David Porter,4,0,36,32
1657254181084,MATH 18,B03,083750,Rideout; David Porter,2,0,37,35
1657254181084,MATH 18,B04,083751,Rideout; David Porter,6,0,36,30
1657254181084,MATH 18,B05,093473,Rideout; David Porter,5,0,36,31
1657254181084,MATH 18,B06,093474,Rideout; David Porter,5,0,36,31
1657254187107,MATH 20A,A01,083754,Zheng; Zequn,14,0,40,26
1657254193135,MATH 20B,A01,083756,Briones; Jor-el Thomas Caparas,3,0,36,33
1657254193135,MATH 20B,A02,083757,Briones; Jor-el Thomas Caparas,1,0,36,35
1657254193135,MATH 20B,A03,093475,Briones; Jor-el Thomas Caparas,2,0,36,34
1657254199158,MATH 20C,A01,083760,Briones; Jor-el Thomas Caparas,1,0,35,34
1657254199158,MATH 20C,A02,083761,Briones; Jor-el Thomas Caparas,8,0,35,27
1657254199158,MATH 20C,A03,093476,Briones; Jor-el Thomas Caparas,0,1,36,36
1657254199158,MATH 20C,B01,083762,Bach; Quang Tran,1,0,30,29
1657254205184,MATH 20D,A01,083765,Tran; Brian Kha,4,0,30,26
1657254205184,MATH 20D,A02,083766,Tran; Brian Kha,5,0,30,25
1657254205184,MATH 20D,A03,083767,Tran; Brian Kha,4,0,30,26
1657254211211,MATH 20E,A01,083771,Ganguly; Soumya,7,0,32,25
1657254211211,MATH 20E,A02,083772,Ganguly; Soumya,7,0,32,25
1657254211211,MATH 20E,B01,083773,Ciotti; Benjamin,19,0,35,16
1657254211211,MATH 20E,B02,083774,Ciotti; Benjamin,17,0,35,18
1657254217239,MATH 103A,A01,083777,Greenfeld; Be'Eri,3,0,36,33
1657254217239,MATH 103A,A02,083778,Greenfeld; Be'Eri,5,0,36,31
1657254217239,MATH 103A,A03,093561,Greenfeld; Be'Eri,4,0,36,32
1657254217239,MATH 103A,B01,083779,Greenfeld; Be'Eri,6,0,36,30
1657254217239,MATH 103A,B02,083780,Greenfeld; Be'Eri,3,0,36,33
1657254217239,MATH 103A,B03,093562,Greenfeld; Be'Eri,3,0,36,33
1657254223267,MATH 105,A01,085443,Carter; Anne Toulson,15,0,35,20
1657254223267,MATH 105,A02,093477,Carter; Anne Toulson,20,0,35,15
1657254229290,MATH 109,A01,083213,Ganzberger; Geoffrey Michael,2,0,34,32
1657254229290,MATH 109,A02,083214,Ganzberger; Geoffrey Michael,4,0,34,30
1657254229290,MATH 109,A03,093478,Ganzberger; Geoffrey Michael,2,0,34,32
1657254229290,MATH 109,B01,083215,Ganzberger; Geoffrey Michael,1,0,32,31
1657254229290,MATH 109,B02,083216,Ganzberger; Geoffrey Michael,1,0,32,31
1657254229290,MATH 109,B03,093479,Ganzberger; Geoffrey Michael,8,0,32,24
1657254235315,MATH 142A,A01,083219,Chow; Bennett,6,0,32,26
1657254235315,MATH 142A,A02,083220,Chow; Bennett,10,0,32,22
1657254235315,MATH 142A,A03,093480,Chow; Bennett,7,0,32,25
1657254235315,MATH 142A,B03,093481,Chow; Bennett,8,0,32,24
1657254235315,MATH 142A,B04,093558,Chow; Bennett,12,0,32,20
1657254235315,MATH 142A,B05,093559,Chow; Bennett,6,0,32,26
1657254241338,MATH 193A,A01,083224,Rotar; Vladimir,7,0,34,27
1657254241338,MATH 193A,A02,083225,Rotar; Vladimir,6,0,34,28
1657254241338,MATH 193A,A03,083781,Rotar; Vladimir,2,0,34,32
1657254241338,MATH 193A,A04,083782,Rotar; Vladimir,8,0,34,26
1657254241338,MATH 193A,A05,093482,Rotar; Vladimir,6,0,34,28
1657254247362,MATH 197,001,091859,McAuley; Julian John,9999,0,9999,0
1657254247362,MATH 197,002,095566,Kedlaya; Kiran S.,9997,0,9999,2
1657254247362,MATH 197,003,095567,Xiao; Ming,9999,0,9999,0
1657254247362,MATH 197,004,095571,Perols; Johan Lars,9998,0,9999,1
1657254254416,COGS 9,A01,083615,Shannon; Kyle Michael,8,0,75,67
1657254260439,COGS 11,A01,083617,Boyle; Mary E. T.,22,0,48,26
1657254266463,COGS 13,A01,083071,Bastos; Amalia Pinkusfeld,8,0,71,63
1657254272493,COGS 14A,A01,092681,Semenuks; Arturs,2,1,100,98
1657254278520,COGS 14B,A01,083073,Cheng; Tzu-Han,6,0,63,57
1657254284547,COGS 17,A01,092677,Semenuks; Arturs,5,0,81,76
1657254290572,COGS 100,A01,083619,Allen; Michael Gordon,16,0,70,54
1657254296597,COGS 101A,A01,083621,Davis; Joshua Daniel,9,0,68,59
1657254302627,COGS 101B,A01,091572,Allen; Michael Gordon,11,0,65,54
1657254308654,COGS 101C,A01,083625,Delgado; Tania,17,0,35,18
1657254314678,COGS 107A,A01,083627,Boyle; Mary E. T.,13,0,60,47
1657254320709,COGS 118A,A01,083075,Gupta; Anjum,18,0,76,58
1657254326737,CSE 3,A50,083646,Miranda; Gregory Joseph,24,0,50,26
1657254332767,CSE 8A,A50,083650,Miranda; Gregory Joseph,17,1,56,39
1657254338791,CSE 11,A01,083080,Cao; Yingjun,5,15,40,35
1657254344815,CSE 12,A01,083652,Krause-Levy; Sophia Louisa,26,1,120,94
1657254350847,CSE 15L,A01,083654,Morris; Justin Loren,9,0,50,41
1657254350847,CSE 15L,A02,083655,Morris; Justin Loren,9,0,50,41
1657254356869,CSE 20,A01,083657,Tran; Khoa Dang,38,0,80,42
1657254362895,CSE 21,A01,095574,Bach; Quang Tran,22,0,48,26
1657254368924,CSE 30,A01,083084,Eldon; John,4,0,80,76
1657254368924,CSE 30,B01,095061,Bhaskar; Nishant,8,0,50,42
1657254374947,CSE 100,A01,083659,Cao; Yingjun,4,4,70,66
1657254380973,CSE 134B,A01,083661,Powell; Thomas Allan,21,0,100,79
1657254386995,CSE 140,A01,083663,Gungor; Onat,13,0,85,72
1657254393023,CSE 140L,A01,083088,Eldon; John,18,0,100,82
1657254399045,CSE 175,A01,083665,Kumar; Rakesh,3,0,25,22
1657254405068,CSE 190,A00,092507,Dubnov; Shlomo,7,0,20,13
1657254411090,ECE 45,A01,083139,Congero; Spencer William,5,0,75,70
1657254417117,ECE 65,A50,083695,Saad; Andrew S,12,0,30,18
1657254417117,ECE 65,A51,095125,Saad; Andrew S,25,0,26,1
1657254423143,ECE 109,A01,091882,Touri; Behrouz,19,0,70,51
1657254429171,ECE 180,A00,083140,Abi Samra; Nicholas Camill,1,0,30,29
1657254429171,ECE 180,B00,083141,Abi Samra; Nicholas Camill,0,0,30,30
1657254435194,MATH 10A,A01,083735,Patchell; Gregory David,2,0,30,28
1657254435194,MATH 10A,A02,083736,Patchell; Gregory David,20,0,30,10
1657254435194,MATH 10A,A03,083737,Patchell; Gregory David,16,0,30,14
1657254441229,MATH 10B,A01,083207,Lim; Seonhee,7,0,34,27
1657254441229,MATH 10B,A02,083208,Lim; Seonhee,9,0,35,26
1657254441229,MATH 10B,A03,093472,Lim; Seonhee,5,0,34,29
1657254441229,MATH 10B,B01,083739,Sinha; Shubham,11,0,30,19
1657254447254,MATH 18,A01,083743,Cinel; Cameron Alexander,6,0,30,24
1657254447254,MATH 18,A02,083744,Cinel; Cameron Alexander,17,0,30,13
1657254447254,MATH 18,A03,083745,Cinel; Cameron Alexander,8,0,30,22
1657254447254,MATH 18,B01,083748,Rideout; David Porter,4,0,37,33
1657254447254,MATH 18,B02,083749,Rideout; David Porter,4,0,36,32
1657254447254,MATH 18,B03,083750,Rideout; David Porter,2,0,37,35
1657254447254,MATH 18,B04,083751,Rideout; David Porter,6,0,36,30
1657254447254,MATH 18,B05,093473,Rideout; David Porter,5,0,36,31
1657254447254,MATH 18,B06,093474,Rideout; David Porter,5,0,36,31
1657254453276,MATH 20A,A01,083754,Zheng; Zequn,14,0,40,26
1657254459307,MATH 20B,A01,083756,Briones; Jor-el Thomas Caparas,3,0,36,33
1657254459307,MATH 20B,A02,083757,Briones; Jor-el Thomas Caparas,1,0,36,35
1657254459307,MATH 20B,A03,093475,Briones; Jor-el Thomas Caparas,2,0,36,34
1657254465337,MATH 20C,A01,083760,Briones; Jor-el Thomas Caparas,1,0,35,34
1657254465337,MATH 20C,A02,083761,Briones; Jor-el Thomas Caparas,8,0,35,27
1657254465337,MATH 20C,A03,093476,Briones; Jor-el Thomas Caparas,0,1,36,36
1657254465337,MATH 20C,B01,083762,Bach; Quang Tran,1,0,30,29
1657254471367,MATH 20D,A01,083765,Tran; Brian Kha,4,0,30,26
1657254471367,MATH 20D,A02,083766,Tran; Brian Kha,5,0,30,25
1657254471367,MATH 20D,A03,083767,Tran; Brian Kha,4,0,30,26
1657254477391,MATH 20E,A01,083771,Ganguly; Soumya,7,0,32,25
1657254477391,MATH 20E,A02,083772,Ganguly; Soumya,7,0,32,25
1657254477391,MATH 20E,B01,083773,Ciotti; Benjamin,19,0,35,16
1657254477391,MATH 20E,B02,083774,Ciotti; Benjamin,17,0,35,18
1657254483415,MATH 103A,A01,083777,Greenfeld; Be'Eri,3,0,36,33
1657254483415,MATH 103A,A02,083778,Greenfeld; Be'Eri,5,0,36,31
1657254483415,MATH 103A,A03,093561,Greenfeld; Be'Eri,4,0,36,32
1657254483415,MATH 103A,B01,083779,Greenfeld; Be'Eri,6,0,36,30
1657254483415,MATH 103A,B02,083780,Greenfeld; Be'Eri,3,0,36,33
1657254483415,MATH 103A,B03,093562,Greenfeld; Be'Eri,3,0,36,33
1657254489443,MATH 105,A01,085443,Carter; Anne Toulson,15,0,35,20
1657254489443,MATH 105,A02,093477,Carter; Anne Toulson,20,0,35,15
1657254495476,MATH 109,A01,083213,Ganzberger; Geoffrey Michael,2,0,34,32
1657254495476,MATH 109,A02,083214,Ganzberger; Geoffrey Michael,4,0,34,30
1657254495476,MATH 109,A03,093478,Ganzberger; Geoffrey Michael,2,0,34,32
1657254495476,MATH 109,B01,083215,Ganzberger; Geoffrey Michael,1,0,32,31
1657254495476,MATH 109,B02,083216,Ganzberger; Geoffrey Michael,1,0,32,31
1657254495476,MATH 109,B03,093479,Ganzberger; Geoffrey Michael,8,0,32,24
1657254501500,MATH 142A,A01,083219,Chow; Bennett,6,0,32,26
1657254501500,MATH 142A,A02,083220,Chow; Bennett,10,0,32,22
1657254501500,MATH 142A,A03,093480,Chow; Bennett,7,0,32,25
1657254501500,MATH 142A,B03,093481,Chow; Bennett,8,0,32,24
1657254501500,MATH 142A,B04,093558,Chow; Bennett,12,0,32,20
1657254501500,MATH 142A,B05,093559,Chow; Bennett,6,0,32,26
1657254507528,MATH 193A,A01,083224,Rotar; Vladimir,7,0,34,27
1657254507528,MATH 193A,A02,083225,Rotar; Vladimir,6,0,34,28
1657254507528,MATH 193A,A03,083781,Rotar; Vladimir,2,0,34,32
1657254507528,MATH 193A,A04,083782,Rotar; Vladimir,8,0,34,26
1657254507528,MATH 193A,A05,093482,Rotar; Vladimir,6,0,34,28
1657254513558,MATH 197,001,091859,McAuley; Julian John,9999,0,9999,0
1657254513558,MATH 197,002,095566,Kedlaya; Kiran S.,9997,0,9999,2
1657254513558,MATH 197,003,095567,Xiao; Ming,9999,0,9999,0
1657254513558,MATH 197,004,095571,Perols; Johan Lars,9998,0,9999,1
1657254520633,COGS 9,A01,083615,Shannon; Kyle Michael,8,0,75,67
1657254526658,COGS 11,A01,083617,Boyle; Mary E. T.,22,0,48,26
1657254532682,COGS 13,A01,083071,Bastos; Amalia Pinkusfeld,8,0,71,63
1657254538707,COGS 14A,A01,092681,Semenuks; Arturs,2,1,100,98
1657254544824,COGS 14B,A01,083073,Cheng; Tzu-Han,6,0,63,57
1657254550846,COGS 17,A01,092677,Semenuks; Arturs,5,0,81,76
1657254556872,COGS 100,A01,083619,Allen; Michael Gordon,16,0,70,54
1657254562895,COGS 101A,A01,083621,Davis; Joshua Daniel,9,0,68,59
1657254568919,COGS 101B,A01,091572,Allen; Michael Gordon,11,0,65,54
1657254574948,COGS 101C,A01,083625,Delgado; Tania,17,0,35,18
1657254580974,COGS 107A,A01,083627,Boyle; Mary E. T.,13,0,60,47
1657254586998,COGS 118A,A01,083075,Gupta; Anjum,18,0,76,58
1657254593024,CSE 3,A50,083646,Miranda; Gregory Joseph,24,0,50,26
1657254599048,CSE 8A,A50,083650,Miranda; Gregory Joseph,17,1,56,39
1657254605071,CSE 11,A01,083080,Cao; Yingjun,5,15,40,35
1657254611094,CSE 12,A01,083652,Krause-Levy; Sophia Louisa,26,1,120,94
1657254617123,CSE 15L,A01,083654,Morris; Justin Loren,9,0,50,41
1657254617123,CSE 15L,A02,083655,Morris; Justin Loren,9,0,50,41
1657254623146,CSE 20,A01,083657,Tran; Khoa Dang,38,0,80,42
1657254629172,CSE 21,A01,095574,Bach; Quang Tran,22,0,48,26
1657254635197,CSE 30,A01,083084,Eldon; John,4,0,80,76
1657254635197,CSE 30,B01,095061,Bhaskar; Nishant,8,0,50,42
1657254641223,CSE 100,A01,083659,Cao; Yingjun,4,4,70,66
1657254647250,CSE 134B,A01,083661,Powell; Thomas Allan,21,0,100,79
1657254653277,CSE 140,A01,083663,Gungor; Onat,13,0,85,72
1657254659301,CSE 140L,A01,083088,Eldon; John,18,0,100,82
1657254665327,CSE 175,A01,083665,Kumar; Rakesh,3,0,25,22
1657254671351,CSE 190,A00,092507,Dubnov; Shlomo,7,0,20,13
1657254677374,ECE 45,A01,083139,Congero; Spencer William,5,0,75,70
1657254683399,ECE 65,A50,083695,Saad; Andrew S,12,0,30,18
1657254683399,ECE 65,A51,095125,Saad; Andrew S,25,0,26,1
1657254689439,ECE 109,A01,091882,Touri; Behrouz,19,0,70,51
1657254695462,ECE 180,A00,083140,Abi Samra; Nicholas Camill,1,0,30,29
1657254695462,ECE 180,B00,083141,Abi Samra; Nicholas Camill,0,0,30,30
1657254701487,MATH 10A,A01,083735,Patchell; Gregory David,2,0,30,28
1657254701487,MATH 10A,A02,083736,Patchell; Gregory David,20,0,30,10
1657254701487,MATH 10A,A03,083737,Patchell; Gregory David,16,0,30,14
1657254707512,MATH 10B,A01,083207,Lim; Seonhee,7,0,34,27
1657254707512,MATH 10B,A02,083208,Lim; Seonhee,9,0,35,26
1657254707512,MATH 10B,A03,093472,Lim; Seonhee,5,0,34,29
1657254707512,MATH 10B,B01,083739,Sinha; Shubham,11,0,30,19
1657254713536,MATH 18,A01,083743,Cinel; Cameron Alexander,6,0,30,24
1657254713536,MATH 18,A02,083744,Cinel; Cameron Alexander,17,0,30,13
1657254713536,MATH 18,A03,083745,Cinel; Cameron Alexander,8,0,30,22
1657254713536,MATH 18,B01,083748,Rideout; David Porter,4,0,37,33
1657254713536,MATH 18,B02,083749,Rideout; David Porter,4,0,36,32
1657254713536,MATH 18,B03,083750,Rideout; David Porter,2,0,37,35
1657254713536,MATH 18,B04,083751,Rideout; David Porter,6,0,36,30
1657254713536,MATH 18,B05,093473,Rideout; David Porter,5,0,36,31
1657254713536,MATH 18,B06,093474,Rideout; David Porter,5,0,36,31
1657254719557,MATH 20A,A01,083754,Zheng; Zequn,14,0,40,26
1657254725581,MATH 20B,A01,083756,Briones; Jor-el Thomas Caparas,3,0,36,33
1657254725581,MATH 20B,A02,083757,Briones; Jor-el Thomas Caparas,1,0,36,35
1657254725581,MATH 20B,A03,093475,Briones; Jor-el Thomas Caparas,2,0,36,34
1657254731605,MATH 20C,A01,083760,Briones; Jor-el Thomas Caparas,1,0,35,34
1657254731605,MATH 20C,A02,083761,Briones; Jor-el Thomas Caparas,8,0,35,27
1657254731605,MATH 20C,A03,093476,Briones; Jor-el Thomas Caparas,0,1,36,36
1657254731605,MATH 20C,B01,083762,Bach; Quang Tran,1,0,30,29
1657254737630,MATH 20D,A01,083765,Tran; Brian Kha,4,0,30,26
1657254737630,MATH 20D,A02,083766,Tran; Brian Kha,5,0,30,25
1657254737630,MATH 20D,A03,083767,Tran; Brian Kha,4,0,30,26
1657254743655,MATH 20E,A01,083771,Ganguly; Soumya,7,0,32,25
1657254743655,MATH 20E,A02,083772,Ganguly; Soumya,7,0,32,25
1657254743655,MATH 20E,B01,083773,Ciotti; Benjamin,19,0,35,16
1657254743655,MATH 20E,B02,083774,Ciotti; Benjamin,17,0,35,18
1657254749687,MATH 103A,A01,083777,Greenfeld; Be'Eri,3,0,36,33
1657254749687,MATH 103A,A02,083778,Greenfeld; Be'Eri,5,0,36,31
1657254749687,MATH 103A,A03,093561,Greenfeld; Be'Eri,4,0,36,32
1657254749687,MATH 103A,B01,083779,Greenfeld; Be'Eri,6,0,36,30
1657254749687,MATH 103A,B02,083780,Greenfeld; Be'Eri,3,0,36,33
1657254749687,MATH 103A,B03,093562,Greenfeld; Be'Eri,3,0,36,33
1657254755712,MATH 105,A01,085443,Carter; Anne Toulson,15,0,35,20
1657254755712,MATH 105,A02,093477,Carter; Anne Toulson,20,0,35,15
1657254761743,MATH 109,A01,083213,Ganzberger; Geoffrey Michael,2,0,34,32
1657254761743,MATH 109,A02,083214,Ganzberger; Geoffrey Michael,4,0,34,30
1657254761743,MATH 109,A03,093478,Ganzberger; Geoffrey Michael,2,0,34,32
1657254761743,MATH 109,B01,083215,Ganzberger; Geoffrey Michael,1,0,32,31
1657254761743,MATH 109,B02,083216,Ganzberger; Geoffrey Michael,1,0,32,31
1657254761743,MATH 109,B03,093479,Ganzberger; Geoffrey Michael,8,0,32,24
1657254767767,MATH 142A,A01,083219,Chow; Bennett,6,0,32,26
1657254767767,MATH 142A,A02,083220,Chow; Bennett,10,0,32,22
1657254767767,MATH 142A,A03,093480,Chow; Bennett,7,0,32,25
1657254767767,MATH 142A,B03,093481,Chow; Bennett,8,0,32,24
1657254767767,MATH 142A,B04,093558,Chow; Bennett,12,0,32,20
1657254767767,MATH 142A,B05,093559,Chow; Bennett,6,0,32,26
1657254773792,MATH 193A,A01,083224,Rotar; Vladimir,7,0,34,27
1657254773792,MATH 193A,A02,083225,Rotar; Vladimir,6,0,34,28
1657254773792,MATH 193A,A03,083781,Rotar; Vladimir,2,0,34,32
1657254773792,MATH 193A,A04,083782,Rotar; Vladimir,8,0,34,26
1657254773792,MATH 193A,A05,093482,Rotar; Vladimir,6,0,34,28
1657254779819,MATH 197,001,091859,McAuley; Julian John,9999,0,9999,0
1657254779819,MATH 197,002,095566,Kedlaya; Kiran S.,9997,0,9999,2
1657254779819,MATH 197,003,095567,Xiao; Ming,9999,0,9999,0
1657254779819,MATH 197,004,095571,Perols; Johan Lars,9998,0,9999,1
1657254786873,COGS 9,A01,083615,Shannon; Kyle Michael,8,0,75,67
1657254792898,COGS 11,A01,083617,Boyle; Mary E. T.,22,0,48,26
1657254798924,COGS 13,A01,083071,Bastos; Amalia Pinkusfeld,8,0,71,63
1657254804947,COGS 14A,A01,092681,Semenuks; Arturs,2,1,100,98
1657254810976,COGS 14B,A01,083073,Cheng; Tzu-Han,6,0,63,57
1657254816999,COGS 17,A01,092677,Semenuks; Arturs,5,0,81,76
1657254823021,COGS 100,A01,083619,Allen; Michael Gordon,16,0,70,54
1657254829045,COGS 101A,A01,083621,Davis; Joshua Daniel,9,0,68,59
1657254835069,COGS 101B,A01,091572,Allen; Michael Gordon,11,0,65,54
1657254841096,COGS 101C,A01,083625,Delgado; Tania,17,0,35,18
1657254847119,COGS 107A,A01,083627,Boyle; Mary E. T.,13,0,60,47
1657254853143,COGS 118A,A01,083075,Gupta; Anjum,18,0,76,58
1657254859166,CSE 3,A50,083646,Miranda; Gregory Joseph,24,0,50,26
1657254865191,CSE 8A,A50,083650,Miranda; Gregory Joseph,17,1,56,39
1657254871215,CSE 11,A01,083080,Cao; Yingjun,5,15,40,35
1657254877242,CSE 12,A01,083652,Krause-Levy; Sophia Louisa,26,1,120,94
1657254883265,CSE 15L,A01,083654,Morris; Justin Loren,9,0,50,41
1657254883265,CSE 15L,A02,083655,Morris; Justin Loren,9,0,50,41
1657254889292,CSE 20,A01,083657,Tran; Khoa Dang,38,0,80,42
1657254895317,CSE 21,A01,095574,Bach; Quang Tran,22,0,48,26
1657254914976,CSE 30,A01,083084,Eldon; John,4,0,80,76
1657254914976,CSE 30,B01,095061,Bhaskar; Nishant,8,0,50,42
1657254920999,CSE 100,A01,083659,Cao; Yingjun,4,4,70,66
1657254927024,CSE 134B,A01,083661,Powell; Thomas Allan,21,0,100,79
1657254933048,CSE 140,A01,083663,Gungor; Onat,13,0,85,72
1657254939076,CSE 140L,A01,083088,Eldon; John,18,0,100,82
1657254945103,CSE 175,A01,083665,Kumar; Rakesh,3,0,25,22
1657254951131,CSE 190,A00,092507,Dubnov; Shlomo,7,0,20,13
1657254957154,ECE 45,A01,083139,Congero; Spencer William,5,0,75,70
1657254963184,ECE 65,A50,083695,Saad; Andrew S,12,0,30,18
1657254963184,ECE 65,A51,095125,Saad; Andrew S,25,0,26,1
1657254969212,ECE 109,A01,091882,Touri; Behrouz,19,0,70,51
1657254975237,ECE 180,A00,083140,Abi Samra; Nicholas Camill,1,0,30,29
1657254975237,ECE 180,B00,083141,Abi Samra; Nicholas Camill,0,0,30,30
1657254981280,MATH 10A,A01,083735,Patchell; Gregory David,2,0,30,28
1657254981280,MATH 10A,A02,083736,Patchell; Gregory David,20,0,30,10
1657254981280,MATH 10A,A03,083737,Patchell; Gregory David,16,0,30,14
1657254987325,MATH 10B,A01,083207,Lim; Seonhee,7,0,34,27
1657254987325,MATH 10B,A02,083208,Lim; Seonhee,9,0,35,26
1657254987325,MATH 10B,A03,093472,Lim; Seonhee,5,0,34,29
1657254987325,MATH 10B,B01,083739,Sinha; Shubham,11,0,30,19
1657254993350,MATH 18,A01,083743,Cinel; Cameron Alexander,6,0,30,24
1657254993350,MATH 18,A02,083744,Cinel; Cameron Alexander,17,0,30,13
1657254993350,MATH 18,A03,083745,Cinel; Cameron Alexander,8,0,30,22
1657254993350,MATH 18,B01,083748,Rideout; David Porter,4,0,37,33
1657254993350,MATH 18,B02,083749,Rideout; David Porter,4,0,36,32
1657254993350,MATH 18,B03,083750,Rideout; David Porter,2,0,37,35
1657254993350,MATH 18,B04,083751,Rideout; David Porter,6,0,36,30
1657254993350,MATH 18,B05,093473,Rideout; David Porter,5,0,36,31
1657254993350,MATH 18,B06,093474,Rideout; David Porter,5,0,36,31
1657254999373,MATH 20A,A01,083754,Zheng; Zequn,14,0,40,26
1657255005396,MATH 20B,A01,083756,Briones; Jor-el Thomas Caparas,3,0,36,33
1657255005396,MATH 20B,A02,083757,Briones; Jor-el Thomas Caparas,1,0,36,35
1657255005396,MATH 20B,A03,093475,Briones; Jor-el Thomas Caparas,2,0,36,34
1657255011425,MATH 20C,A01,083760,Briones; Jor-el Thomas Caparas,1,0,35,34
1657255011425,MATH 20C,A02,083761,Briones; Jor-el Thomas Caparas,8,0,35,27
1657255011425,MATH 20C,A03,093476,Briones; Jor-el Thomas Caparas,0,1,36,36
1657255011425,MATH 20C,B01,083762,Bach; Quang Tran,1,0,30,29
1657255017453,MATH 20D,A01,083765,Tran; Brian Kha,4,0,30,26
1657255017453,MATH 20D,A02,083766,Tran; Brian Kha,5,0,30,25
1657255017453,MATH 20D,A03,083767,Tran; Brian Kha,4,0,30,26
1657255023483,MATH 20E,A01,083771,Ganguly; Soumya,7,0,32,25
1657255023483,MATH 20E,A02,083772,Ganguly; Soumya,7,0,32,25
1657255023483,MATH 20E,B01,083773,Ciotti; Benjamin,19,0,35,16
1657255023483,MATH 20E,B02,083774,Ciotti; Benjamin,17,0,35,18
1657255029506,MATH 103A,A01,083777,Greenfeld; Be'Eri,3,0,36,33
1657255029506,MATH 103A,A02,083778,Greenfeld; Be'Eri,5,0,36,31
1657255029506,MATH 103A,A03,093561,Greenfeld; Be'Eri,4,0,36,32
1657255029506,MATH 103A,B01,083779,Greenfeld; Be'Eri,6,0,36,30
1657255029506,MATH 103A,B02,083780,Greenfeld; Be'Eri,3,0,36,33
1657255029506,MATH 103A,B03,093562,Greenfeld; Be'Eri,3,0,36,33
1657255035533,MATH 105,A01,085443,Carter; Anne Toulson,15,0,35,20
1657255035533,MATH 105,A02,093477,Carter; Anne Toulson,20,0,35,15
1657255041564,MATH 109,A01,083213,Ganzberger; Geoffrey Michael,2,0,34,32
1657255041564,MATH 109,A02,083214,Ganzberger; Geoffrey Michael,4,0,34,30
1657255041564,MATH 109,A03,093478,Ganzberger; Geoffrey Michael,2,0,34,32
1657255041564,MATH 109,B01,083215,Ganzberger; Geoffrey Michael,1,0,32,31
1657255041564,MATH 109,B02,083216,Ganzberger; Geoffrey Michael,1,0,32,31
1657255041564,MATH 109,B03,093479,Ganzberger; Geoffrey Michael,8,0,32,24
1657255047593,MATH 142A,A01,083219,Chow; Bennett,6,0,32,26
1657255047593,MATH 142A,A02,083220,Chow; Bennett,10,0,32,22
1657255047593,MATH 142A,A03,093480,Chow; Bennett,7,0,32,25
1657255047593,MATH 142A,B03,093481,Chow; Bennett,8,0,32,24
1657255047593,MATH 142A,B04,093558,Chow; Bennett,12,0,32,20
1657255047593,MATH 142A,B05,093559,Chow; Bennett,6,0,32,26
1657255053623,MATH 193A,A01,083224,Rotar; Vladimir,7,0,34,27
1657255053623,MATH 193A,A02,083225,Rotar; Vladimir,6,0,34,28
1657255053623,MATH 193A,A03,083781,Rotar; Vladimir,2,0,34,32
1657255053623,MATH 193A,A04,083782,Rotar; Vladimir,8,0,34,26
1657255053623,MATH 193A,A05,093482,Rotar; Vladimir,6,0,34,28
1657255059644,MATH 197,001,091859,McAuley; Julian John,9999,0,9999,0
1657255059644,MATH 197,002,095566,Kedlaya; Kiran S.,9997,0,9999,2
1657255059644,MATH 197,003,095567,Xiao; Ming,9999,0,9999,0
1657255059644,MATH 197,004,095571,Perols; Johan Lars,9998,0,9999,1
1657255066691,COGS 9,A01,083615,Shannon; Kyle Michael,8,0,75,67
1657255072718,COGS 11,A01,083617,Boyle; Mary E. T.,22,0,48,26
1657255078744,COGS 13,A01,083071,Bastos; Amalia Pinkusfeld,8,0,71,63
1657255084765,COGS 14A,A01,092681,Semenuks; Arturs,2,1,100,98
1657255090787,COGS 14B,A01,083073,Cheng; Tzu-Han,6,0,63,57
1657255096809,COGS 17,A01,092677,Semenuks; Arturs,5,0,81,76
1657255102835,COGS 100,A01,083619,Allen; Michael Gordon,16,0,70,54
1657255108859,COGS 101A,A01,083621,Davis; Joshua Daniel,9,0,68,59
1657255114882,COGS 101B,A01,091572,Allen; Michael Gordon,11,0,65,54
1657255120908,COGS 101C,A01,083625,Delgado; Tania,17,0,35,18
1657255126935,COGS 107A,A01,083627,Boyle; Mary E. T.,13,0,60,47
1657255132958,COGS 118A,A01,083075,Gupta; Anjum,18,0,76,58
1657255138985,CSE 3,A50,083646,Miranda; Gregory Joseph,24,0,50,26
1657255145008,CSE 8A,A50,083650,Miranda; Gregory Joseph,17,1,56,39
1657255151032,CSE 11,A01,083080,Cao; Yingjun,5,15,40,35
1657255157132,CSE 12,A01,083652,Krause-Levy; Sophia Louisa,26,1,120,94
1657255163154,CSE 15L,A01,083654,Morris; Justin Loren,9,0,50,41
1657255163154,CSE 15L,A02,083655,Morris; Justin Loren,9,0,50,41
1657255169185,CSE 20,A01,083657,Tran; Khoa Dang,38,0,80,42
1657255175209,CSE 21,A01,095574,Bach; Quang Tran,22,0,48,26
1657255181233,CSE 30,A01,083084,Eldon; John,4,0,80,76
1657255181233,CSE 30,B01,095061,Bhaskar; Nishant,8,0,50,42
1657255187263,CSE 100,A01,083659,Cao; Yingjun,4,4,70,66
1657255193290,CSE 134B,A01,083661,Powell; Thomas Allan,21,0,100,79
1657255199311,CSE 140,A01,083663,Gungor; Onat,13,0,85,72
1657255205335,CSE 140L,A01,083088,Eldon; John,18,0,100,82
1657255211362,CSE 175,A01,083665,Kumar; Rakesh,3,0,25,22
1657255217389,CSE 190,A00,092507,Dubnov; Shlomo,7,0,20,13
1657255223411,ECE 45,A01,083139,Congero; Spencer William,5,0,75,70
1657255229438,ECE 65,A50,083695,Saad; Andrew S,12,0,30,18
1657255229438,ECE 65,A51,095125,Saad; Andrew S,25,0,26,1
1657255235464,ECE 109,A01,091882,Touri; Behrouz,19,0,70,51
1657255241490,ECE 180,A00,083140,Abi Samra; Nicholas Camill,1,0,30,29
1657255241490,ECE 180,B00,083141,Abi Samra; Nicholas Camill,0,0,30,30
1657255247517,MATH 10A,A01,083735,Patchell; Gregory David,2,0,30,28
1657255247517,MATH 10A,A02,083736,Patchell; Gregory David,20,0,30,10
1657255247517,MATH 10A,A03,083737,Patchell; Gregory David,16,0,30,14
1657255253544,MATH 10B,A01,083207,Lim; Seonhee,7,0,34,27
1657255253544,MATH 10B,A02,083208,Lim; Seonhee,9,0,35,26
1657255253544,MATH 10B,A03,093472,Lim; Seonhee,5,0,34,29
1657255253544,MATH 10B,B01,083739,Sinha; Shubham,11,0,30,19
1657255259569,MATH 18,A01,083743,Cinel; Cameron Alexander,6,0,30,24
1657255259569,MATH 18,A02,083744,Cinel; Cameron Alexander,17,0,30,13
1657255259569,MATH 18,A03,083745,Cinel; Cameron Alexander,8,0,30,22
1657255259569,MATH 18,B01,083748,Rideout; David Porter,4,0,37,33
1657255259569,MATH 18,B02,083749,Rideout; David Porter,4,0,36,32
1657255259569,MATH 18,B03,083750,Rideout; David Porter,2,0,37,35
1657255259569,MATH 18,B04,083751,Rideout; David Porter,6,0,36,30
1657255259569,MATH 18,B05,093473,Rideout; David Porter,5,0,36,31
1657255259569,MATH 18,B06,093474,Rideout; David Porter,5,0,36,31
1657255265603,MATH 20A,A01,083754,Zheng; Zequn,14,0,40,26
1657255271632,MATH 20B,A01,083756,Briones; Jor-el Thomas Caparas,3,0,36,33
1657255271632,MATH 20B,A02,083757,Briones; Jor-el Thomas Caparas,1,0,36,35
1657255271632,MATH 20B,A03,093475,Briones; Jor-el Thomas Caparas,2,0,36,34
1657255277654,MATH 20C,A01,083760,Briones; Jor-el Thomas Caparas,1,0,35,34
1657255277654,MATH 20C,A02,083761,Briones; Jor-el Thomas Caparas,8,0,35,27
1657255277654,MATH 20C,A03,093476,Briones; Jor-el Thomas Caparas,0,1,36,36
1657255277654,MATH 20C,B01,083762,Bach; Quang Tran,1,0,30,29
1657255283682,MATH 20D,A01,083765,Tran; Brian Kha,4,0,30,26
1657255283682,MATH 20D,A02,083766,Tran; Brian Kha,5,0,30,25
1657255283682,MATH 20D,A03,083767,Tran; Brian Kha,4,0,30,26
1657255289704,MATH 20E,A01,083771,Ganguly; Soumya,7,0,32,25
1657255289704,MATH 20E,A02,083772,Ganguly; Soumya,7,0,32,25
1657255289704,MATH 20E,B01,083773,Ciotti; Benjamin,19,0,35,16
1657255289704,MATH 20E,B02,083774,Ciotti; Benjamin,17,0,35,18
1657255295735,MATH 103A,A01,083777,Greenfeld; Be'Eri,3,0,36,33
1657255295735,MATH 103A,A02,083778,Greenfeld; Be'Eri,5,0,36,31
1657255295735,MATH 103A,A03,093561,Greenfeld; Be'Eri,4,0,36,32
1657255295735,MATH 103A,B01,083779,Greenfeld; Be'Eri,6,0,36,30
1657255295735,MATH 103A,B02,083780,Greenfeld; Be'Eri,3,0,36,33
1657255295735,MATH 103A,B03,093562,Greenfeld; Be'Eri,3,0,36,33
1657255301759,MATH 105,A01,085443,Carter; Anne Toulson,15,0,35,20
1657255301759,MATH 105,A02,093477,Carter; Anne Toulson,20,0,35,15
1657255307783,MATH 109,A01,083213,Ganzberger; Geoffrey Michael,2,0,34,32
1657255307783,MATH 109,A02,083214,Ganzberger; Geoffrey Michael,4,0,34,30
1657255307783,MATH 109,A03,093478,Ganzberger; Geoffrey Michael,2,0,34,32
1657255307783,MATH 109,B01,083215,Ganzberger; Geoffrey Michael,1,0,32,31
1657255307783,MATH 109,B02,083216,Ganzberger; Geoffrey Michael,1,0,32,31
1657255307783,MATH 109,B03,093479,Ganzberger; Geoffrey Michael,8,0,32,24
1657255313813,MATH 142A,A01,083219,Chow; Bennett,6,0,32,26
1657255313813,MATH 142A,A02,083220,Chow; Bennett,10,0,32,22
1657255313813,MATH 142A,A03,093480,Chow; Bennett,7,0,32,25
1657255313813,MATH 142A,B03,093481,Chow; Bennett,8,0,32,24
1657255313813,MATH 142A,B04,093558,Chow; Bennett,12,0,32,20
1657255313813,MATH 142A,B05,093559,Chow; Bennett,6,0,32,26
1657255319842,MATH 193A,A01,083224,Rotar; Vladimir,7,0,34,27
1657255319842,MATH 193A,A02,083225,Rotar; Vladimir,6,0,34,28
1657255319842,MATH 193A,A03,083781,Rotar; Vladimir,2,0,34,32
1657255319842,MATH 193A,A04,083782,Rotar; Vladimir,8,0,34,26
1657255319842,MATH 193A,A05,093482,Rotar; Vladimir,6,0,34,28
1657255325865,MATH 197,001,091859,McAuley; Julian John,9999,0,9999,0
1657255325865,MATH 197,002,095566,Kedlaya; Kiran S.,9997,0,9999,2
1657255325865,MATH 197,003,095567,Xiao; Ming,9999,0,9999,0
1657255325865,MATH 197,004,095571,Perols; Johan Lars,9998,0,9999,1
1657255332928,COGS 9,A01,083615,Shannon; Kyle Michael,8,0,75,67
1657255338956,COGS 11,A01,083617,Boyle; Mary E. T.,22,0,48,26
1657255344981,COGS 13,A01,083071,Bastos; Amalia Pinkusfeld,8,0,71,63
1657255351008,COGS 14A,A01,092681,Semenuks; Arturs,2,1,100,98
1657255357030,COGS 14B,A01,083073,Cheng; Tzu-Han,6,0,63,57
1657255363052,COGS 17,A01,092677,Semenuks; Arturs,5,0,81,76
1657255369076,COGS 100,A01,083619,Allen; Michael Gordon,16,0,70,54
1657255375101,COGS 101A,A01,083621,Davis; Joshua Daniel,9,0,68,59
1657255381127,COGS 101B,A01,091572,Allen; Michael Gordon,11,0,65,54
1657255387157,COGS 101C,A01,083625,Delgado; Tania,17,0,35,18
1657255393181,COGS 107A,A01,083627,Boyle; Mary E. T.,13,0,60,47
1657255399206,COGS 118A,A01,083075,Gupta; Anjum,18,0,76,58
1657255405233,CSE 3,A50,083646,Miranda; Gregory Joseph,24,0,50,26
1657255411256,CSE 8A,A50,083650,Miranda; Gregory Joseph,17,1,56,39
1657255417283,CSE 11,A01,083080,Cao; Yingjun,5,15,40,35
1657255423310,CSE 12,A01,083652,Krause-Levy; Sophia Louisa,26,1,120,94
1657255429334,CSE 15L,A01,083654,Morris; Justin Loren,9,0,50,41
1657255429334,CSE 15L,A02,083655,Morris; Justin Loren,9,0,50,41
1657255435358,CSE 20,A01,083657,Tran; Khoa Dang,38,0,80,42
1657255441387,CSE 21,A01,095574,Bach; Quang Tran,22,0,48,26
1657255447413,CSE 30,A01,083084,Eldon; John,4,0,80,76
1657255447413,CSE 30,B01,095061,Bhaskar; Nishant,8,0,50,42
1657255453441,CSE 100,A01,083659,Cao; Yingjun,4,4,70,66
1657255459468,CSE 134B,A01,083661,Powell; Thomas Allan,21,0,100,79
1657255465494,CSE 140,A01,083663,Gungor; Onat,13,0,85,72
1657255471519,CSE 140L,A01,083088,Eldon; John,18,0,100,82
1657255477552,CSE 175,A01,083665,Kumar; Rakesh,3,0,25,22
1657255483573,CSE 190,A00,092507,Dubnov; Shlomo,7,0,20,13
1657255489596,ECE 45,A01,083139,Congero; Spencer William,5,0,75,70
1657255495626,ECE 65,A50,083695,Saad; Andrew S,12,0,30,18
1657255495626,ECE 65,A51,095125,Saad; Andrew S,25,0,26,1
1657255501653,ECE 109,A01,091882,Touri; Behrouz,19,0,70,51
1657255507677,ECE 180,A00,083140,Abi Samra; Nicholas Camill,1,0,30,29
1657255507677,ECE 180,B00,083141,Abi Samra; Nicholas Camill,0,0,30,30
1657255513706,MATH 10A,A01,083735,Patchell; Gregory David,2,0,30,28
1657255513706,MATH 10A,A02,083736,Patchell; Gregory David,20,0,30,10
1657255513706,MATH 10A,A03,083737,Patchell; Gregory David,16,0,30,14
1657255519734,MATH 10B,A01,083207,Lim; Seonhee,7,0,34,27
1657255519734,MATH 10B,A02,083208,Lim; Seonhee,9,0,35,26
1657255519734,MATH 10B,A03,093472,Lim; Seonhee,5,0,34,29
1657255519734,MATH 10B,B01,083739,Sinha; Shubham,11,0,30,19
1657255525764,MATH 18,A01,083743,Cinel; Cameron Alexander,6,0,30,24
1657255525764,MATH 18,A02,083744,Cinel; Cameron Alexander,17,0,30,13
1657255525764,MATH 18,A03,083745,Cinel; Cameron Alexander,8,0,30,22
1657255525764,MATH 18,B01,083748,Rideout; David Porter,4,0,37,33
1657255525764,MATH 18,B02,083749,Rideout; David Porter,4,0,36,32
1657255525764,MATH 18,B03,083750,Rideout; David Porter,2,0,37,35
1657255525764,MATH 18,B04,083751,Rideout; David Porter,6,0,36,30
1657255525764,MATH 18,B05,093473,Rideout; David Porter,5,0,36,31
1657255525764,MATH 18,B06,093474,Rideout; David Porter,5,0,36,31
1657255531786,MATH 20A,A01,083754,Zheng; Zequn,14,0,40,26
1657255537815,MATH 20B,A01,083756,Briones; Jor-el Thomas Caparas,3,0,36,33
1657255537815,MATH 20B,A02,083757,Briones; Jor-el Thomas Caparas,1,0,36,35
1657255537815,MATH 20B,A03,093475,Briones; Jor-el Thomas Caparas,2,0,36,34
1657255543839,MATH 20C,A01,083760,Briones; Jor-el Thomas Caparas,1,0,35,34
1657255543839,MATH 20C,A02,083761,Briones; Jor-el Thomas Caparas,8,0,35,27
1657255543839,MATH 20C,A03,093476,Briones; Jor-el Thomas Caparas,0,1,36,36
1657255543839,MATH 20C,B01,083762,Bach; Quang Tran,1,0,30,29
1657255549862,MATH 20D,A01,083765,Tran; Brian Kha,4,0,30,26
1657255549862,MATH 20D,A02,083766,Tran; Brian Kha,5,0,30,25
1657255549862,MATH 20D,A03,083767,Tran; Brian Kha,4,0,30,26
1657255555891,MATH 20E,A01,083771,Ganguly; Soumya,7,0,32,25
1657255555891,MATH 20E,A02,083772,Ganguly; Soumya,7,0,32,25
1657255555891,MATH 20E,B01,083773,Ciotti; Benjamin,19,0,35,16
1657255555891,MATH 20E,B02,083774,Ciotti; Benjamin,17,0,35,18
1657255561920,MATH 103A,A01,083777,Greenfeld; Be'Eri,3,0,36,33
1657255561920,MATH 103A,A02,083778,Greenfeld; Be'Eri,5,0,36,31
1657255561920,MATH 103A,A03,093561,Greenfeld; Be'Eri,4,0,36,32
1657255561920,MATH 103A,B01,083779,Greenfeld; Be'Eri,6,0,36,30
1657255561920,MATH 103A,B02,083780,Greenfeld; Be'Eri,3,0,36,33
1657255561920,MATH 103A,B03,093562,Greenfeld; Be'Eri,3,0,36,33
1657255567948,MATH 105,A01,085443,Carter; Anne Toulson,15,0,35,20
1657255567948,MATH 105,A02,093477,Carter; Anne Toulson,20,0,35,15
1657255573978,MATH 109,A01,083213,Ganzberger; Geoffrey Michael,2,0,34,32
1657255573978,MATH 109,A02,083214,Ganzberger; Geoffrey Michael,4,0,34,30
1657255573978,MATH 109,A03,093478,Ganzberger; Geoffrey Michael,2,0,34,32
1657255573978,MATH 109,B01,083215,Ganzberger; Geoffrey Michael,1,0,32,31
1657255573978,MATH 109,B02,083216,Ganzberger; Geoffrey Michael,1,0,32,31
1657255573978,MATH 109,B03,093479,Ganzberger; Geoffrey Michael,8,0,32,24
1657255580010,MATH 142A,A01,083219,Chow; Bennett,6,0,32,26
1657255580010,MATH 142A,A02,083220,Chow; Bennett,10,0,32,22
1657255580010,MATH 142A,A03,093480,Chow; Bennett,7,0,32,25
1657255580010,MATH 142A,B03,093481,Chow; Bennett,8,0,32,24
1657255580010,MATH 142A,B04,093558,Chow; Bennett,12,0,32,20
1657255580010,MATH 142A,B05,093559,Chow; Bennett,6,0,32,26
1657255586037,MATH 193A,A01,083224,Rotar; Vladimir,7,0,34,27
1657255586037,MATH 193A,A02,083225,Rotar; Vladimir,6,0,34,28
1657255586037,MATH 193A,A03,083781,Rotar; Vladimir,2,0,34,32
1657255586037,MATH 193A,A04,083782,Rotar; Vladimir,8,0,34,26
1657255586037,MATH 193A,A05,093482,Rotar; Vladimir,6,0,34,28
1657255592064,MATH 197,001,091859,McAuley; Julian John,9999,0,9999,0
1657255592064,MATH 197,002,095566,Kedlaya; Kiran S.,9997,0,9999,2
1657255592064,MATH 197,003,095567,Xiao; Ming,9999,0,9999,0
1657255592064,MATH 197,004,095571,Perols; Johan Lars,9998,0,9999,1
1657255599120,COGS 9,A01,083615,Shannon; Kyle Michael,8,0,75,67
1657255605144,COGS 11,A01,083617,Boyle; Mary E. T.,22,0,48,26
1657255611171,COGS 13,A01,083071,Bastos; Amalia Pinkusfeld,8,0,71,63
1657255617194,COGS 14A,A01,092681,Semenuks; Arturs,2,1,100,98
1657255623222,COGS 14B,A01,083073,Cheng; Tzu-Han,6,0,63,57
1657255629245,COGS 17,A01,092677,Semenuks; Arturs,5,0,81,76
1657255635280,COGS 100,A01,083619,Allen; Michael Gordon,16,0,70,54
1657255641303,COGS 101A,A01,083621,Davis; Joshua Daniel,9,0,68,59
1657255647326,COGS 101B,A01,091572,Allen; Michael Gordon,11,0,65,54
1657255653351,COGS 101C,A01,083625,Delgado; Tania,17,0,35,18
1657255659377,COGS 107A,A01,083627,Boyle; Mary E. T.,13,0,60,47
1657255665410,COGS 118A,A01,083075,Gupta; Anjum,18,0,76,58
1657255671443,CSE 3,A50,083646,Miranda; Gregory Joseph,24,0,50,26
1657255677472,CSE 8A,A50,083650,Miranda; Gregory Joseph,17,1,56,39
1657255683493,CSE 11,A01,083080,Cao; Yingjun,5,15,40,35
1657255689518,CSE 12,A01,083652,Krause-Levy; Sophia Louisa,26,1,120,94
1657255695540,CSE 15L,A01,083654,Morris; Justin Loren,9,0,50,41
1657255695540,CSE 15L,A02,083655,Morris; Justin Loren,9,0,50,41
1657255701563,CSE 20,A01,083657,Tran; Khoa Dang,38,0,80,42
1657255707589,CSE 21,A01,095574,Bach; Quang Tran,22,0,48,26
1657255713615,CSE 30,A01,083084,Eldon; John,4,0,80,76
1657255713615,CSE 30,B01,095061,Bhaskar; Nishant,8,0,50,42
1657255719639,CSE 100,A01,083659,Cao; Yingjun,4,4,70,66
1657255725666,CSE 134B,A01,083661,Powell; Thomas Allan,21,0,100,79
1657255731690,CSE 140,A01,083663,Gungor; Onat,13,0,85,72
1657255737718,CSE 140L,A01,083088,Eldon; John,18,0,100,82
1657255743742,CSE 175,A01,083665,Kumar; Rakesh,3,0,25,22
1657255749769,CSE 190,A00,092507,Dubnov; Shlomo,7,0,20,13
1657255755862,ECE 45,A01,083139,Congero; Spencer William,5,0,75,70
1657255761887,ECE 65,A50,083695,Saad; Andrew S,12,0,30,18
1657255761887,ECE 65,A51,095125,Saad; Andrew S,25,0,26,1
1657255767914,ECE 109,A01,091882,Touri; Behrouz,19,0,70,51
1657255773940,ECE 180,A00,083140,Abi Samra; Nicholas Camill,1,0,30,29
1657255773940,ECE 180,B00,083141,Abi Samra; Nicholas Camill,0,0,30,30
1657255779969,MATH 10A,A01,083735,Patchell; Gregory David,2,0,30,28
1657255779969,MATH 10A,A02,083736,Patchell; Gregory David,20,0,30,10
1657255779969,MATH 10A,A03,083737,Patchell; Gregory David,16,0,30,14
1657255786006,MATH 10B,A01,083207,Lim; Seonhee,7,0,34,27
1657255786006,MATH 10B,A02,083208,Lim; Seonhee,9,0,35,26
1657255786006,MATH 10B,A03,093472,Lim; Seonhee,5,0,34,29
1657255786006,MATH 10B,B01,083739,Sinha; Shubham,11,0,30,19
1657255792046,MATH 18,A01,083743,Cinel; Cameron Alexander,6,0,30,24
1657255792046,MATH 18,A02,083744,Cinel; Cameron Alexander,17,0,30,13
1657255792046,MATH 18,A03,083745,Cinel; Cameron Alexander,8,0,30,22
1657255792046,MATH 18,B01,083748,Rideout; David Porter,4,0,37,33
1657255792046,MATH 18,B02,083749,Rideout; David Porter,4,0,36,32
1657255792046,MATH 18,B03,083750,Rideout; David Porter,2,0,37,35
1657255792046,MATH 18,B04,083751,Rideout; David Porter,6,0,36,30
1657255792046,MATH 18,B05,093473,Rideout; David Porter,5,0,36,31
1657255792046,MATH 18,B06,093474,Rideout; David Porter,5,0,36,31
1657255798073,MATH 20A,A01,083754,Zheng; Zequn,14,0,40,26
1657255804096,MATH 20B,A01,083756,Briones; Jor-el Thomas Caparas,3,0,36,33
1657255804096,MATH 20B,A02,083757,Briones; Jor-el Thomas Caparas,1,0,36,35
1657255804096,MATH 20B,A03,093475,Briones; Jor-el Thomas Caparas,2,0,36,34
1657255810126,MATH 20C,A01,083760,Briones; Jor-el Thomas Caparas,1,0,35,34
1657255810126,MATH 20C,A02,083761,Briones; Jor-el Thomas Caparas,8,0,35,27
1657255810126,MATH 20C,A03,093476,Briones; Jor-el Thomas Caparas,0,1,36,36
1657255810126,MATH 20C,B01,083762,Bach; Quang Tran,1,0,30,29
1657255816156,MATH 20D,A01,083765,Tran; Brian Kha,4,0,30,26
1657255816156,MATH 20D,A02,083766,Tran; Brian Kha,5,0,30,25
1657255816156,MATH 20D,A03,083767,Tran; Brian Kha,4,0,30,26
1657255822178,MATH 20E,A01,083771,Ganguly; Soumya,7,0,32,25
1657255822178,MATH 20E,A02,083772,Ganguly; Soumya,7,0,32,25
1657255822178,MATH 20E,B01,083773,Ciotti; Benjamin,19,0,35,16
1657255822178,MATH 20E,B02,083774,Ciotti; Benjamin,17,0,35,18
1657255828202,MATH 103A,A01,083777,Greenfeld; Be'Eri,3,0,36,33
1657255828202,MATH 103A,A02,083778,Greenfeld; Be'Eri,5,0,36,31
1657255828202,MATH 103A,A03,093561,Greenfeld; Be'Eri,4,0,36,32
1657255828202,MATH 103A,B01,083779,Greenfeld; Be'Eri,6,0,36,30
1657255828202,MATH 103A,B02,083780,Greenfeld; Be'Eri,3,0,36,33
1657255828202,MATH 103A,B03,093562,Greenfeld; Be'Eri,3,0,36,33
1657255834230,MATH 105,A01,085443,Carter; Anne Toulson,15,0,35,20
1657255834230,MATH 105,A02,093477,Carter; Anne Toulson,20,0,35,15
1657255840254,MATH 109,A01,083213,Ganzberger; Geoffrey Michael,2,0,34,32
1657255840254,MATH 109,A02,083214,Ganzberger; Geoffrey Michael,4,0,34,30
1657255840254,MATH 109,A03,093478,Ganzberger; Geoffrey Michael,2,0,34,32
1657255840254,MATH 109,B01,083215,Ganzberger; Geoffrey Michael,1,0,32,31
1657255840254,MATH 109,B02,083216,Ganzberger; Geoffrey Michael,1,0,32,31
1657255840254,MATH 109,B03,093479,Ganzberger; Geoffrey Michael,8,0,32,24
1657255846278,MATH 142A,A01,083219,Chow; Bennett,6,0,32,26
1657255846278,MATH 142A,A02,083220,Chow; Bennett,10,0,32,22
1657255846278,MATH 142A,A03,093480,Chow; Bennett,7,0,32,25
1657255846278,MATH 142A,B03,093481,Chow; Bennett,8,0,32,24
1657255846278,MATH 142A,B04,093558,Chow; Bennett,12,0,32,20
1657255846278,MATH 142A,B05,093559,Chow; Bennett,6,0,32,26
1657255852305,MATH 193A,A01,083224,Rotar; Vladimir,7,0,34,27
1657255852305,MATH 193A,A02,083225,Rotar; Vladimir,6,0,34,28
1657255852305,MATH 193A,A03,083781,Rotar; Vladimir,2,0,34,32
1657255852305,MATH 193A,A04,083782,Rotar; Vladimir,8,0,34,26
1657255852305,MATH 193A,A05,093482,Rotar; Vladimir,6,0,34,28
1657255858330,MATH 197,001,091859,McAuley; Julian John,9999,0,9999,0
1657255858330,MATH 197,002,095566,Kedlaya; Kiran S.,9997,0,9999,2
1657255858330,MATH 197,003,095567,Xiao; Ming,9999,0,9999,0
1657255858330,MATH 197,004,095571,Perols; Johan Lars,9998,0,9999,1
1657255865392,COGS 9,A01,083615,Shannon; Kyle Michael,8,0,75,67
1657255871420,COGS 11,A01,083617,Boyle; Mary E. T.,22,0,48,26
1657255877445,COGS 13,A01,083071,Bastos; Amalia Pinkusfeld,8,0,71,63
1657255883470,COGS 14A,A01,092681,Semenuks; Arturs,2,1,100,98
1657255889495,COGS 14B,A01,083073,Cheng; Tzu-Han,6,0,63,57
1657255895521,COGS 17,A01,092677,Semenuks; Arturs,5,0,81,76
1657255901548,COGS 100,A01,083619,Allen; Michael Gordon,16,0,70,54
1657255907572,COGS 101A,A01,083621,Davis; Joshua Daniel,9,0,68,59
1657255913598,COGS 101B,A01,091572,Allen; Michael Gordon,11,0,65,54
1657255919622,COGS 101C,A01,083625,Delgado; Tania,17,0,35,18
1657255925646,COGS 107A,A01,083627,Boyle; Mary E. T.,13,0,60,47
1657255931672,COGS 118A,A01,083075,Gupta; Anjum,18,0,76,58
1657255937695,CSE 3,A50,083646,Miranda; Gregory Joseph,24,0,50,26
1657255943719,CSE 8A,A50,083650,Miranda; Gregory Joseph,17,1,56,39
1657255949745,CSE 11,A01,083080,Cao; Yingjun,5,15,40,35
1657255955772,CSE 12,A01,083652,Krause-Levy; Sophia Louisa,26,1,120,94
1657255961798,CSE 15L,A01,083654,Morris; Justin Loren,9,0,50,41
1657255961798,CSE 15L,A02,083655,Morris; Justin Loren,9,0,50,41
1657255967821,CSE 20,A01,083657,Tran; Khoa Dang,38,0,80,42
1657255973848,CSE 21,A01,095574,Bach; Quang Tran,22,0,48,26
1657255979872,CSE 30,A01,083084,Eldon; John,4,0,80,76
1657255979872,CSE 30,B01,095061,Bhaskar; Nishant,8,0,50,42
1657255985900,CSE 100,A01,083659,Cao; Yingjun,4,4,70,66
1657255991922,CSE 134B,A01,083661,Powell; Thomas Allan,21,0,100,79
1657255997948,CSE 140,A01,083663,Gungor; Onat,13,0,85,72
1657256003974,CSE 140L,A01,083088,Eldon; John,18,0,100,82
1657256009998,CSE 175,A01,083665,Kumar; Rakesh,3,0,25,22
1657256016024,CSE 190,A00,092507,Dubnov; Shlomo,7,0,20,13
1657256022046,ECE 45,A01,083139,Congero; Spencer William,5,0,75,70
1657256028072,ECE 65,A50,083695,Saad; Andrew S,12,0,30,18
1657256028072,ECE 65,A51,095125,Saad; Andrew S,25,0,26,1
1657256034098,ECE 109,A01,091882,Touri; Behrouz,19,0,70,51
1657256040124,ECE 180,A00,083140,Abi Samra; Nicholas Camill,1,0,30,29
1657256040124,ECE 180,B00,083141,Abi Samra; Nicholas Camill,0,0,30,30
1657256046148,MATH 10A,A01,083735,Patchell; Gregory David,2,0,30,28
1657256046148,MATH 10A,A02,083736,Patchell; Gregory David,20,0,30,10
1657256046148,MATH 10A,A03,083737,Patchell; Gregory David,16,0,30,14
1657256052173,MATH 10B,A01,083207,Lim; Seonhee,7,0,34,27
1657256052173,MATH 10B,A02,083208,Lim; Seonhee,9,0,35,26
1657256052173,MATH 10B,A03,093472,Lim; Seonhee,5,0,34,29
1657256052173,MATH 10B,B01,083739,Sinha; Shubham,11,0,30,19
1657256058198,MATH 18,A01,083743,Cinel; Cameron Alexander,6,0,30,24
1657256058198,MATH 18,A02,083744,Cinel; Cameron Alexander,17,0,30,13
1657256058198,MATH 18,A03,083745,Cinel; Cameron Alexander,8,0,30,22
1657256058198,MATH 18,B01,083748,Rideout; David Porter,4,0,37,33
1657256058198,MATH 18,B02,083749,Rideout; David Porter,4,0,36,32
1657256058198,MATH 18,B03,083750,Rideout; David Porter,2,0,37,35
1657256058198,MATH 18,B04,083751,Rideout; David Porter,6,0,36,30
1657256058198,MATH 18,B05,093473,Rideout; David Porter,5,0,36,31
1657256058198,MATH 18,B06,093474,Rideout; David Porter,5,0,36,31
1657256064221,MATH 20A,A01,083754,Zheng; Zequn,14,0,40,26
1657256070244,MATH 20B,A01,083756,Briones; Jor-el Thomas Caparas,3,0,36,33
1657256070244,MATH 20B,A02,083757,Briones; Jor-el Thomas Caparas,1,0,36,35
1657256070244,MATH 20B,A03,093475,Briones; Jor-el Thomas Caparas,2,0,36,34
1657256076267,MATH 20C,A01,083760,Briones; Jor-el Thomas Caparas,1,0,35,34
1657256076267,MATH 20C,A02,083761,Briones; Jor-el Thomas Caparas,8,0,35,27
1657256076267,MATH 20C,A03,093476,Briones; Jor-el Thomas Caparas,0,1,36,36
1657256076267,MATH 20C,B01,083762,Bach; Quang Tran,1,0,30,29
1657256082294,MATH 20D,A01,083765,Tran; Brian Kha,4,0,30,26
1657256082294,MATH 20D,A02,083766,Tran; Brian Kha,5,0,30,25
1657256082294,MATH 20D,A03,083767,Tran; Brian Kha,4,0,30,26
1657256088319,MATH 20E,A01,083771,Ganguly; Soumya,7,0,32,25
1657256088319,MATH 20E,A02,083772,Ganguly; Soumya,7,0,32,25
1657256088319,MATH 20E,B01,083773,Ciotti; Benjamin,19,0,35,16
1657256088319,MATH 20E,B02,083774,Ciotti; Benjamin,17,0,35,18
1657256094346,MATH 103A,A01,083777,Greenfeld; Be'Eri,3,0,36,33
1657256094346,MATH 103A,A02,083778,Greenfeld; Be'Eri,5,0,36,31
1657256094346,MATH 103A,A03,093561,Greenfeld; Be'Eri,4,0,36,32
1657256094346,MATH 103A,B01,083779,Greenfeld; Be'Eri,6,0,36,30
1657256094346,MATH 103A,B02,083780,Greenfeld; Be'Eri,3,0,36,33
1657256094346,MATH 103A,B03,093562,Greenfeld; Be'Eri,3,0,36,33
1657256100370,MATH 105,A01,085443,Carter; Anne Toulson,15,0,35,20
1657256100370,MATH 105,A02,093477,Carter; Anne Toulson,20,0,35,15
1657256106398,MATH 109,A01,083213,Ganzberger; Geoffrey Michael,2,0,34,32
1657256106398,MATH 109,A02,083214,Ganzberger; Geoffrey Michael,4,0,34,30
1657256106398,MATH 109,A03,093478,Ganzberger; Geoffrey Michael,2,0,34,32
1657256106398,MATH 109,B01,083215,Ganzberger; Geoffrey Michael,1,0,32,31
1657256106398,MATH 109,B02,083216,Ganzberger; Geoffrey Michael,1,0,32,31
1657256106398,MATH 109,B03,093479,Ganzberger; Geoffrey Michael,8,0,32,24
1657256112426,MATH 142A,A01,083219,Chow; Bennett,6,0,32,26
1657256112426,MATH 142A,A02,083220,Chow; Bennett,10,0,32,22
1657256112426,MATH 142A,A03,093480,Chow; Bennett,7,0,32,25
1657256112426,MATH 142A,B03,093481,Chow; Bennett,8,0,32,24
1657256112426,MATH 142A,B04,093558,Chow; Bennett,12,0,32,20
1657256112426,MATH 142A,B05,093559,Chow; Bennett,6,0,32,26
1657256118456,MATH 193A,A01,083224,Rotar; Vladimir,7,0,34,27
1657256118456,MATH 193A,A02,083225,Rotar; Vladimir,6,0,34,28
1657256118456,MATH 193A,A03,083781,Rotar; Vladimir,2,0,34,32
1657256118456,MATH 193A,A04,083782,Rotar; Vladimir,8,0,34,26
1657256118456,MATH 193A,A05,093482,Rotar; Vladimir,6,0,34,28
1657256124478,MATH 197,001,091859,McAuley; Julian John,9999,0,9999,0
1657256124478,MATH 197,002,095566,Kedlaya; Kiran S.,9997,0,9999,2
1657256124478,MATH 197,003,095567,Xiao; Ming,9999,0,9999,0
1657256124478,MATH 197,004,095571,Perols; Johan Lars,9998,0,9999,1
1657256131533,COGS 9,A01,083615,Shannon; Kyle Michael,8,0,75,67
1657256137560,COGS 11,A01,083617,Boyle; Mary E. T.,22,0,48,26
1657256143581,COGS 13,A01,083071,Bastos; Amalia Pinkusfeld,8,0,71,63
1657256149610,COGS 14A,A01,092681,Semenuks; Arturs,2,1,100,98
1657256155636,COGS 14B,A01,083073,Cheng; Tzu-Han,6,0,63,57
1657256161660,COGS 17,A01,092677,Semenuks; Arturs,5,0,81,76
1657256167683,COGS 100,A01,083619,Allen; Michael Gordon,16,0,70,54
1657256173714,COGS 101A,A01,083621,Davis; Joshua Daniel,9,0,68,59
1657256179742,COGS 101B,A01,091572,Allen; Michael Gordon,11,0,65,54
1657256185764,COGS 101C,A01,083625,Delgado; Tania,17,0,35,18
1657256191786,COGS 107A,A01,083627,Boyle; Mary E. T.,13,0,60,47
1657256197808,COGS 118A,A01,083075,Gupta; Anjum,18,0,76,58
1657256203829,CSE 3,A50,083646,Miranda; Gregory Joseph,24,0,50,26
1657256209853,CSE 8A,A50,083650,Miranda; Gregory Joseph,17,1,56,39
1657256215877,CSE 11,A01,083080,Cao; Yingjun,5,15,40,35
1657256221900,CSE 12,A01,083652,Krause-Levy; Sophia Louisa,26,1,120,94
1657256227930,CSE 15L,A01,083654,Morris; Justin Loren,9,0,50,41
1657256227930,CSE 15L,A02,083655,Morris; Justin Loren,9,0,50,41
1657256233953,CSE 20,A01,083657,Tran; Khoa Dang,38,0,80,42
1657256239976,CSE 21,A01,095574,Bach; Quang Tran,22,0,48,26
1657256246000,CSE 30,A01,083084,Eldon; John,4,0,80,76
1657256246000,CSE 30,B01,095061,Bhaskar; Nishant,8,0,50,42
1657256252023,CSE 100,A01,083659,Cao; Yingjun,4,4,70,66
1657256258055,CSE 134B,A01,083661,Powell; Thomas Allan,21,0,100,79
1657256264079,CSE 140,A01,083663,Gungor; Onat,13,0,85,72
1657256270119,CSE 140L,A01,083088,Eldon; John,18,0,100,82
1657256276147,CSE 175,A01,083665,Kumar; Rakesh,3,0,25,22
1657256282170,CSE 190,A00,092507,Dubnov; Shlomo,7,0,20,13
1657256288198,ECE 45,A01,083139,Congero; Spencer William,5,0,75,70
1657256294221,ECE 65,A50,083695,Saad; Andrew S,12,0,30,18
1657256294221,ECE 65,A51,095125,Saad; Andrew S,25,0,26,1
1657256300245,ECE 109,A01,091882,Touri; Behrouz,19,0,70,51
1657256306270,ECE 180,A00,083140,Abi Samra; Nicholas Camill,1,0,30,29
1657256306270,ECE 180,B00,083141,Abi Samra; Nicholas Camill,0,0,30,30
1657256312298,MATH 10A,A01,083735,Patchell; Gregory David,2,0,30,28
1657256312298,MATH 10A,A02,083736,Patchell; Gregory David,20,0,30,10
1657256312298,MATH 10A,A03,083737,Patchell; Gregory David,16,0,30,14
1657256318326,MATH 10B,A01,083207,Lim; Seonhee,7,0,34,27
1657256318326,MATH 10B,A02,083208,Lim; Seonhee,9,0,35,26
1657256318326,MATH 10B,A03,093472,Lim; Seonhee,5,0,34,29
1657256318326,MATH 10B,B01,083739,Sinha; Shubham,11,0,30,19
1657256324350,MATH 18,A01,083743,Cinel; Cameron Alexander,6,0,30,24
1657256324350,MATH 18,A02,083744,Cinel; Cameron Alexander,17,0,30,13
1657256324350,MATH 18,A03,083745,Cinel; Cameron Alexander,8,0,30,22
1657256324350,MATH 18,B01,083748,Rideout; David Porter,4,0,37,33
1657256324350,MATH 18,B02,083749,Rideout; David Porter,4,0,36,32
1657256324350,MATH 18,B03,083750,Rideout; David Porter,2,0,37,35
1657256324350,MATH 18,B04,083751,Rideout; David Porter,6,0,36,30
1657256324350,MATH 18,B05,093473,Rideout; David Porter,5,0,36,31
1657256324350,MATH 18,B06,093474,Rideout; David Porter,5,0,36,31
1657256330390,MATH 20A,A01,083754,Zheng; Zequn,14,0,40,26
1657256336414,MATH 20B,A01,083756,Briones; Jor-el Thomas Caparas,3,0,36,33
1657256336414,MATH 20B,A02,083757,Briones; Jor-el Thomas Caparas,1,0,36,35
1657256336414,MATH 20B,A03,093475,Briones; Jor-el Thomas Caparas,2,0,36,34
1657256342438,MATH 20C,A01,083760,Briones; Jor-el Thomas Caparas,1,0,35,34
1657256342438,MATH 20C,A02,083761,Briones; Jor-el Thomas Caparas,8,0,35,27
1657256342438,MATH 20C,A03,093476,Briones; Jor-el Thomas Caparas,0,1,36,36
1657256342438,MATH 20C,B01,083762,Bach; Quang Tran,1,0,30,29
1657256348463,MATH 20D,A01,083765,Tran; Brian Kha,4,0,30,26
1657256348463,MATH 20D,A02,083766,Tran; Brian Kha,5,0,30,25
1657256348463,MATH 20D,A03,083767,Tran; Brian Kha,4,0,30,26
1657256354573,MATH 20E,A01,083771,Ganguly; Soumya,7,0,32,25
1657256354573,MATH 20E,A02,083772,Ganguly; Soumya,7,0,32,25
1657256354573,MATH 20E,B01,083773,Ciotti; Benjamin,19,0,35,16
1657256354573,MATH 20E,B02,083774,Ciotti; Benjamin,17,0,35,18
1657256360603,MATH 103A,A01,083777,Greenfeld; Be'Eri,3,0,36,33
1657256360603,MATH 103A,A02,083778,Greenfeld; Be'Eri,5,0,36,31
1657256360603,MATH 103A,A03,093561,Greenfeld; Be'Eri,4,0,36,32
1657256360603,MATH 103A,B01,083779,Greenfeld; Be'Eri,6,0,36,30
1657256360603,MATH 103A,B02,083780,Greenfeld; Be'Eri,3,0,36,33
1657256360603,MATH 103A,B03,093562,Greenfeld; Be'Eri,3,0,36,33
1657256366624,MATH 105,A01,085443,Carter; Anne Toulson,15,0,35,20
1657256366624,MATH 105,A02,093477,Carter; Anne Toulson,20,0,35,15
1657256372664,MATH 109,A01,083213,Ganzberger; Geoffrey Michael,2,0,34,32
1657256372664,MATH 109,A02,083214,Ganzberger; Geoffrey Michael,4,0,34,30
1657256372664,MATH 109,A03,093478,Ganzberger; Geoffrey Michael,2,0,34,32
1657256372664,MATH 109,B01,083215,Ganzberger; Geoffrey Michael,1,0,32,31
1657256372664,MATH 109,B02,083216,Ganzberger; Geoffrey Michael,1,0,32,31
1657256372664,MATH 109,B03,093479,Ganzberger; Geoffrey Michael,8,0,32,24
1657256378689,MATH 142A,A01,083219,Chow; Bennett,6,0,32,26
1657256378689,MATH 142A,A02,083220,Chow; Bennett,10,0,32,22
1657256378689,MATH 142A,A03,093480,Chow; Bennett,7,0,32,25
1657256378689,MATH 142A,B03,093481,Chow; Bennett,8,0,32,24
1657256378689,MATH 142A,B04,093558,Chow; Bennett,12,0,32,20
1657256378689,MATH 142A,B05,093559,Chow; Bennett,6,0,32,26
1657256384716,MATH 193A,A01,083224,Rotar; Vladimir,7,0,34,27
1657256384716,MATH 193A,A02,083225,Rotar; Vladimir,6,0,34,28
1657256384716,MATH 193A,A03,083781,Rotar; Vladimir,2,0,34,32
1657256384716,MATH 193A,A04,083782,Rotar; Vladimir,8,0,34,26
1657256384716,MATH 193A,A05,093482,Rotar; Vladimir,6,0,34,28
1657256390743,MATH 197,001,091859,McAuley; Julian John,9999,0,9999,0
1657256390743,MATH 197,002,095566,Kedlaya; Kiran S.,9997,0,9999,2
1657256390743,MATH 197,003,095567,Xiao; Ming,9999,0,9999,0
1657256390743,MATH 197,004,095571,Perols; Johan Lars,9998,0,9999,1
1657256397798,COGS 9,A01,083615,Shannon; Kyle Michael,8,0,75,67
1657256403821,COGS 11,A01,083617,Boyle; Mary E. T.,22,0,48,26
1657256409844,COGS 13,A01,083071,Bastos; Amalia Pinkusfeld,8,0,71,63
1657256415868,COGS 14A,A01,092681,Semenuks; Arturs,2,1,100,98
1657256421895,COGS 14B,A01,083073,Cheng; Tzu-Han,6,0,63,57
1657256427928,COGS 17,A01,092677,Semenuks; Arturs,5,0,81,76
1657256433954,COGS 100,A01,083619,Allen; Michael Gordon,16,0,70,54
1657256439980,COGS 101A,A01,083621,Davis; Joshua Daniel,9,0,68,59
1657256446005,COGS 101B,A01,091572,Allen; Michael Gordon,11,0,65,54
1657256452028,COGS 101C,A01,083625,Delgado; Tania,17,0,35,18
1657256458050,COGS 107A,A01,083627,Boyle; Mary E. T.,13,0,60,47
1657256464072,COGS 118A,A01,083075,Gupta; Anjum,18,0,76,58
1657256470093,CSE 3,A50,083646,Miranda; Gregory Joseph,24,0,50,26
1657256476117,CSE 8A,A50,083650,Miranda; Gregory Joseph,17,1,56,39
1657256482143,CSE 11,A01,083080,Cao; Yingjun,5,15,40,35
1657256488175,CSE 12,A01,083652,Krause-Levy; Sophia Louisa,26,1,120,94
1657256494201,CSE 15L,A01,083654,Morris; Justin Loren,9,0,50,41
1657256494201,CSE 15L,A02,083655,Morris; Justin Loren,9,0,50,41
1657256500225,CSE 20,A01,083657,Tran; Khoa Dang,38,0,80,42
1657256506250,CSE 21,A01,095574,Bach; Quang Tran,22,0,48,26
1657256512277,CSE 30,A01,083084,Eldon; John,4,0,80,76
1657256512277,CSE 30,B01,095061,Bhaskar; Nishant,8,0,50,42
1657256518305,CSE 100,A01,083659,Cao; Yingjun,4,4,70,66
1657256524330,CSE 134B,A01,083661,Powell; Thomas Allan,21,0,100,79
1657256530362,CSE 140,A01,083663,Gungor; Onat,13,0,85,72
1657256536384,CSE 140L,A01,083088,Eldon; John,18,0,100,82
1657256542407,CSE 175,A01,083665,Kumar; Rakesh,3,0,25,22
1657256548432,CSE 190,A00,092507,Dubnov; Shlomo,7,0,20,13
1657256554455,ECE 45,A01,083139,Congero; Spencer William,5,0,75,70
1657256560476,ECE 65,A50,083695,Saad; Andrew S,12,0,30,18
1657256560476,ECE 65,A51,095125,Saad; Andrew S,25,0,26,1
1657256566499,ECE 109,A01,091882,Touri; Behrouz,19,0,70,51
1657256572526,ECE 180,A00,083140,Abi Samra; Nicholas Camill,1,0,30,29
1657256572526,ECE 180,B00,083141,Abi Samra; Nicholas Camill,0,0,30,30
1657256578548,MATH 10A,A01,083735,Patchell; Gregory David,2,0,30,28
1657256578548,MATH 10A,A02,083736,Patchell; Gregory David,20,0,30,10
1657256578548,MATH 10A,A03,083737,Patchell; Gregory David,16,0,30,14
1657256584576,MATH 10B,A01,083207,Lim; Seonhee,7,0,34,27
1657256584576,MATH 10B,A02,083208,Lim; Seonhee,9,0,35,26
1657256584576,MATH 10B,A03,093472,Lim; Seonhee,5,0,34,29
1657256584576,MATH 10B,B01,083739,Sinha; Shubham,11,0,30,19
1657256590610,MATH 18,A01,083743,Cinel; Cameron Alexander,6,0,30,24
1657256590610,MATH 18,A02,083744,Cinel; Cameron Alexander,17,0,30,13
1657256590610,MATH 18,A03,083745,Cinel; Cameron Alexander,8,0,30,22
1657256590610,MATH 18,B01,083748,Rideout; David Porter,4,0,37,33
1657256590610,MATH 18,B02,083749,Rideout; David Porter,4,0,36,32
1657256590610,MATH 18,B03,083750,Rideout; David Porter,2,0,37,35
1657256590610,MATH 18,B04,083751,Rideout; David Porter,6,0,36,30
1657256590610,MATH 18,B05,093473,Rideout; David Porter,5,0,36,31
1657256590610,MATH 18,B06,093474,Rideout; David Porter,5,0,36,31
1657256596633,MATH 20A,A01,083754,Zheng; Zequn,14,0,40,26
1657256602657,MATH 20B,A01,083756,Briones; Jor-el Thomas Caparas,3,0,36,33
1657256602657,MATH 20B,A02,083757,Briones; Jor-el Thomas Caparas,1,0,36,35
1657256602657,MATH 20B,A03,093475,Briones; Jor-el Thomas Caparas,2,0,36,34
1657256608686,MATH 20C,A01,083760,Briones; Jor-el Thomas Caparas,1,0,35,34
1657256608686,MATH 20C,A02,083761,Briones; Jor-el Thomas Caparas,8,0,35,27
1657256608686,MATH 20C,A03,093476,Briones; Jor-el Thomas Caparas,0,1,36,36
1657256608686,MATH 20C,B01,083762,Bach; Quang Tran,1,0,30,29
1657256614712,MATH 20D,A01,083765,Tran; Brian Kha,4,0,30,26
1657256614712,MATH 20D,A02,083766,Tran; Brian Kha,5,0,30,25
1657256614712,MATH 20D,A03,083767,Tran; Brian Kha,4,0,30,26
1657256620740,MATH 20E,A01,083771,Ganguly; Soumya,7,0,32,25
1657256620740,MATH 20E,A02,083772,Ganguly; Soumya,7,0,32,25
1657256620740,MATH 20E,B01,083773,Ciotti; Benjamin,19,0,35,16
1657256620740,MATH 20E,B02,083774,Ciotti; Benjamin,17,0,35,18
1657256626763,MATH 103A,A01,083777,Greenfeld; Be'Eri,3,0,36,33
1657256626763,MATH 103A,A02,083778,Greenfeld; Be'Eri,5,0,36,31
1657256626763,MATH 103A,A03,093561,Greenfeld; Be'Eri,4,0,36,32
1657256626763,MATH 103A,B01,083779,Greenfeld; Be'Eri,6,0,36,30
1657256626763,MATH 103A,B02,083780,Greenfeld; Be'Eri,3,0,36,33
1657256626763,MATH 103A,B03,093562,Greenfeld; Be'Eri,3,0,36,33
1657256632791,MATH 105,A01,085443,Carter; Anne Toulson,15,0,35,20
1657256632791,MATH 105,A02,093477,Carter; Anne Toulson,20,0,35,15
1657256638819,MATH 109,A01,083213,Ganzberger; Geoffrey Michael,2,0,34,32
1657256638819,MATH 109,A02,083214,Ganzberger; Geoffrey Michael,4,0,34,30
1657256638819,MATH 109,A03,093478,Ganzberger; Geoffrey Michael,2,0,34,32
1657256638819,MATH 109,B01,083215,Ganzberger; Geoffrey Michael,1,0,32,31
1657256638819,MATH 109,B02,083216,Ganzberger; Geoffrey Michael,1,0,32,31
1657256638819,MATH 109,B03,093479,Ganzberger; Geoffrey Michael,8,0,32,24
1657256644852,MATH 142A,A01,083219,Chow; Bennett,6,0,32,26
1657256644852,MATH 142A,A02,083220,Chow; Bennett,10,0,32,22
1657256644852,MATH 142A,A03,093480,Chow; Bennett,7,0,32,25
1657256644852,MATH 142A,B03,093481,Chow; Bennett,8,0,32,24
1657256644852,MATH 142A,B04,093558,Chow; Bennett,12,0,32,20
1657256644852,MATH 142A,B05,093559,Chow; Bennett,6,0,32,26
1657256650874,MATH 193A,A01,083224,Rotar; Vladimir,7,0,34,27
1657256650874,MATH 193A,A02,083225,Rotar; Vladimir,6,0,34,28
1657256650874,MATH 193A,A03,083781,Rotar; Vladimir,2,0,34,32
1657256650874,MATH 193A,A04,083782,Rotar; Vladimir,8,0,34,26
1657256650874,MATH 193A,A05,093482,Rotar; Vladimir,6,0,34,28
1657256656901,MATH 197,001,091859,McAuley; Julian John,9999,0,9999,0
1657256656901,MATH 197,002,095566,Kedlaya; Kiran S.,9997,0,9999,2
1657256656901,MATH 197,003,095567,Xiao; Ming,9999,0,9999,0
1657256656901,MATH 197,004,095571,Perols; Johan Lars,9998,0,9999,1
1657256663954,COGS 9,A01,083615,Shannon; Kyle Michael,8,0,75,67
1657256669980,COGS 11,A01,083617,Boyle; Mary E. T.,22,0,48,26
1657256676006,COGS 13,A01,083071,Bastos; Amalia Pinkusfeld,8,0,71,63
1657256682033,COGS 14A,A01,092681,Semenuks; Arturs,2,1,100,98
1657256688060,COGS 14B,A01,083073,Cheng; Tzu-Han,6,0,63,57
1657256694087,COGS 17,A01,092677,Semenuks; Arturs,5,0,81,76
1657256700111,COGS 100,A01,083619,Allen; Michael Gordon,16,0,70,54
1657256706135,COGS 101A,A01,083621,Davis; Joshua Daniel,9,0,68,59
1657256712159,COGS 101B,A01,091572,Allen; Michael Gordon,11,0,65,54
1657256718186,COGS 101C,A01,083625,Delgado; Tania,17,0,35,18
1657256724209,COGS 107A,A01,083627,Boyle; Mary E. T.,13,0,60,47
1657256730236,COGS 118A,A01,083075,Gupta; Anjum,18,0,76,58
1657256736258,CSE 3,A50,083646,Miranda; Gregory Joseph,24,0,50,26
1657256742281,CSE 8A,A50,083650,Miranda; Gregory Joseph,17,1,56,39
1657256748304,CSE 11,A01,083080,Cao; Yingjun,5,15,40,35
1657256754328,CSE 12,A01,083652,Krause-Levy; Sophia Louisa,26,1,120,94
1657256760361,CSE 15L,A01,083654,Morris; Justin Loren,9,0,50,41
1657256760361,CSE 15L,A02,083655,Morris; Justin Loren,9,0,50,41
1657256766384,CSE 20,A01,083657,Tran; Khoa Dang,38,0,80,42
1657256772408,CSE 21,A01,095574,Bach; Quang Tran,22,0,48,26
1657256778430,CSE 30,A01,083084,Eldon; John,4,0,80,76
1657256778430,CSE 30,B01,095061,Bhaskar; Nishant,8,0,50,42
1657256784458,CSE 100,A01,083659,Cao; Yingjun,4,4,70,66
1657256790492,CSE 134B,A01,083661,Powell; Thomas Allan,21,0,100,79
1657256796516,CSE 140,A01,083663,Gungor; Onat,13,0,85,72
1657256802546,CSE 140L,A01,083088,Eldon; John,18,0,100,82
1657256808576,CSE 175,A01,083665,Kumar; Rakesh,3,0,25,22
1657256814603,CSE 190,A00,092507,Dubnov; Shlomo,7,0,20,13
1657256820631,ECE 45,A01,083139,Congero; Spencer William,5,0,75,70
1657256826657,ECE 65,A50,083695,Saad; Andrew S,12,0,30,18
1657256826657,ECE 65,A51,095125,Saad; Andrew S,25,0,26,1
1657256832684,ECE 109,A01,091882,Touri; Behrouz,19,0,70,51
1657256838707,ECE 180,A00,083140,Abi Samra; Nicholas Camill,1,0,30,29
1657256838707,ECE 180,B00,083141,Abi Samra; Nicholas Camill,0,0,30,30
1657256844730,MATH 10A,A01,083735,Patchell; Gregory David,2,0,30,28
1657256844730,MATH 10A,A02,083736,Patchell; Gregory David,20,0,30,10
1657256844730,MATH 10A,A03,083737,Patchell; Gregory David,16,0,30,14
1657256850753,MATH 10B,A01,083207,Lim; Seonhee,7,0,34,27
1657256850753,MATH 10B,A02,083208,Lim; Seonhee,9,0,35,26
1657256850753,MATH 10B,A03,093472,Lim; Seonhee,5,0,34,29
1657256850753,MATH 10B,B01,083739,Sinha; Shubham,11,0,30,19
1657256856783,MATH 18,A01,083743,Cinel; Cameron Alexander,6,0,30,24
1657256856783,MATH 18,A02,083744,Cinel; Cameron Alexander,17,0,30,13
1657256856783,MATH 18,A03,083745,Cinel; Cameron Alexander,8,0,30,22
1657256856783,MATH 18,B01,083748,Rideout; David Porter,4,0,37,33
1657256856783,MATH 18,B02,083749,Rideout; David Porter,4,0,36,32
1657256856783,MATH 18,B03,083750,Rideout; David Porter,2,0,37,35
1657256856783,MATH 18,B04,083751,Rideout; David Porter,6,0,36,30
1657256856783,MATH 18,B05,093473,Rideout; David Porter,5,0,36,31
1657256856783,MATH 18,B06,093474,Rideout; David Porter,5,0,36,31
1657256862811,MATH 20A,A01,083754,Zheng; Zequn,14,0,40,26
1657256868836,MATH 20B,A01,083756,Briones; Jor-el Thomas Caparas,3,0,36,33
1657256868836,MATH 20B,A02,083757,Briones; Jor-el Thomas Caparas,1,0,36,35
1657256868836,MATH 20B,A03,093475,Briones; Jor-el Thomas Caparas,2,0,36,34
1657256874867,MATH 20C,A01,083760,Briones; Jor-el Thomas Caparas,1,0,35,34
1657256874867,MATH 20C,A02,083761,Briones; Jor-el Thomas Caparas,8,0,35,27
1657256874867,MATH 20C,A03,093476,Briones; Jor-el Thomas Caparas,0,1,36,36
1657256874867,MATH 20C,B01,083762,Bach; Quang Tran,1,0,30,29
1657256880898,MATH 20D,A01,083765,Tran; Brian Kha,4,0,30,26
1657256880898,MATH 20D,A02,083766,Tran; Brian Kha,5,0,30,25
1657256880898,MATH 20D,A03,083767,Tran; Brian Kha,4,0,30,26
1657256886922,MATH 20E,A01,083771,Ganguly; Soumya,7,0,32,25
1657256886922,MATH 20E,A02,083772,Ganguly; Soumya,7,0,32,25
1657256886922,MATH 20E,B01,083773,Ciotti; Benjamin,19,0,35,16
1657256886922,MATH 20E,B02,083774,Ciotti; Benjamin,17,0,35,18
1657256892945,MATH 103A,A01,083777,Greenfeld; Be'Eri,3,0,36,33
1657256892945,MATH 103A,A02,083778,Greenfeld; Be'Eri,5,0,36,31
1657256892945,MATH 103A,A03,093561,Greenfeld; Be'Eri,4,0,36,32
1657256892945,MATH 103A,B01,083779,Greenfeld; Be'Eri,6,0,36,30
1657256892945,MATH 103A,B02,083780,Greenfeld; Be'Eri,3,0,36,33
1657256892945,MATH 103A,B03,093562,Greenfeld; Be'Eri,3,0,36,33
1657256898971,MATH 105,A01,085443,Carter; Anne Toulson,15,0,35,20
1657256898971,MATH 105,A02,093477,Carter; Anne Toulson,20,0,35,15
1657256905005,MATH 109,A01,083213,Ganzberger; Geoffrey Michael,2,0,34,32
1657256905005,MATH 109,A02,083214,Ganzberger; Geoffrey Michael,4,0,34,30
1657256905005,MATH 109,A03,093478,Ganzberger; Geoffrey Michael,2,0,34,32
1657256905005,MATH 109,B01,083215,Ganzberger; Geoffrey Michael,1,0,32,31
1657256905005,MATH 109,B02,083216,Ganzberger; Geoffrey Michael,1,0,32,31
1657256905005,MATH 109,B03,093479,Ganzberger; Geoffrey Michael,8,0,32,24
1657256911028,MATH 142A,A01,083219,Chow; Bennett,6,0,32,26
1657256911028,MATH 142A,A02,083220,Chow; Bennett,10,0,32,22
1657256911028,MATH 142A,A03,093480,Chow; Bennett,7,0,32,25
1657256911028,MATH 142A,B03,093481,Chow; Bennett,8,0,32,24
1657256911028,MATH 142A,B04,093558,Chow; Bennett,12,0,32,20
1657256911028,MATH 142A,B05,093559,Chow; Bennett,6,0,32,26
1657256917056,MATH 193A,A01,083224,Rotar; Vladimir,7,0,34,27
1657256917056,MATH 193A,A02,083225,Rotar; Vladimir,6,0,34,28
1657256917056,MATH 193A,A03,083781,Rotar; Vladimir,2,0,34,32
1657256917056,MATH 193A,A04,083782,Rotar; Vladimir,8,0,34,26
1657256917056,MATH 193A,A05,093482,Rotar; Vladimir,6,0,34,28
1657256923080,MATH 197,001,091859,McAuley; Julian John,9999,0,9999,0
1657256923080,MATH 197,002,095566,Kedlaya; Kiran S.,9997,0,9999,2
1657256923080,MATH 197,003,095567,Xiao; Ming,9999,0,9999,0
1657256923080,MATH 197,004,095571,Perols; Johan Lars,9998,0,9999,1
1657256930159,COGS 9,A01,083615,Shannon; Kyle Michael,8,0,75,67
1657256936182,COGS 11,A01,083617,Boyle; Mary E. T.,22,0,48,26
1657256942211,COGS 13,A01,083071,Bastos; Amalia Pinkusfeld,8,0,71,63
1657256948320,COGS 14A,A01,092681,Semenuks; Arturs,2,1,100,98
1657256954346,COGS 14B,A01,083073,Cheng; Tzu-Han,6,0,63,57
1657256960370,COGS 17,A01,092677,Semenuks; Arturs,5,0,81,76
1657256966398,COGS 100,A01,083619,Allen; Michael Gordon,16,0,70,54
1657256972421,COGS 101A,A01,083621,Davis; Joshua Daniel,9,0,68,59
1657256978450,COGS 101B,A01,091572,Allen; Michael Gordon,11,0,65,54
1657256984474,COGS 101C,A01,083625,Delgado; Tania,17,0,35,18
1657256990497,COGS 107A,A01,083627,Boyle; Mary E. T.,13,0,60,47
1657256996533,COGS 118A,A01,083075,Gupta; Anjum,18,0,76,58
1657257002558,CSE 3,A50,083646,Miranda; Gregory Joseph,24,0,50,26
1657257008581,CSE 8A,A50,083650,Miranda; Gregory Joseph,17,1,56,39
1657257014609,CSE 11,A01,083080,Cao; Yingjun,5,15,40,35
1657257020638,CSE 12,A01,083652,Krause-Levy; Sophia Louisa,26,1,120,94
1657257026662,CSE 15L,A01,083654,Morris; Justin Loren,9,0,50,41
1657257026662,CSE 15L,A02,083655,Morris; Justin Loren,9,0,50,41
1657257032687,CSE 20,A01,083657,Tran; Khoa Dang,38,0,80,42
1657257038708,CSE 21,A01,095574,Bach; Quang Tran,22,0,48,26
1657257044732,CSE 30,A01,083084,Eldon; John,4,0,80,76
1657257044732,CSE 30,B01,095061,Bhaskar; Nishant,8,0,50,42
1657257050756,CSE 100,A01,083659,Cao; Yingjun,4,4,70,66
1657257056783,CSE 134B,A01,083661,Powell; Thomas Allan,21,0,100,79
1657257062805,CSE 140,A01,083663,Gungor; Onat,13,0,85,72
1657257068829,CSE 140L,A01,083088,Eldon; John,18,0,100,82
1657257074855,CSE 175,A01,083665,Kumar; Rakesh,3,0,25,22
1657257080892,CSE 190,A00,092507,Dubnov; Shlomo,7,0,20,13
1657257086913,ECE 45,A01,083139,Congero; Spencer William,5,0,75,70
1657257092939,ECE 65,A50,083695,Saad; Andrew S,12,0,30,18
1657257092939,ECE 65,A51,095125,Saad; Andrew S,25,0,26,1
1657257098961,ECE 109,A01,091882,Touri; Behrouz,19,0,70,51
1657257104987,ECE 180,A00,083140,Abi Samra; Nicholas Camill,1,0,30,29
1657257104987,ECE 180,B00,083141,Abi Samra; Nicholas Camill,0,0,30,30
1657257111041,MATH 10A,A01,083735,Patchell; Gregory David,2,0,30,28
1657257111041,MATH 10A,A02,083736,Patchell; Gregory David,20,0,30,10
1657257111041,MATH 10A,A03,083737,Patchell; Gregory David,16,0,30,14
1657257117071,MATH 10B,A01,083207,Lim; Seonhee,7,0,34,27
1657257117071,MATH 10B,A02,083208,Lim; Seonhee,9,0,35,26
1657257117071,MATH 10B,A03,093472,Lim; Seonhee,5,0,34,29
1657257117071,MATH 10B,B01,083739,Sinha; Shubham,11,0,30,19
1657257123096,MATH 18,A01,083743,Cinel; Cameron Alexander,6,0,30,24
1657257123096,MATH 18,A02,083744,Cinel; Cameron Alexander,17,0,30,13
1657257123096,MATH 18,A03,083745,Cinel; Cameron Alexander,8,0,30,22
1657257123096,MATH 18,B01,083748,Rideout; David Porter,4,0,37,33
1657257123096,MATH 18,B02,083749,Rideout; David Porter,4,0,36,32
1657257123096,MATH 18,B03,083750,Rideout; David Porter,2,0,37,35
1657257123096,MATH 18,B04,083751,Rideout; David Porter,6,0,36,30
1657257123096,MATH 18,B05,093473,Rideout; David Porter,5,0,36,31
1657257123096,MATH 18,B06,093474,Rideout; David Porter,5,0,36,31
1657257129119,MATH 20A,A01,083754,Zheng; Zequn,14,0,40,26
1657257135144,MATH 20B,A01,083756,Briones; Jor-el Thomas Caparas,3,0,36,33
1657257135144,MATH 20B,A02,083757,Briones; Jor-el Thomas Caparas,1,0,36,35
1657257135144,MATH 20B,A03,093475,Briones; Jor-el Thomas Caparas,2,0,36,34
1657257141171,MATH 20C,A01,083760,Briones; Jor-el Thomas Caparas,1,0,35,34
1657257141171,MATH 20C,A02,083761,Briones; Jor-el Thomas Caparas,8,0,35,27
1657257141171,MATH 20C,A03,093476,Briones; Jor-el Thomas Caparas,0,1,36,36
1657257141171,MATH 20C,B01,083762,Bach; Quang Tran,1,0,30,29
1657257147194,MATH 20D,A01,083765,Tran; Brian Kha,4,0,30,26
1657257147194,MATH 20D,A02,083766,Tran; Brian Kha,5,0,30,25
1657257147194,MATH 20D,A03,083767,Tran; Brian Kha,4,0,30,26
1657257153234,MATH 20E,A01,083771,Ganguly; Soumya,7,0,32,25
1657257153234,MATH 20E,A02,083772,Ganguly; Soumya,7,0,32,25
1657257153234,MATH 20E,B01,083773,Ciotti; Benjamin,19,0,35,16
1657257153234,MATH 20E,B02,083774,Ciotti; Benjamin,17,0,35,18
1657257159263,MATH 103A,A01,083777,Greenfeld; Be'Eri,3,0,36,33
1657257159263,MATH 103A,A02,083778,Greenfeld; Be'Eri,5,0,36,31
1657257159263,MATH 103A,A03,093561,Greenfeld; Be'Eri,4,0,36,32
1657257159263,MATH 103A,B01,083779,Greenfeld; Be'Eri,6,0,36,30
1657257159263,MATH 103A,B02,083780,Greenfeld; Be'Eri,3,0,36,33
1657257159263,MATH 103A,B03,093562,Greenfeld; Be'Eri,3,0,36,33
1657257165289,MATH 105,A01,085443,Carter; Anne Toulson,15,0,35,20
1657257165289,MATH 105,A02,093477,Carter; Anne Toulson,20,0,35,15
1657257171317,MATH 109,A01,083213,Ganzberger; Geoffrey Michael,2,0,34,32
1657257171317,MATH 109,A02,083214,Ganzberger; Geoffrey Michael,4,0,34,30
1657257171317,MATH 109,A03,093478,Ganzberger; Geoffrey Michael,2,0,34,32
1657257171317,MATH 109,B01,083215,Ganzberger; Geoffrey Michael,1,0,32,31
1657257171317,MATH 109,B02,083216,Ganzberger; Geoffrey Michael,1,0,32,31
1657257171317,MATH 109,B03,093479,Ganzberger; Geoffrey Michael,8,0,32,24
1657257177347,MATH 142A,A01,083219,Chow; Bennett,6,0,32,26
1657257177347,MATH 142A,A02,083220,Chow; Bennett,10,0,32,22
1657257177347,MATH 142A,A03,093480,Chow; Bennett,7,0,32,25
1657257177347,MATH 142A,B03,093481,Chow; Bennett,8,0,32,24
1657257177347,MATH 142A,B04,093558,Chow; Bennett,12,0,32,20
1657257177347,MATH 142A,B05,093559,Chow; Bennett,6,0,32,26
1657257183384,MATH 193A,A01,083224,Rotar; Vladimir,7,0,34,27
1657257183384,MATH 193A,A02,083225,Rotar; Vladimir,6,0,34,28
1657257183384,MATH 193A,A03,083781,Rotar; Vladimir,2,0,34,32
1657257183384,MATH 193A,A04,083782,Rotar; Vladimir,8,0,34,26
1657257183384,MATH 193A,A05,093482,Rotar; Vladimir,6,0,34,28
1657257189410,MATH 197,001,091859,McAuley; Julian John,9999,0,9999,0
1657257189410,MATH 197,002,095566,Kedlaya; Kiran S.,9997,0,9999,2
1657257189410,MATH 197,003,095567,Xiao; Ming,9999,0,9999,0
1657257189410,MATH 197,004,095571,Perols; Johan Lars,9998,0,9999,1
1657257196461,COGS 9,A01,083615,Shannon; Kyle Michael,8,0,75,67
1657257202505,COGS 11,A01,083617,Boyle; Mary E. T.,22,0,48,26
1657257208528,COGS 13,A01,083071,Bastos; Amalia Pinkusfeld,8,0,71,63
1657257214554,COGS 14A,A01,092681,Semenuks; Arturs,2,1,100,98
1657257220577,COGS 14B,A01,083073,Cheng; Tzu-Han,6,0,63,57
1657257226602,COGS 17,A01,092677,Semenuks; Arturs,5,0,81,76
1657257232623,COGS 100,A01,083619,Allen; Michael Gordon,16,0,70,54
1657257238645,COGS 101A,A01,083621,Davis; Joshua Daniel,9,0,68,59
1657257244668,COGS 101B,A01,091572,Allen; Michael Gordon,11,0,65,54
1657257250691,COGS 101C,A01,083625,Delgado; Tania,17,0,35,18
1657257256730,COGS 107A,A01,083627,Boyle; Mary E. T.,13,0,60,47
1657257262753,COGS 118A,A01,083075,Gupta; Anjum,18,0,76,58
1657257268779,CSE 3,A50,083646,Miranda; Gregory Joseph,24,0,50,26
1657257274801,CSE 8A,A50,083650,Miranda; Gregory Joseph,17,1,56,39
1657257280825,CSE 11,A01,083080,Cao; Yingjun,5,15,40,35
1657257286848,CSE 12,A01,083652,Krause-Levy; Sophia Louisa,26,1,120,94
1657257292877,CSE 15L,A01,083654,Morris; Justin Loren,9,0,50,41
1657257292877,CSE 15L,A02,083655,Morris; Justin Loren,9,0,50,41
1657257298901,CSE 20,A01,083657,Tran; Khoa Dang,38,0,80,42
1657257304945,CSE 21,A01,095574,Bach; Quang Tran,22,0,48,26
1657257310967,CSE 30,A01,083084,Eldon; John,4,0,80,76
1657257310967,CSE 30,B01,095061,Bhaskar; Nishant,8,0,50,42
1657257316994,CSE 100,A01,083659,Cao; Yingjun,4,4,70,66
1657257323017,CSE 134B,A01,083661,Powell; Thomas Allan,21,0,100,79
1657257329039,CSE 140,A01,083663,Gungor; Onat,13,0,85,72
1657257335088,CSE 140L,A01,083088,Eldon; John,18,0,100,82
1657257341114,CSE 175,A01,083665,Kumar; Rakesh,3,0,25,22
1657257347138,CSE 190,A00,092507,Dubnov; Shlomo,7,0,20,13
1657257353175,ECE 45,A01,083139,Congero; Spencer William,5,0,75,70
1657257359202,ECE 65,A50,083695,Saad; Andrew S,12,0,30,18
1657257359202,ECE 65,A51,095125,Saad; Andrew S,25,0,26,1
1657257365227,ECE 109,A01,091882,Touri; Behrouz,19,0,70,51
1657257371254,ECE 180,A00,083140,Abi Samra; Nicholas Camill,1,0,30,29
1657257371254,ECE 180,B00,083141,Abi Samra; Nicholas Camill,0,0,30,30
1657257377281,MATH 10A,A01,083735,Patchell; Gregory David,2,0,30,28
1657257377281,MATH 10A,A02,083736,Patchell; Gregory David,20,0,30,10
1657257377281,MATH 10A,A03,083737,Patchell; Gregory David,16,0,30,14
1657257383310,MATH 10B,A01,083207,Lim; Seonhee,7,0,34,27
1657257383310,MATH 10B,A02,083208,Lim; Seonhee,9,0,35,26
1657257383310,MATH 10B,A03,093472,Lim; Seonhee,5,0,34,29
1657257383310,MATH 10B,B01,083739,Sinha; Shubham,11,0,30,19
1657257389343,MATH 18,A01,083743,Cinel; Cameron Alexander,6,0,30,24
1657257389343,MATH 18,A02,083744,Cinel; Cameron Alexander,17,0,30,13
1657257389343,MATH 18,A03,083745,Cinel; Cameron Alexander,8,0,30,22
1657257389343,MATH 18,B01,083748,Rideout; David Porter,4,0,37,33
1657257389343,MATH 18,B02,083749,Rideout; David Porter,4,0,36,32
1657257389343,MATH 18,B03,083750,Rideout; David Porter,2,0,37,35
1657257389343,MATH 18,B04,083751,Rideout; David Porter,6,0,36,30
1657257389343,MATH 18,B05,093473,Rideout; David Porter,5,0,36,31
1657257389343,MATH 18,B06,093474,Rideout; David Porter,5,0,36,31
1657257395365,MATH 20A,A01,083754,Zheng; Zequn,14,0,40,26
1657257401388,MATH 20B,A01,083756,Briones; Jor-el Thomas Caparas,3,0,36,33
1657257401388,MATH 20B,A02,083757,Briones; Jor-el Thomas Caparas,1,0,36,35
1657257401388,MATH 20B,A03,093475,Briones; Jor-el Thomas Caparas,2,0,36,34
1657257407414,MATH 20C,A01,083760,Briones; Jor-el Thomas Caparas,1,0,35,34
1657257407414,MATH 20C,A02,083761,Briones; Jor-el Thomas Caparas,8,0,35,27
1657257407414,MATH 20C,A03,093476,Briones; Jor-el Thomas Caparas,0,1,36,36
1657257407414,MATH 20C,B01,083762,Bach; Quang Tran,1,0,30,29
1657257413439,MATH 20D,A01,083765,Tran; Brian Kha,4,0,30,26
1657257413439,MATH 20D,A02,083766,Tran; Brian Kha,5,0,30,25
1657257413439,MATH 20D,A03,083767,Tran; Brian Kha,4,0,30,26
1657257419467,MATH 20E,A01,083771,Ganguly; Soumya,7,0,32,25
1657257419467,MATH 20E,A02,083772,Ganguly; Soumya,7,0,32,25
1657257419467,MATH 20E,B01,083773,Ciotti; Benjamin,19,0,35,16
1657257419467,MATH 20E,B02,083774,Ciotti; Benjamin,17,0,35,18
1657257425496,MATH 103A,A01,083777,Greenfeld; Be'Eri,3,0,36,33
1657257425496,MATH 103A,A02,083778,Greenfeld; Be'Eri,5,0,36,31
1657257425496,MATH 103A,A03,093561,Greenfeld; Be'Eri,4,0,36,32
1657257425496,MATH 103A,B01,083779,Greenfeld; Be'Eri,6,0,36,30
1657257425496,MATH 103A,B02,083780,Greenfeld; Be'Eri,3,0,36,33
1657257425496,MATH 103A,B03,093562,Greenfeld; Be'Eri,3,0,36,33
1657257431533,MATH 105,A01,085443,Carter; Anne Toulson,15,0,35,20
1657257431533,MATH 105,A02,093477,Carter; Anne Toulson,20,0,35,15
1657257437557,MATH 109,A01,083213,Ganzberger; Geoffrey Michael,2,0,34,32
1657257437557,MATH 109,A02,083214,Ganzberger; Geoffrey Michael,4,0,34,30
1657257437557,MATH 109,A03,093478,Ganzberger; Geoffrey Michael,2,0,34,32
1657257437557,MATH 109,B01,083215,Ganzberger; Geoffrey Michael,1,0,32,31
1657257437557,MATH 109,B02,083216,Ganzberger; Geoffrey Michael,1,0,32,31
1657257437557,MATH 109,B03,093479,Ganzberger; Geoffrey Michael,8,0,32,24
1657257443580,MATH 142A,A01,083219,Chow; Bennett,6,0,32,26
1657257443580,MATH 142A,A02,083220,Chow; Bennett,10,0,32,22
1657257443580,MATH 142A,A03,093480,Chow; Bennett,7,0,32,25
1657257443580,MATH 142A,B03,093481,Chow; Bennett,8,0,32,24
1657257443580,MATH 142A,B04,093558,Chow; Bennett,12,0,32,20
1657257443580,MATH 142A,B05,093559,Chow; Bennett,6,0,32,26
1657257449609,MATH 193A,A01,083224,Rotar; Vladimir,7,0,34,27
1657257449609,MATH 193A,A02,083225,Rotar; Vladimir,6,0,34,28
1657257449609,MATH 193A,A03,083781,Rotar; Vladimir,2,0,34,32
1657257449609,MATH 193A,A04,083782,Rotar; Vladimir,8,0,34,26
1657257449609,MATH 193A,A05,093482,Rotar; Vladimir,6,0,34,28
1657257455635,MATH 197,001,091859,McAuley; Julian John,9999,0,9999,0
1657257455635,MATH 197,002,095566,Kedlaya; Kiran S.,9997,0,9999,2
1657257455635,MATH 197,003,095567,Xiao; Ming,9999,0,9999,0
1657257455635,MATH 197,004,095571,Perols; Johan Lars,9998,0,9999,1
1657257462685,COGS 9,A01,083615,Shannon; Kyle Michael,8,0,75,67
1657257468713,COGS 11,A01,083617,Boyle; Mary E. T.,22,0,48,26
1657257474737,COGS 13,A01,083071,Bastos; Amalia Pinkusfeld,8,0,71,63
1657257480762,COGS 14A,A01,092681,Semenuks; Arturs,2,1,100,98
1657257486793,COGS 14B,A01,083073,Cheng; Tzu-Han,6,0,63,57
1657257492816,COGS 17,A01,092677,Semenuks; Arturs,5,0,81,76
1657257498839,COGS 100,A01,083619,Allen; Michael Gordon,16,0,70,54
1657257504861,COGS 101A,A01,083621,Davis; Joshua Daniel,9,0,68,59
1657257510888,COGS 101B,A01,091572,Allen; Michael Gordon,11,0,65,54
1657257516910,COGS 101C,A01,083625,Delgado; Tania,17,0,35,18
1657257522934,COGS 107A,A01,083627,Boyle; Mary E. T.,13,0,60,47
1657257528961,COGS 118A,A01,083075,Gupta; Anjum,18,0,76,58
1657257534995,CSE 3,A50,083646,Miranda; Gregory Joseph,24,0,50,26
1657257541019,CSE 8A,A50,083650,Miranda; Gregory Joseph,17,1,56,39
1657257547130,CSE 11,A01,083080,Cao; Yingjun,5,15,40,35
1657257553156,CSE 12,A01,083652,Krause-Levy; Sophia Louisa,26,1,120,94
1657257559181,CSE 15L,A01,083654,Morris; Justin Loren,9,0,50,41
1657257559181,CSE 15L,A02,083655,Morris; Justin Loren,9,0,50,41
1657257565215,CSE 20,A01,083657,Tran; Khoa Dang,38,0,80,42
1657257571246,CSE 21,A01,095574,Bach; Quang Tran,22,0,48,26
1657257577269,CSE 30,A01,083084,Eldon; John,4,0,80,76
1657257577269,CSE 30,B01,095061,Bhaskar; Nishant,8,0,50,42
1657257583297,CSE 100,A01,083659,Cao; Yingjun,4,4,70,66
1657257589323,CSE 134B,A01,083661,Powell; Thomas Allan,21,0,100,79
1657257595352,CSE 140,A01,083663,Gungor; Onat,13,0,85,72
1657257601378,CSE 140L,A01,083088,Eldon; John,18,0,100,82
1657257607401,CSE 175,A01,083665,Kumar; Rakesh,3,0,25,22
1657257613424,CSE 190,A00,092507,Dubnov; Shlomo,7,0,20,13
1657257619465,ECE 45,A01,083139,Congero; Spencer William,5,0,75,70
1657257625489,ECE 65,A50,083695,Saad; Andrew S,12,0,30,18
1657257625489,ECE 65,A51,095125,Saad; Andrew S,25,0,26,1
1657257631516,ECE 109,A01,091882,Touri; Behrouz,19,0,70,51
1657257637541,ECE 180,A00,083140,Abi Samra; Nicholas Camill,1,0,30,29
1657257637541,ECE 180,B00,083141,Abi Samra; Nicholas Camill,0,0,30,30
1657257643569,MATH 10A,A01,083735,Patchell; Gregory David,2,0,30,28
1657257643569,MATH 10A,A02,083736,Patchell; Gregory David,20,0,30,10
1657257643569,MATH 10A,A03,083737,Patchell; Gregory David,16,0,30,14
1657257649592,MATH 10B,A01,083207,Lim; Seonhee,7,0,34,27
1657257649592,MATH 10B,A02,083208,Lim; Seonhee,9,0,35,26
1657257649592,MATH 10B,A03,093472,Lim; Seonhee,5,0,34,29
1657257649592,MATH 10B,B01,083739,Sinha; Shubham,11,0,30,19
1657257655616,MATH 18,A01,083743,Cinel; Cameron Alexander,6,0,30,24
1657257655616,MATH 18,A02,083744,Cinel; Cameron Alexander,17,0,30,13
1657257655616,MATH 18,A03,083745,Cinel; Cameron Alexander,8,0,30,22
1657257655616,MATH 18,B01,083748,Rideout; David Porter,4,0,37,33
1657257655616,MATH 18,B02,083749,Rideout; David Porter,4,0,36,32
1657257655616,MATH 18,B03,083750,Rideout; David Porter,2,0,37,35
1657257655616,MATH 18,B04,083751,Rideout; David Porter,6,0,36,30
1657257655616,MATH 18,B05,093473,Rideout; David Porter,5,0,36,31
1657257655616,MATH 18,B06,093474,Rideout; David Porter,5,0,36,31
1657257661638,MATH 20A,A01,083754,Zheng; Zequn,14,0,40,26
1657257667660,MATH 20B,A01,083756,Briones; Jor-el Thomas Caparas,3,0,36,33
1657257667660,MATH 20B,A02,083757,Briones; Jor-el Thomas Caparas,1,0,36,35
1657257667660,MATH 20B,A03,093475,Briones; Jor-el Thomas Caparas,2,0,36,34
1657257673688,MATH 20C,A01,083760,Briones; Jor-el Thomas Caparas,1,0,35,34
1657257673688,MATH 20C,A02,083761,Briones; Jor-el Thomas Caparas,8,0,35,27
1657257673688,MATH 20C,A03,093476,Briones; Jor-el Thomas Caparas,0,1,36,36
1657257673688,MATH 20C,B01,083762,Bach; Quang Tran,1,0,30,29
1657257679712,MATH 20D,A01,083765,Tran; Brian Kha,4,0,30,26
1657257679712,MATH 20D,A02,083766,Tran; Brian Kha,5,0,30,25
1657257679712,MATH 20D,A03,083767,Tran; Brian Kha,4,0,30,26
1657257685735,MATH 20E,A01,083771,Ganguly; Soumya,7,0,32,25
1657257685735,MATH 20E,A02,083772,Ganguly; Soumya,7,0,32,25
1657257685735,MATH 20E,B01,083773,Ciotti; Benjamin,19,0,35,16
1657257685735,MATH 20E,B02,083774,Ciotti; Benjamin,17,0,35,18
1657257691763,MATH 103A,A01,083777,Greenfeld; Be'Eri,3,0,36,33
1657257691763,MATH 103A,A02,083778,Greenfeld; Be'Eri,5,0,36,31
1657257691763,MATH 103A,A03,093561,Greenfeld; Be'Eri,4,0,36,32
1657257691763,MATH 103A,B01,083779,Greenfeld; Be'Eri,6,0,36,30
1657257691763,MATH 103A,B02,083780,Greenfeld; Be'Eri,3,0,36,33
1657257691763,MATH 103A,B03,093562,Greenfeld; Be'Eri,3,0,36,33
1657257697785,MATH 105,A01,085443,Carter; Anne Toulson,15,0,35,20
1657257697785,MATH 105,A02,093477,Carter; Anne Toulson,20,0,35,15
1657257703813,MATH 109,A01,083213,Ganzberger; Geoffrey Michael,2,0,34,32
1657257703813,MATH 109,A02,083214,Ganzberger; Geoffrey Michael,4,0,34,30
1657257703813,MATH 109,A03,093478,Ganzberger; Geoffrey Michael,2,0,34,32
1657257703813,MATH 109,B01,083215,Ganzberger; Geoffrey Michael,1,0,32,31
1657257703813,MATH 109,B02,083216,Ganzberger; Geoffrey Michael,1,0,32,31
1657257703813,MATH 109,B03,093479,Ganzberger; Geoffrey Michael,8,0,32,24
1657257709835,MATH 142A,A01,083219,Chow; Bennett,6,0,32,26
1657257709835,MATH 142A,A02,083220,Chow; Bennett,10,0,32,22
1657257709835,MATH 142A,A03,093480,Chow; Bennett,7,0,32,25
1657257709835,MATH 142A,B03,093481,Chow; Bennett,8,0,32,24
1657257709835,MATH 142A,B04,093558,Chow; Bennett,12,0,32,20
1657257709835,MATH 142A,B05,093559,Chow; Bennett,6,0,32,26
1657257715863,MATH 193A,A01,083224,Rotar; Vladimir,7,0,34,27
1657257715863,MATH 193A,A02,083225,Rotar; Vladimir,6,0,34,28
1657257715863,MATH 193A,A03,083781,Rotar; Vladimir,2,0,34,32
1657257715863,MATH 193A,A04,083782,Rotar; Vladimir,8,0,34,26
1657257715863,MATH 193A,A05,093482,Rotar; Vladimir,6,0,34,28
1657257721887,MATH 197,001,091859,McAuley; Julian John,9999,0,9999,0
1657257721887,MATH 197,002,095566,Kedlaya; Kiran S.,9997,0,9999,2
1657257721887,MATH 197,003,095567,Xiao; Ming,9999,0,9999,0
1657257721887,MATH 197,004,095571,Perols; Johan Lars,9998,0,9999,1
1657257728947,COGS 9,A01,083615,Shannon; Kyle Michael,8,0,75,67
1657257734978,COGS 11,A01,083617,Boyle; Mary E. T.,22,0,48,26
1657257741017,COGS 13,A01,083071,Bastos; Amalia Pinkusfeld,8,0,71,63
1657257747040,COGS 14A,A01,092681,Semenuks; Arturs,2,1,100,98
1657257753064,COGS 14B,A01,083073,Cheng; Tzu-Han,6,0,63,57
1657257759088,COGS 17,A01,092677,Semenuks; Arturs,5,0,81,76
1657257765116,COGS 100,A01,083619,Allen; Michael Gordon,16,0,70,54
1657257771144,COGS 101A,A01,083621,Davis; Joshua Daniel,9,0,68,59
1657257777171,COGS 101B,A01,091572,Allen; Michael Gordon,11,0,65,54
1657257783199,COGS 101C,A01,083625,Delgado; Tania,17,0,35,18
1657257789227,COGS 107A,A01,083627,Boyle; Mary E. T.,13,0,60,47
1657257795251,COGS 118A,A01,083075,Gupta; Anjum,18,0,76,58
1657257801278,CSE 3,A50,083646,Miranda; Gregory Joseph,24,0,50,26
1657257807306,CSE 8A,A50,083650,Miranda; Gregory Joseph,17,1,56,39
1657257813334,CSE 11,A01,083080,Cao; Yingjun,5,15,40,35
1657257819361,CSE 12,A01,083652,Krause-Levy; Sophia Louisa,26,1,120,94
1657257825384,CSE 15L,A01,083654,Morris; Justin Loren,9,0,50,41
1657257825384,CSE 15L,A02,083655,Morris; Justin Loren,9,0,50,41
1657257831423,CSE 20,A01,083657,Tran; Khoa Dang,38,0,80,42
1657257837444,CSE 21,A01,095574,Bach; Quang Tran,22,0,48,26
1657257843467,CSE 30,A01,083084,Eldon; John,4,0,80,76
1657257843467,CSE 30,B01,095061,Bhaskar; Nishant,8,0,50,42
1657257849494,CSE 100,A01,083659,Cao; Yingjun,4,4,70,66
1657257855524,CSE 134B,A01,083661,Powell; Thomas Allan,21,0,100,79
1657257861546,CSE 140,A01,083663,Gungor; Onat,13,0,85,72
1657257867572,CSE 140L,A01,083088,Eldon; John,19,0,100,81
1657257873598,CSE 175,A01,083665,Kumar; Rakesh,3,0,25,22
1657257879620,CSE 190,A00,092507,Dubnov; Shlomo,7,0,20,13
1657257885643,ECE 45,A01,083139,Congero; Spencer William,5,0,75,70
1657257891666,ECE 65,A50,083695,Saad; Andrew S,12,0,30,18
1657257891666,ECE 65,A51,095125,Saad; Andrew S,25,0,26,1
1657257897689,ECE 109,A01,091882,Touri; Behrouz,19,0,70,51
1657257903711,ECE 180,A00,083140,Abi Samra; Nicholas Camill,1,0,30,29
1657257903711,ECE 180,B00,083141,Abi Samra; Nicholas Camill,0,0,30,30
1657257909739,MATH 10A,A01,083735,Patchell; Gregory David,2,0,30,28
1657257909739,MATH 10A,A02,083736,Patchell; Gregory David,20,0,30,10
1657257909739,MATH 10A,A03,083737,Patchell; Gregory David,16,0,30,14
1657257915769,MATH 10B,A01,083207,Lim; Seonhee,7,0,34,27
1657257915769,MATH 10B,A02,083208,Lim; Seonhee,9,0,35,26
1657257915769,MATH 10B,A03,093472,Lim; Seonhee,5,0,34,29
1657257915769,MATH 10B,B01,083739,Sinha; Shubham,11,0,30,19
1657257921795,MATH 18,A01,083743,Cinel; Cameron Alexander,6,0,30,24
1657257921795,MATH 18,A02,083744,Cinel; Cameron Alexander,17,0,30,13
1657257921795,MATH 18,A03,083745,Cinel; Cameron Alexander,8,0,30,22
1657257921795,MATH 18,B01,083748,Rideout; David Porter,4,0,37,33
1657257921795,MATH 18,B02,083749,Rideout; David Porter,4,0,36,32
1657257921795,MATH 18,B03,083750,Rideout; David Porter,2,0,37,35
1657257921795,MATH 18,B04,083751,Rideout; David Porter,6,0,36,30
1657257921795,MATH 18,B05,093473,Rideout; David Porter,5,0,36,31
1657257921795,MATH 18,B06,093474,Rideout; David Porter,5,0,36,31
1657257927820,MATH 20A,A01,083754,Zheng; Zequn,14,0,40,26
1657257933850,MATH 20B,A01,083756,Briones; Jor-el Thomas Caparas,3,0,36,33
1657257933850,MATH 20B,A02,083757,Briones; Jor-el Thomas Caparas,1,0,36,35
1657257933850,MATH 20B,A03,093475,Briones; Jor-el Thomas Caparas,2,0,36,34
1657257939879,MATH 20C,A01,083760,Briones; Jor-el Thomas Caparas,1,0,35,34
1657257939879,MATH 20C,A02,083761,Briones; Jor-el Thomas Caparas,8,0,35,27
1657257939879,MATH 20C,A03,093476,Briones; Jor-el Thomas Caparas,0,1,36,36
1657257939879,MATH 20C,B01,083762,Bach; Quang Tran,1,0,30,29
1657257945904,MATH 20D,A01,083765,Tran; Brian Kha,4,0,30,26
1657257945904,MATH 20D,A02,083766,Tran; Brian Kha,5,0,30,25
1657257945904,MATH 20D,A03,083767,Tran; Brian Kha,4,0,30,26
1657257951928,MATH 20E,A01,083771,Ganguly; Soumya,7,0,32,25
1657257951928,MATH 20E,A02,083772,Ganguly; Soumya,7,0,32,25
1657257951928,MATH 20E,B01,083773,Ciotti; Benjamin,19,0,35,16
1657257951928,MATH 20E,B02,083774,Ciotti; Benjamin,17,0,35,18
1657257957953,MATH 103A,A01,083777,Greenfeld; Be'Eri,3,0,36,33
1657257957953,MATH 103A,A02,083778,Greenfeld; Be'Eri,5,0,36,31
1657257957953,MATH 103A,A03,093561,Greenfeld; Be'Eri,4,0,36,32
1657257957953,MATH 103A,B01,083779,Greenfeld; Be'Eri,6,0,36,30
1657257957953,MATH 103A,B02,083780,Greenfeld; Be'Eri,3,0,36,33
1657257957953,MATH 103A,B03,093562,Greenfeld; Be'Eri,3,0,36,33
1657257963977,MATH 105,A01,085443,Carter; Anne Toulson,15,0,35,20
1657257963977,MATH 105,A02,093477,Carter; Anne Toulson,20,0,35,15
1657257970002,MATH 109,A01,083213,Ganzberger; Geoffrey Michael,2,0,34,32
1657257970002,MATH 109,A02,083214,Ganzberger; Geoffrey Michael,4,0,34,30
1657257970002,MATH 109,A03,093478,Ganzberger; Geoffrey Michael,2,0,34,32
1657257970002,MATH 109,B01,083215,Ganzberger; Geoffrey Michael,1,0,32,31
1657257970002,MATH 109,B02,083216,Ganzberger; Geoffrey Michael,1,0,32,31
1657257970002,MATH 109,B03,093479,Ganzberger; Geoffrey Michael,8,0,32,24
1657257976037,MATH 142A,A01,083219,Chow; Bennett,6,0,32,26
1657257976037,MATH 142A,A02,083220,Chow; Bennett,10,0,32,22
1657257976037,MATH 142A,A03,093480,Chow; Bennett,7,0,32,25
1657257976037,MATH 142A,B03,093481,Chow; Bennett,8,0,32,24
1657257976037,MATH 142A,B04,093558,Chow; Bennett,12,0,32,20
1657257976037,MATH 142A,B05,093559,Chow; Bennett,6,0,32,26
1657257982064,MATH 193A,A01,083224,Rotar; Vladimir,7,0,34,27
1657257982064,MATH 193A,A02,083225,Rotar; Vladimir,6,0,34,28
1657257982064,MATH 193A,A03,083781,Rotar; Vladimir,2,0,34,32
1657257982064,MATH 193A,A04,083782,Rotar; Vladimir,8,0,34,26
1657257982064,MATH 193A,A05,093482,Rotar; Vladimir,6,0,34,28
1657257988087,MATH 197,001,091859,McAuley; Julian John,9999,0,9999,0
1657257988087,MATH 197,002,095566,Kedlaya; Kiran S.,9997,0,9999,2
1657257988087,MATH 197,003,095567,Xiao; Ming,9999,0,9999,0
1657257988087,MATH 197,004,095571,Perols; Johan Lars,9998,0,9999,1
1657257995157,COGS 9,A01,083615,Shannon; Kyle Michael,8,0,75,67
1657258001185,COGS 11,A01,083617,Boyle; Mary E. T.,22,0,48,26
1657258007208,COGS 13,A01,083071,Bastos; Amalia Pinkusfeld,8,0,71,63
1657258013240,COGS 14A,A01,092681,Semenuks; Arturs,2,1,100,98
1657258019264,COGS 14B,A01,083073,Cheng; Tzu-Han,6,0,63,57
1657258025291,COGS 17,A01,092677,Semenuks; Arturs,5,0,81,76
1657258031315,COGS 100,A01,083619,Allen; Michael Gordon,16,0,70,54
1657258037342,COGS 101A,A01,083621,Davis; Joshua Daniel,9,0,68,59
1657258043366,COGS 101B,A01,091572,Allen; Michael Gordon,11,0,65,54
1657258049415,COGS 101C,A01,083625,Delgado; Tania,17,0,35,18
1657258055448,COGS 107A,A01,083627,Boyle; Mary E. T.,13,0,60,47
1657258061471,COGS 118A,A01,083075,Gupta; Anjum,18,0,76,58
1657258067496,CSE 3,A50,083646,Miranda; Gregory Joseph,24,0,50,26
1657258073520,CSE 8A,A50,083650,Miranda; Gregory Joseph,17,1,56,39
1657258079544,CSE 11,A01,083080,Cao; Yingjun,5,15,40,35
1657258085575,CSE 12,A01,083652,Krause-Levy; Sophia Louisa,26,1,120,94
1657258091598,CSE 15L,A01,083654,Morris; Justin Loren,9,0,50,41
1657258091598,CSE 15L,A02,083655,Morris; Justin Loren,9,0,50,41
1657258097619,CSE 20,A01,083657,Tran; Khoa Dang,38,0,80,42
1657258103651,CSE 21,A01,095574,Bach; Quang Tran,22,0,48,26
1657258109680,CSE 30,A01,083084,Eldon; John,4,0,80,76
1657258109680,CSE 30,B01,095061,Bhaskar; Nishant,8,0,50,42
1657258115703,CSE 100,A01,083659,Cao; Yingjun,4,4,70,66
1657258121724,CSE 134B,A01,083661,Powell; Thomas Allan,21,0,100,79
1657258127746,CSE 140,A01,083663,Gungor; Onat,13,0,85,72
1657258133768,CSE 140L,A01,083088,Eldon; John,19,0,100,81
1657258139793,CSE 175,A01,083665,Kumar; Rakesh,3,0,25,22
1657258145891,CSE 190,A00,092507,Dubnov; Shlomo,7,0,20,13
1657258151921,ECE 45,A01,083139,Congero; Spencer William,5,0,75,70
1657258157944,ECE 65,A50,083695,Saad; Andrew S,12,0,30,18
1657258157944,ECE 65,A51,095125,Saad; Andrew S,25,0,26,1
1657258163970,ECE 109,A01,091882,Touri; Behrouz,19,0,70,51
1657258169996,ECE 180,A00,083140,Abi Samra; Nicholas Camill,1,0,30,29
1657258169996,ECE 180,B00,083141,Abi Samra; Nicholas Camill,0,0,30,30
1657258176021,MATH 10A,A01,083735,Patchell; Gregory David,2,0,30,28
1657258176021,MATH 10A,A02,083736,Patchell; Gregory David,20,0,30,10
1657258176021,MATH 10A,A03,083737,Patchell; Gregory David,16,0,30,14
1657258182052,MATH 10B,A01,083207,Lim; Seonhee,7,0,34,27
1657258182052,MATH 10B,A02,083208,Lim; Seonhee,9,0,35,26
1657258182052,MATH 10B,A03,093472,Lim; Seonhee,5,0,34,29
1657258182052,MATH 10B,B01,083739,Sinha; Shubham,11,0,30,19
1657258188080,MATH 18,A01,083743,Cinel; Cameron Alexander,6,0,30,24
1657258188080,MATH 18,A02,083744,Cinel; Cameron Alexander,17,0,30,13
1657258188080,MATH 18,A03,083745,Cinel; Cameron Alexander,8,0,30,22
1657258188080,MATH 18,B01,083748,Rideout; David Porter,4,0,37,33
1657258188080,MATH 18,B02,083749,Rideout; David Porter,4,0,36,32
1657258188080,MATH 18,B03,083750,Rideout; David Porter,2,0,37,35
1657258188080,MATH 18,B04,083751,Rideout; David Porter,6,0,36,30
1657258188080,MATH 18,B05,093473,Rideout; David Porter,5,0,36,31
1657258188080,MATH 18,B06,093474,Rideout; David Porter,5,0,36,31
1657258194107,MATH 20A,A01,083754,Zheng; Zequn,14,0,40,26
1657258200135,MATH 20B,A01,083756,Briones; Jor-el Thomas Caparas,3,0,36,33
1657258200135,MATH 20B,A02,083757,Briones; Jor-el Thomas Caparas,1,0,36,35
1657258200135,MATH 20B,A03,093475,Briones; Jor-el Thomas Caparas,2,0,36,34
1657258206160,MATH 20C,A01,083760,Briones; Jor-el Thomas Caparas,1,0,35,34
1657258206160,MATH 20C,A02,083761,Briones; Jor-el Thomas Caparas,8,0,35,27
1657258206160,MATH 20C,A03,093476,Briones; Jor-el Thomas Caparas,0,1,36,36
1657258206160,MATH 20C,B01,083762,Bach; Quang Tran,1,0,30,29
1657258212183,MATH 20D,A01,083765,Tran; Brian Kha,4,0,30,26
1657258212183,MATH 20D,A02,083766,Tran; Brian Kha,5,0,30,25
1657258212183,MATH 20D,A03,083767,Tran; Brian Kha,4,0,30,26
1657258218206,MATH 20E,A01,083771,Ganguly; Soumya,7,0,32,25
1657258218206,MATH 20E,A02,083772,Ganguly; Soumya,7,0,32,25
1657258218206,MATH 20E,B01,083773,Ciotti; Benjamin,19,0,35,16
1657258218206,MATH 20E,B02,083774,Ciotti; Benjamin,17,0,35,18
1657258224235,MATH 103A,A01,083777,Greenfeld; Be'Eri,3,0,36,33
1657258224235,MATH 103A,A02,083778,Greenfeld; Be'Eri,5,0,36,31
1657258224235,MATH 103A,A03,093561,Greenfeld; Be'Eri,4,0,36,32
1657258224235,MATH 103A,B01,083779,Greenfeld; Be'Eri,6,0,36,30
1657258224235,MATH 103A,B02,083780,Greenfeld; Be'Eri,3,0,36,33
1657258224235,MATH 103A,B03,093562,Greenfeld; Be'Eri,3,0,36,33
1657258230264,MATH 105,A01,085443,Carter; Anne Toulson,15,0,35,20
1657258230264,MATH 105,A02,093477,Carter; Anne Toulson,20,0,35,15
1657258236300,MATH 109,A01,083213,Ganzberger; Geoffrey Michael,2,0,34,32
1657258236300,MATH 109,A02,083214,Ganzberger; Geoffrey Michael,4,0,34,30
1657258236300,MATH 109,A03,093478,Ganzberger; Geoffrey Michael,2,0,34,32
1657258236300,MATH 109,B01,083215,Ganzberger; Geoffrey Michael,1,0,32,31
1657258236300,MATH 109,B02,083216,Ganzberger; Geoffrey Michael,1,0,32,31
1657258236300,MATH 109,B03,093479,Ganzberger; Geoffrey Michael,8,0,32,24
1657258242328,MATH 142A,A01,083219,Chow; Bennett,6,0,32,26
1657258242328,MATH 142A,A02,083220,Chow; Bennett,10,0,32,22
1657258242328,MATH 142A,A03,093480,Chow; Bennett,7,0,32,25
1657258242328,MATH 142A,B03,093481,Chow; Bennett,8,0,32,24
1657258242328,MATH 142A,B04,093558,Chow; Bennett,12,0,32,20
1657258242328,MATH 142A,B05,093559,Chow; Bennett,6,0,32,26
1657258248357,MATH 193A,A01,083224,Rotar; Vladimir,7,0,34,27
1657258248357,MATH 193A,A02,083225,Rotar; Vladimir,6,0,34,28
1657258248357,MATH 193A,A03,083781,Rotar; Vladimir,2,0,34,32
1657258248357,MATH 193A,A04,083782,Rotar; Vladimir,8,0,34,26
1657258248357,MATH 193A,A05,093482,Rotar; Vladimir,6,0,34,28
1657258254379,MATH 197,001,091859,McAuley; Julian John,9999,0,9999,0
1657258254379,MATH 197,002,095566,Kedlaya; Kiran S.,9997,0,9999,2
1657258254379,MATH 197,003,095567,Xiao; Ming,9999,0,9999,0
1657258254379,MATH 197,004,095571,Perols; Johan Lars,9998,0,9999,1
1657258261443,COGS 9,A01,083615,Shannon; Kyle Michael,8,0,75,67
1657258267471,COGS 11,A01,083617,Boyle; Mary E. T.,22,0,48,26
1657258273494,COGS 13,A01,083071,Bastos; Amalia Pinkusfeld,8,0,71,63
1657258279520,COGS 14A,A01,092681,Semenuks; Arturs,2,1,100,98
1657258285570,COGS 14B,A01,083073,Cheng; Tzu-Han,6,0,63,57
1657258291596,COGS 17,A01,092677,Semenuks; Arturs,5,0,81,76
1657258297624,COGS 100,A01,083619,Allen; Michael Gordon,16,0,70,54
1657258303647,COGS 101A,A01,083621,Davis; Joshua Daniel,9,0,68,59
1657258309673,COGS 101B,A01,091572,Allen; Michael Gordon,11,0,65,54
1657258315695,COGS 101C,A01,083625,Delgado; Tania,17,0,35,18
1657258321722,COGS 107A,A01,083627,Boyle; Mary E. T.,13,0,60,47
1657258327760,COGS 118A,A01,083075,Gupta; Anjum,18,0,76,58
1657258333783,CSE 3,A50,083646,Miranda; Gregory Joseph,24,0,50,26
1657258339813,CSE 8A,A50,083650,Miranda; Gregory Joseph,17,1,56,39
1657258345841,CSE 11,A01,083080,Cao; Yingjun,5,15,40,35
1657258351864,CSE 12,A01,083652,Krause-Levy; Sophia Louisa,26,1,120,94
1657258357891,CSE 15L,A01,083654,Morris; Justin Loren,9,0,50,41
1657258357891,CSE 15L,A02,083655,Morris; Justin Loren,9,0,50,41
1657258363919,CSE 20,A01,083657,Tran; Khoa Dang,38,0,80,42
1657258369945,CSE 21,A01,095574,Bach; Quang Tran,22,0,48,26
1657258375974,CSE 30,A01,083084,Eldon; John,4,0,80,76
1657258375974,CSE 30,B01,095061,Bhaskar; Nishant,8,0,50,42
1657258381998,CSE 100,A01,083659,Cao; Yingjun,4,4,70,66
1657258388021,CSE 134B,A01,083661,Powell; Thomas Allan,21,0,100,79
1657258394047,CSE 140,A01,083663,Gungor; Onat,13,0,85,72
1657258400071,CSE 140L,A01,083088,Eldon; John,19,0,100,81
1657258406094,CSE 175,A01,083665,Kumar; Rakesh,3,0,25,22
1657258412115,CSE 190,A00,092507,Dubnov; Shlomo,7,0,20,13
1657258418139,ECE 45,A01,083139,Congero; Spencer William,5,0,75,70
1657258424164,ECE 65,A50,083695,Saad; Andrew S,12,0,30,18
1657258424164,ECE 65,A51,095125,Saad; Andrew S,25,0,26,1
1657258430188,ECE 109,A01,091882,Touri; Behrouz,19,0,70,51
1657258436209,ECE 180,A00,083140,Abi Samra; Nicholas Camill,1,0,30,29
1657258436209,ECE 180,B00,083141,Abi Samra; Nicholas Camill,0,0,30,30
1657258442237,MATH 10A,A01,083735,Patchell; Gregory David,2,0,30,28
1657258442237,MATH 10A,A02,083736,Patchell; Gregory David,20,0,30,10
1657258442237,MATH 10A,A03,083737,Patchell; Gregory David,16,0,30,14
1657258448262,MATH 10B,A01,083207,Lim; Seonhee,7,0,34,27
1657258448262,MATH 10B,A02,083208,Lim; Seonhee,9,0,35,26
1657258448262,MATH 10B,A03,093472,Lim; Seonhee,5,0,34,29
1657258448262,MATH 10B,B01,083739,Sinha; Shubham,11,0,30,19
1657258454294,MATH 18,A01,083743,Cinel; Cameron Alexander,6,0,30,24
1657258454294,MATH 18,A02,083744,Cinel; Cameron Alexander,17,0,30,13
1657258454294,MATH 18,A03,083745,Cinel; Cameron Alexander,8,0,30,22
1657258454294,MATH 18,B01,083748,Rideout; David Porter,4,0,37,33
1657258454294,MATH 18,B02,083749,Rideout; David Porter,4,0,36,32
1657258454294,MATH 18,B03,083750,Rideout; David Porter,2,0,37,35
1657258454294,MATH 18,B04,083751,Rideout; David Porter,6,0,36,30
1657258454294,MATH 18,B05,093473,Rideout; David Porter,5,0,36,31
1657258454294,MATH 18,B06,093474,Rideout; David Porter,5,0,36,31
1657258460334,MATH 20A,A01,083754,Zheng; Zequn,14,0,40,26
1657258466362,MATH 20B,A01,083756,Briones; Jor-el Thomas Caparas,3,0,36,33
1657258466362,MATH 20B,A02,083757,Briones; Jor-el Thomas Caparas,1,0,36,35
1657258466362,MATH 20B,A03,093475,Briones; Jor-el Thomas Caparas,2,0,36,34
1657258472391,MATH 20C,A01,083760,Briones; Jor-el Thomas Caparas,1,0,35,34
1657258472391,MATH 20C,A02,083761,Briones; Jor-el Thomas Caparas,8,0,35,27
1657258472391,MATH 20C,A03,093476,Briones; Jor-el Thomas Caparas,0,1,36,36
1657258472391,MATH 20C,B01,083762,Bach; Quang Tran,1,0,30,29
1657258478424,MATH 20D,A01,083765,Tran; Brian Kha,4,0,30,26
1657258478424,MATH 20D,A02,083766,Tran; Brian Kha,5,0,30,25
1657258478424,MATH 20D,A03,083767,Tran; Brian Kha,4,0,30,26
1657258484453,MATH 20E,A01,083771,Ganguly; Soumya,7,0,32,25
1657258484453,MATH 20E,A02,083772,Ganguly; Soumya,7,0,32,25
1657258484453,MATH 20E,B01,083773,Ciotti; Benjamin,19,0,35,16
1657258484453,MATH 20E,B02,083774,Ciotti; Benjamin,17,0,35,18
1657258490476,MATH 103A,A01,083777,Greenfeld; Be'Eri,3,0,36,33
1657258490476,MATH 103A,A02,083778,Greenfeld; Be'Eri,5,0,36,31
1657258490476,MATH 103A,A03,093561,Greenfeld; Be'Eri,4,0,36,32
1657258490476,MATH 103A,B01,083779,Greenfeld; Be'Eri,6,0,36,30
1657258490476,MATH 103A,B02,083780,Greenfeld; Be'Eri,3,0,36,33
1657258490476,MATH 103A,B03,093562,Greenfeld; Be'Eri,3,0,36,33
1657258496502,MATH 105,A01,085443,Carter; Anne Toulson,15,0,35,20
1657258496502,MATH 105,A02,093477,Carter; Anne Toulson,20,0,35,15
1657258502530,MATH 109,A01,083213,Ganzberger; Geoffrey Michael,2,0,34,32
1657258502530,MATH 109,A02,083214,Ganzberger; Geoffrey Michael,4,0,34,30
1657258502530,MATH 109,A03,093478,Ganzberger; Geoffrey Michael,2,0,34,32
1657258502530,MATH 109,B01,083215,Ganzberger; Geoffrey Michael,1,0,32,31
1657258502530,MATH 109,B02,083216,Ganzberger; Geoffrey Michael,1,0,32,31
1657258502530,MATH 109,B03,093479,Ganzberger; Geoffrey Michael,8,0,32,24
1657258508554,MATH 142A,A01,083219,Chow; Bennett,7,0,32,25
1657258508554,MATH 142A,A02,083220,Chow; Bennett,10,0,32,22
1657258508554,MATH 142A,A03,093480,Chow; Bennett,7,0,32,25
1657258508554,MATH 142A,B03,093481,Chow; Bennett,8,0,32,24
1657258508554,MATH 142A,B04,093558,Chow; Bennett,12,0,32,20
1657258508554,MATH 142A,B05,093559,Chow; Bennett,6,0,32,26
1657258514578,MATH 193A,A01,083224,Rotar; Vladimir,7,0,34,27
1657258514578,MATH 193A,A02,083225,Rotar; Vladimir,6,0,34,28
1657258514578,MATH 193A,A03,083781,Rotar; Vladimir,2,0,34,32
1657258514578,MATH 193A,A04,083782,Rotar; Vladimir,8,0,34,26
1657258514578,MATH 193A,A05,093482,Rotar; Vladimir,6,0,34,28
1657258520602,MATH 197,001,091859,McAuley; Julian John,9999,0,9999,0
1657258520602,MATH 197,002,095566,Kedlaya; Kiran S.,9997,0,9999,2
1657258520602,MATH 197,003,095567,Xiao; Ming,9999,0,9999,0
1657258520602,MATH 197,004,095571,Perols; Johan Lars,9998,0,9999,1
1657258527656,COGS 9,A01,083615,Shannon; Kyle Michael,8,0,75,67
1657258533681,COGS 11,A01,083617,Boyle; Mary E. T.,22,0,48,26
1657258539702,COGS 13,A01,083071,Bastos; Amalia Pinkusfeld,8,0,71,63
1657258545729,COGS 14A,A01,092681,Semenuks; Arturs,2,1,100,98
1657258551750,COGS 14B,A01,083073,Cheng; Tzu-Han,6,0,63,57
1657258557772,COGS 17,A01,092677,Semenuks; Arturs,5,0,81,76
1657258563798,COGS 100,A01,083619,Allen; Michael Gordon,16,0,70,54
1657258569825,COGS 101A,A01,083621,Davis; Joshua Daniel,9,0,68,59
1657258575849,COGS 101B,A01,091572,Allen; Michael Gordon,11,0,65,54
1657258581872,COGS 101C,A01,083625,Delgado; Tania,17,0,35,18
1657258587904,COGS 107A,A01,083627,Boyle; Mary E. T.,13,0,60,47
1657258593929,COGS 118A,A01,083075,Gupta; Anjum,18,0,76,58
1657258599956,CSE 3,A50,083646,Miranda; Gregory Joseph,24,0,50,26
1657258605983,CSE 8A,A50,083650,Miranda; Gregory Joseph,17,1,56,39
1657258612009,CSE 11,A01,083080,Cao; Yingjun,5,15,40,35
1657258618036,CSE 12,A01,083652,Krause-Levy; Sophia Louisa,26,1,120,94
1657258624059,CSE 15L,A01,083654,Morris; Justin Loren,9,0,50,41
1657258624059,CSE 15L,A02,083655,Morris; Justin Loren,9,0,50,41
1657258630084,CSE 20,A01,083657,Tran; Khoa Dang,38,0,80,42
1657258636115,CSE 21,A01,095574,Bach; Quang Tran,22,0,48,26
1657258642139,CSE 30,A01,083084,Eldon; John,4,0,80,76
1657258642139,CSE 30,B01,095061,Bhaskar; Nishant,8,0,50,42
1657258648169,CSE 100,A01,083659,Cao; Yingjun,4,4,70,66
1657258654195,CSE 134B,A01,083661,Powell; Thomas Allan,21,0,100,79
1657258660220,CSE 140,A01,083663,Gungor; Onat,13,0,85,72
1657258666244,CSE 140L,A01,083088,Eldon; John,19,0,100,81
1657258672267,CSE 175,A01,083665,Kumar; Rakesh,3,0,25,22
1657258678292,CSE 190,A00,092507,Dubnov; Shlomo,7,0,20,13
1657258684315,ECE 45,A01,083139,Congero; Spencer William,5,0,75,70
1657258690337,ECE 65,A50,083695,Saad; Andrew S,12,0,30,18
1657258690337,ECE 65,A51,095125,Saad; Andrew S,25,0,26,1
1657258696358,ECE 109,A01,091882,Touri; Behrouz,19,0,70,51
1657258702382,ECE 180,A00,083140,Abi Samra; Nicholas Camill,1,0,30,29
1657258702382,ECE 180,B00,083141,Abi Samra; Nicholas Camill,0,0,30,30
1657258708410,MATH 10A,A01,083735,Patchell; Gregory David,2,0,30,28
1657258708410,MATH 10A,A02,083736,Patchell; Gregory David,20,0,30,10
1657258708410,MATH 10A,A03,083737,Patchell; Gregory David,16,0,30,14
1657258714437,MATH 10B,A01,083207,Lim; Seonhee,7,0,34,27
1657258714437,MATH 10B,A02,083208,Lim; Seonhee,9,0,35,26
1657258714437,MATH 10B,A03,093472,Lim; Seonhee,5,0,34,29
1657258714437,MATH 10B,B01,083739,Sinha; Shubham,11,0,30,19
1657258720460,MATH 18,A01,083743,Cinel; Cameron Alexander,6,0,30,24
1657258720460,MATH 18,A02,083744,Cinel; Cameron Alexander,17,0,30,13
1657258720460,MATH 18,A03,083745,Cinel; Cameron Alexander,8,0,30,22
1657258720460,MATH 18,B01,083748,Rideout; David Porter,4,0,37,33
1657258720460,MATH 18,B02,083749,Rideout; David Porter,4,0,36,32
1657258720460,MATH 18,B03,083750,Rideout; David Porter,2,0,37,35
1657258720460,MATH 18,B04,083751,Rideout; David Porter,6,0,36,30
1657258720460,MATH 18,B05,093473,Rideout; David Porter,5,0,36,31
1657258720460,MATH 18,B06,093474,Rideout; David Porter,5,0,36,31
1657258726483,MATH 20A,A01,083754,Zheng; Zequn,14,0,40,26
1657258732509,MATH 20B,A01,083756,Briones; Jor-el Thomas Caparas,3,0,36,33
1657258732509,MATH 20B,A02,083757,Briones; Jor-el Thomas Caparas,1,0,36,35
1657258732509,MATH 20B,A03,093475,Briones; Jor-el Thomas Caparas,2,0,36,34
1657258738535,MATH 20C,A01,083760,Briones; Jor-el Thomas Caparas,1,0,35,34
1657258738535,MATH 20C,A02,083761,Briones; Jor-el Thomas Caparas,8,0,35,27
1657258738535,MATH 20C,A03,093476,Briones; Jor-el Thomas Caparas,0,1,36,36
1657258738535,MATH 20C,B01,083762,Bach; Quang Tran,1,0,30,29
1657258744652,MATH 20D,A01,083765,Tran; Brian Kha,4,0,30,26
1657258744652,MATH 20D,A02,083766,Tran; Brian Kha,5,0,30,25
1657258744652,MATH 20D,A03,083767,Tran; Brian Kha,4,0,30,26
1657258750683,MATH 20E,A01,083771,Ganguly; Soumya,7,0,32,25
1657258750683,MATH 20E,A02,083772,Ganguly; Soumya,7,0,32,25
1657258750683,MATH 20E,B01,083773,Ciotti; Benjamin,19,0,35,16
1657258750683,MATH 20E,B02,083774,Ciotti; Benjamin,17,0,35,18
1657258756714,MATH 103A,A01,083777,Greenfeld; Be'Eri,3,0,36,33
1657258756714,MATH 103A,A02,083778,Greenfeld; Be'Eri,5,0,36,31
1657258756714,MATH 103A,A03,093561,Greenfeld; Be'Eri,4,0,36,32
1657258756714,MATH 103A,B01,083779,Greenfeld; Be'Eri,6,0,36,30
1657258756714,MATH 103A,B02,083780,Greenfeld; Be'Eri,3,0,36,33
1657258756714,MATH 103A,B03,093562,Greenfeld; Be'Eri,3,0,36,33
1657258762735,MATH 105,A01,085443,Carter; Anne Toulson,15,0,35,20
1657258762735,MATH 105,A02,093477,Carter; Anne Toulson,20,0,35,15
1657258768758,MATH 109,A01,083213,Ganzberger; Geoffrey Michael,2,0,34,32
1657258768758,MATH 109,A02,083214,Ganzberger; Geoffrey Michael,4,0,34,30
1657258768758,MATH 109,A03,093478,Ganzberger; Geoffrey Michael,2,0,34,32
1657258768758,MATH 109,B01,083215,Ganzberger; Geoffrey Michael,1,0,32,31
1657258768758,MATH 109,B02,083216,Ganzberger; Geoffrey Michael,1,0,32,31
1657258768758,MATH 109,B03,093479,Ganzberger; Geoffrey Michael,8,0,32,24
1657258774789,MATH 142A,A01,083219,Chow; Bennett,7,0,32,25
1657258774789,MATH 142A,A02,083220,Chow; Bennett,10,0,32,22
1657258774789,MATH 142A,A03,093480,Chow; Bennett,7,0,32,25
1657258774789,MATH 142A,B03,093481,Chow; Bennett,8,0,32,24
1657258774789,MATH 142A,B04,093558,Chow; Bennett,12,0,32,20
1657258774789,MATH 142A,B05,093559,Chow; Bennett,6,0,32,26
1657258780811,MATH 193A,A01,083224,Rotar; Vladimir,7,0,34,27
1657258780811,MATH 193A,A02,083225,Rotar; Vladimir,6,0,34,28
1657258780811,MATH 193A,A03,083781,Rotar; Vladimir,2,0,34,32
1657258780811,MATH 193A,A04,083782,Rotar; Vladimir,8,0,34,26
1657258780811,MATH 193A,A05,093482,Rotar; Vladimir,6,0,34,28
1657258786833,MATH 197,001,091859,McAuley; Julian John,9999,0,9999,0
1657258786833,MATH 197,002,095566,Kedlaya; Kiran S.,9997,0,9999,2
1657258786833,MATH 197,003,095567,Xiao; Ming,9999,0,9999,0
1657258786833,MATH 197,004,095571,Perols; Johan Lars,9998,0,9999,1
1657258793883,COGS 9,A01,083615,Shannon; Kyle Michael,8,0,75,67
1657258799906,COGS 11,A01,083617,Boyle; Mary E. T.,22,0,48,26
1657258805928,COGS 13,A01,083071,Bastos; Amalia Pinkusfeld,8,0,71,63
1657258811954,COGS 14A,A01,092681,Semenuks; Arturs,2,1,100,98
1657258817979,COGS 14B,A01,083073,Cheng; Tzu-Han,6,0,63,57
1657258824004,COGS 17,A01,092677,Semenuks; Arturs,5,0,81,76
1657258830027,COGS 100,A01,083619,Allen; Michael Gordon,16,0,70,54
1657258836050,COGS 101A,A01,083621,Davis; Joshua Daniel,9,0,68,59
1657258842076,COGS 101B,A01,091572,Allen; Michael Gordon,11,0,65,54
1657258848097,COGS 101C,A01,083625,Delgado; Tania,17,0,35,18
1657258854119,COGS 107A,A01,083627,Boyle; Mary E. T.,13,0,60,47
1657258860144,COGS 118A,A01,083075,Gupta; Anjum,18,0,76,58
1657258866173,CSE 3,A50,083646,Miranda; Gregory Joseph,24,0,50,26
1657258872200,CSE 8A,A50,083650,Miranda; Gregory Joseph,17,1,56,39
1657258878223,CSE 11,A01,083080,Cao; Yingjun,5,15,40,35
1657258884249,CSE 12,A01,083652,Krause-Levy; Sophia Louisa,26,1,120,94
1657258890270,CSE 15L,A01,083654,Morris; Justin Loren,9,0,50,41
1657258890270,CSE 15L,A02,083655,Morris; Justin Loren,9,0,50,41
1657258896292,CSE 20,A01,083657,Tran; Khoa Dang,38,0,80,42
1657258902314,CSE 21,A01,095574,Bach; Quang Tran,22,0,48,26
1657258908376,CSE 30,A01,083084,Eldon; John,4,0,80,76
1657258908376,CSE 30,B01,095061,Bhaskar; Nishant,8,0,50,42
1657258914399,CSE 100,A01,083659,Cao; Yingjun,4,4,70,66
1657258920421,CSE 134B,A01,083661,Powell; Thomas Allan,21,0,100,79
1657258926447,CSE 140,A01,083663,Gungor; Onat,13,0,85,72
1657258932470,CSE 140L,A01,083088,Eldon; John,19,0,100,81
1657258938493,CSE 175,A01,083665,Kumar; Rakesh,3,0,25,22
1657258944515,CSE 190,A00,092507,Dubnov; Shlomo,7,0,20,13
1657258950540,ECE 45,A01,083139,Congero; Spencer William,5,0,75,70
1657258956564,ECE 65,A50,083695,Saad; Andrew S,12,0,30,18
1657258956564,ECE 65,A51,095125,Saad; Andrew S,25,0,26,1
1657258962593,ECE 109,A01,091882,Touri; Behrouz,19,0,70,51
1657258968617,ECE 180,A00,083140,Abi Samra; Nicholas Camill,1,0,30,29
1657258968617,ECE 180,B00,083141,Abi Samra; Nicholas Camill,0,0,30,30
1657258974643,MATH 10A,A01,083735,Patchell; Gregory David,2,0,30,28
1657258974643,MATH 10A,A02,083736,Patchell; Gregory David,20,0,30,10
1657258974643,MATH 10A,A03,083737,Patchell; Gregory David,16,0,30,14
1657258980667,MATH 10B,A01,083207,Lim; Seonhee,7,0,34,27
1657258980667,MATH 10B,A02,083208,Lim; Seonhee,9,0,35,26
1657258980667,MATH 10B,A03,093472,Lim; Seonhee,5,0,34,29
1657258980667,MATH 10B,B01,083739,Sinha; Shubham,11,0,30,19
1657258986697,MATH 18,A01,083743,Cinel; Cameron Alexander,6,0,30,24
1657258986697,MATH 18,A02,083744,Cinel; Cameron Alexander,17,0,30,13
1657258986697,MATH 18,A03,083745,Cinel; Cameron Alexander,8,0,30,22
1657258986697,MATH 18,B01,083748,Rideout; David Porter,4,0,37,33
1657258986697,MATH 18,B02,083749,Rideout; David Porter,4,0,36,32
1657258986697,MATH 18,B03,083750,Rideout; David Porter,2,0,37,35
1657258986697,MATH 18,B04,083751,Rideout; David Porter,6,0,36,30
1657258986697,MATH 18,B05,093473,Rideout; David Porter,5,0,36,31
1657258986697,MATH 18,B06,093474,Rideout; David Porter,5,0,36,31
1657258992720,MATH 20A,A01,083754,Zheng; Zequn,14,0,40,26
1657258998749,MATH 20B,A01,083756,Briones; Jor-el Thomas Caparas,3,0,36,33
1657258998749,MATH 20B,A02,083757,Briones; Jor-el Thomas Caparas,1,0,36,35
1657258998749,MATH 20B,A03,093475,Briones; Jor-el Thomas Caparas,2,0,36,34
1657259004770,MATH 20C,A01,083760,Briones; Jor-el Thomas Caparas,1,0,35,34
1657259004770,MATH 20C,A02,083761,Briones; Jor-el Thomas Caparas,8,0,35,27
1657259004770,MATH 20C,A03,093476,Briones; Jor-el Thomas Caparas,0,1,36,36
1657259004770,MATH 20C,B01,083762,Bach; Quang Tran,1,0,30,29
1657259010798,MATH 20D,A01,083765,Tran; Brian Kha,4,0,30,26
1657259010798,MATH 20D,A02,083766,Tran; Brian Kha,5,0,30,25
1657259010798,MATH 20D,A03,083767,Tran; Brian Kha,4,0,30,26
1657259016824,MATH 20E,A01,083771,Ganguly; Soumya,7,0,32,25
1657259016824,MATH 20E,A02,083772,Ganguly; Soumya,7,0,32,25
1657259016824,MATH 20E,B01,083773,Ciotti; Benjamin,19,0,35,16
1657259016824,MATH 20E,B02,083774,Ciotti; Benjamin,17,0,35,18
1657259022848,MATH 103A,A01,083777,Greenfeld; Be'Eri,3,0,36,33
1657259022848,MATH 103A,A02,083778,Greenfeld; Be'Eri,5,0,36,31
1657259022848,MATH 103A,A03,093561,Greenfeld; Be'Eri,4,0,36,32
1657259022848,MATH 103A,B01,083779,Greenfeld; Be'Eri,6,0,36,30
1657259022848,MATH 103A,B02,083780,Greenfeld; Be'Eri,3,0,36,33
1657259022848,MATH 103A,B03,093562,Greenfeld; Be'Eri,3,0,36,33
1657259028871,MATH 105,A01,085443,Carter; Anne Toulson,15,0,35,20
1657259028871,MATH 105,A02,093477,Carter; Anne Toulson,20,0,35,15
1657259034898,MATH 109,A01,083213,Ganzberger; Geoffrey Michael,2,0,34,32
1657259034898,MATH 109,A02,083214,Ganzberger; Geoffrey Michael,4,0,34,30
1657259034898,MATH 109,A03,093478,Ganzberger; Geoffrey Michael,2,0,34,32
1657259034898,MATH 109,B01,083215,Ganzberger; Geoffrey Michael,1,0,32,31
1657259034898,MATH 109,B02,083216,Ganzberger; Geoffrey Michael,1,0,32,31
1657259034898,MATH 109,B03,093479,Ganzberger; Geoffrey Michael,8,0,32,24
1657259040927,MATH 142A,A01,083219,Chow; Bennett,7,0,32,25
1657259040927,MATH 142A,A02,083220,Chow; Bennett,10,0,32,22
1657259040927,MATH 142A,A03,093480,Chow; Bennett,7,0,32,25
1657259040927,MATH 142A,B03,093481,Chow; Bennett,8,0,32,24
1657259040927,MATH 142A,B04,093558,Chow; Bennett,12,0,32,20
1657259040927,MATH 142A,B05,093559,Chow; Bennett,6,0,32,26
1657259046955,MATH 193A,A01,083224,Rotar; Vladimir,7,0,34,27
1657259046955,MATH 193A,A02,083225,Rotar; Vladimir,6,0,34,28
1657259046955,MATH 193A,A03,083781,Rotar; Vladimir,2,0,34,32
1657259046955,MATH 193A,A04,083782,Rotar; Vladimir,8,0,34,26
1657259046955,MATH 193A,A05,093482,Rotar; Vladimir,6,0,34,28
1657259052980,MATH 197,001,091859,McAuley; Julian John,9999,0,9999,0
1657259052980,MATH 197,002,095566,Kedlaya; Kiran S.,9997,0,9999,2
1657259052980,MATH 197,003,095567,Xiao; Ming,9999,0,9999,0
1657259052980,MATH 197,004,095571,Perols; Johan Lars,9998,0,9999,1
1657259060030,COGS 9,A01,083615,Shannon; Kyle Michael,8,0,75,67
1657259066069,COGS 11,A01,083617,Boyle; Mary E. T.,22,0,48,26
1657259072096,COGS 13,A01,083071,Bastos; Amalia Pinkusfeld,8,0,71,63
1657259078124,COGS 14A,A01,092681,Semenuks; Arturs,2,1,100,98
1657259084148,COGS 14B,A01,083073,Cheng; Tzu-Han,6,0,63,57
1657259090175,COGS 17,A01,092677,Semenuks; Arturs,5,0,81,76
1657259096213,COGS 100,A01,083619,Allen; Michael Gordon,16,0,70,54
1657259102242,COGS 101A,A01,083621,Davis; Joshua Daniel,9,0,68,59
1657259108276,COGS 101B,A01,091572,Allen; Michael Gordon,11,0,65,54
1657259114301,COGS 101C,A01,083625,Delgado; Tania,17,0,35,18
1657259120324,COGS 107A,A01,083627,Boyle; Mary E. T.,13,0,60,47
1657259126347,COGS 118A,A01,083075,Gupta; Anjum,18,0,76,58
1657259132369,CSE 3,A50,083646,Miranda; Gregory Joseph,24,0,50,26
1657259138397,CSE 8A,A50,083650,Miranda; Gregory Joseph,17,1,56,39
1657259144418,CSE 11,A01,083080,Cao; Yingjun,5,15,40,35
1657259150444,CSE 12,A01,083652,Krause-Levy; Sophia Louisa,26,1,120,94
1657259156467,CSE 15L,A01,083654,Morris; Justin Loren,9,0,50,41
1657259156467,CSE 15L,A02,083655,Morris; Justin Loren,9,0,50,41
1657259162492,CSE 20,A01,083657,Tran; Khoa Dang,38,0,80,42
1657259168517,CSE 21,A01,095574,Bach; Quang Tran,22,0,48,26
1657259174539,CSE 30,A01,083084,Eldon; John,4,0,80,76
1657259174539,CSE 30,B01,095061,Bhaskar; Nishant,8,0,50,42
1657259180566,CSE 100,A01,083659,Cao; Yingjun,4,4,70,66
1657259186593,CSE 134B,A01,083661,Powell; Thomas Allan,21,0,100,79
1657259192620,CSE 140,A01,083663,Gungor; Onat,13,0,85,72
1657259198643,CSE 140L,A01,083088,Eldon; John,19,0,100,81
1657259204670,CSE 175,A01,083665,Kumar; Rakesh,3,0,25,22
1657259210694,CSE 190,A00,092507,Dubnov; Shlomo,7,0,20,13
1657259216722,ECE 45,A01,083139,Congero; Spencer William,5,0,75,70
1657259222747,ECE 65,A50,083695,Saad; Andrew S,12,0,30,18
1657259222747,ECE 65,A51,095125,Saad; Andrew S,25,0,26,1
1657259228774,ECE 109,A01,091882,Touri; Behrouz,19,0,70,51
1657259234819,ECE 180,A00,083140,Abi Samra; Nicholas Camill,1,0,30,29
1657259234819,ECE 180,B00,083141,Abi Samra; Nicholas Camill,0,0,30,30
1657259240843,MATH 10A,A01,083735,Patchell; Gregory David,2,0,30,28
1657259240843,MATH 10A,A02,083736,Patchell; Gregory David,20,0,30,10
1657259240843,MATH 10A,A03,083737,Patchell; Gregory David,16,0,30,14
1657259246868,MATH 10B,A01,083207,Lim; Seonhee,7,0,34,27
1657259246868,MATH 10B,A02,083208,Lim; Seonhee,9,0,35,26
1657259246868,MATH 10B,A03,093472,Lim; Seonhee,5,0,34,29
1657259246868,MATH 10B,B01,083739,Sinha; Shubham,11,0,30,19
1657259252910,MATH 18,A01,083743,Cinel; Cameron Alexander,6,0,30,24
1657259252910,MATH 18,A02,083744,Cinel; Cameron Alexander,17,0,30,13
1657259252910,MATH 18,A03,083745,Cinel; Cameron Alexander,8,0,30,22
1657259252910,MATH 18,B01,083748,Rideout; David Porter,4,0,37,33
1657259252910,MATH 18,B02,083749,Rideout; David Porter,4,0,36,32
1657259252910,MATH 18,B03,083750,Rideout; David Porter,2,0,37,35
1657259252910,MATH 18,B04,083751,Rideout; David Porter,6,0,36,30
1657259252910,MATH 18,B05,093473,Rideout; David Porter,5,0,36,31
1657259252910,MATH 18,B06,093474,Rideout; David Porter,5,0,36,31
1657259258939,MATH 20A,A01,083754,Zheng; Zequn,14,0,40,26
1657259264964,MATH 20B,A01,083756,Briones; Jor-el Thomas Caparas,3,0,36,33
1657259264964,MATH 20B,A02,083757,Briones; Jor-el Thomas Caparas,1,0,36,35
1657259264964,MATH 20B,A03,093475,Briones; Jor-el Thomas Caparas,2,0,36,34
1657259270994,MATH 20C,A01,083760,Briones; Jor-el Thomas Caparas,1,0,35,34
1657259270994,MATH 20C,A02,083761,Briones; Jor-el Thomas Caparas,8,0,35,27
1657259270994,MATH 20C,A03,093476,Briones; Jor-el Thomas Caparas,0,1,36,36
1657259270994,MATH 20C,B01,083762,Bach; Quang Tran,1,0,30,29
1657259277024,MATH 20D,A01,083765,Tran; Brian Kha,4,0,30,26
1657259277024,MATH 20D,A02,083766,Tran; Brian Kha,5,0,30,25
1657259277024,MATH 20D,A03,083767,Tran; Brian Kha,4,0,30,26
1657259283052,MATH 20E,A01,083771,Ganguly; Soumya,7,0,32,25
1657259283052,MATH 20E,A02,083772,Ganguly; Soumya,7,0,32,25
1657259283052,MATH 20E,B01,083773,Ciotti; Benjamin,19,0,35,16
1657259283052,MATH 20E,B02,083774,Ciotti; Benjamin,17,0,35,18
1657259289082,MATH 103A,A01,083777,Greenfeld; Be'Eri,3,0,36,33
1657259289082,MATH 103A,A02,083778,Greenfeld; Be'Eri,5,0,36,31
1657259289082,MATH 103A,A03,093561,Greenfeld; Be'Eri,4,0,36,32
1657259289082,MATH 103A,B01,083779,Greenfeld; Be'Eri,6,0,36,30
1657259289082,MATH 103A,B02,083780,Greenfeld; Be'Eri,3,0,36,33
1657259289082,MATH 103A,B03,093562,Greenfeld; Be'Eri,3,0,36,33
1657259295106,MATH 105,A01,085443,Carter; Anne Toulson,15,0,35,20
1657259295106,MATH 105,A02,093477,Carter; Anne Toulson,20,0,35,15
1657259301131,MATH 109,A01,083213,Ganzberger; Geoffrey Michael,2,0,34,32
1657259301131,MATH 109,A02,083214,Ganzberger; Geoffrey Michael,4,0,34,30
1657259301131,MATH 109,A03,093478,Ganzberger; Geoffrey Michael,2,0,34,32
1657259301131,MATH 109,B01,083215,Ganzberger; Geoffrey Michael,1,0,32,31
1657259301131,MATH 109,B02,083216,Ganzberger; Geoffrey Michael,1,0,32,31
1657259301131,MATH 109,B03,093479,Ganzberger; Geoffrey Michael,8,0,32,24
1657259307162,MATH 142A,A01,083219,Chow; Bennett,7,0,32,25
1657259307162,MATH 142A,A02,083220,Chow; Bennett,10,0,32,22
1657259307162,MATH 142A,A03,093480,Chow; Bennett,7,0,32,25
1657259307162,MATH 142A,B03,093481,Chow; Bennett,8,0,32,24
1657259307162,MATH 142A,B04,093558,Chow; Bennett,12,0,32,20
1657259307162,MATH 142A,B05,093559,Chow; Bennett,6,0,32,26
1657259313187,MATH 193A,A01,083224,Rotar; Vladimir,7,0,34,27
1657259313187,MATH 193A,A02,083225,Rotar; Vladimir,6,0,34,28
1657259313187,MATH 193A,A03,083781,Rotar; Vladimir,2,0,34,32
1657259313187,MATH 193A,A04,083782,Rotar; Vladimir,8,0,34,26
1657259313187,MATH 193A,A05,093482,Rotar; Vladimir,6,0,34,28
1657259319214,MATH 197,001,091859,McAuley; Julian John,9999,0,9999,0
1657259319214,MATH 197,002,095566,Kedlaya; Kiran S.,9997,0,9999,2
1657259319214,MATH 197,003,095567,Xiao; Ming,9999,0,9999,0
1657259319214,MATH 197,004,095571,Perols; Johan Lars,9998,0,9999,1
1657259326269,COGS 9,A01,083615,Shannon; Kyle Michael,8,0,75,67
1657259332309,COGS 11,A01,083617,Boyle; Mary E. T.,22,0,48,26
1657259338404,COGS 13,A01,083071,Bastos; Amalia Pinkusfeld,8,0,71,63
1657259344439,COGS 14A,A01,092681,Semenuks; Arturs,2,1,100,98
1657259350467,COGS 14B,A01,083073,Cheng; Tzu-Han,6,0,63,57
1657259356495,COGS 17,A01,092677,Semenuks; Arturs,5,0,81,76
1657259362522,COGS 100,A01,083619,Allen; Michael Gordon,16,0,70,54
1657259368546,COGS 101A,A01,083621,Davis; Joshua Daniel,9,0,68,59
1657259374574,COGS 101B,A01,091572,Allen; Michael Gordon,11,0,65,54
1657259380598,COGS 101C,A01,083625,Delgado; Tania,17,0,35,18
1657259386631,COGS 107A,A01,083627,Boyle; Mary E. T.,13,0,60,47
1657259392673,COGS 118A,A01,083075,Gupta; Anjum,18,0,76,58
1657259398697,CSE 3,A50,083646,Miranda; Gregory Joseph,24,0,50,26
1657259404724,CSE 8A,A50,083650,Miranda; Gregory Joseph,17,1,56,39
1657259410755,CSE 11,A01,083080,Cao; Yingjun,5,15,40,35
1657259416776,CSE 12,A01,083652,Krause-Levy; Sophia Louisa,26,1,120,94
1657259422805,CSE 15L,A01,083654,Morris; Justin Loren,9,0,50,41
1657259422805,CSE 15L,A02,083655,Morris; Justin Loren,9,0,50,41
1657259428842,CSE 20,A01,083657,Tran; Khoa Dang,38,0,80,42
1657259434871,CSE 21,A01,095574,Bach; Quang Tran,22,0,48,26
1657259440895,CSE 30,A01,083084,Eldon; John,4,0,80,76
1657259440895,CSE 30,B01,095061,Bhaskar; Nishant,8,0,50,42
1657259446921,CSE 100,A01,083659,Cao; Yingjun,4,4,70,66
1657259452947,CSE 134B,A01,083661,Powell; Thomas Allan,21,0,100,79
1657259458969,CSE 140,A01,083663,Gungor; Onat,13,0,85,72
1657259464995,CSE 140L,A01,083088,Eldon; John,19,0,100,81
1657259471017,CSE 175,A01,083665,Kumar; Rakesh,3,0,25,22
1657259477044,CSE 190,A00,092507,Dubnov; Shlomo,7,0,20,13
1657259483066,ECE 45,A01,083139,Congero; Spencer William,5,0,75,70
1657259489094,ECE 65,A50,083695,Saad; Andrew S,12,0,30,18
1657259489094,ECE 65,A51,095125,Saad; Andrew S,25,0,26,1
1657259495126,ECE 109,A01,091882,Touri; Behrouz,19,0,70,51
1657259501153,ECE 180,A00,083140,Abi Samra; Nicholas Camill,1,0,30,29
1657259501153,ECE 180,B00,083141,Abi Samra; Nicholas Camill,0,0,30,30
1657259507177,MATH 10A,A01,083735,Patchell; Gregory David,2,0,30,28
1657259507177,MATH 10A,A02,083736,Patchell; Gregory David,20,0,30,10
1657259507177,MATH 10A,A03,083737,Patchell; Gregory David,16,0,30,14
1657259513202,MATH 10B,A01,083207,Lim; Seonhee,7,0,34,27
1657259513202,MATH 10B,A02,083208,Lim; Seonhee,9,0,35,26
1657259513202,MATH 10B,A03,093472,Lim; Seonhee,5,0,34,29
1657259513202,MATH 10B,B01,083739,Sinha; Shubham,11,0,30,19
1657259519242,MATH 18,A01,083743,Cinel; Cameron Alexander,6,0,30,24
1657259519242,MATH 18,A02,083744,Cinel; Cameron Alexander,17,0,30,13
1657259519242,MATH 18,A03,083745,Cinel; Cameron Alexander,8,0,30,22
1657259519242,MATH 18,B01,083748,Rideout; David Porter,4,0,37,33
1657259519242,MATH 18,B02,083749,Rideout; David Porter,4,0,36,32
1657259519242,MATH 18,B03,083750,Rideout; David Porter,2,0,37,35
1657259519242,MATH 18,B04,083751,Rideout; David Porter,6,0,36,30
1657259519242,MATH 18,B05,093473,Rideout; David Porter,5,0,36,31
1657259519242,MATH 18,B06,093474,Rideout; David Porter,5,0,36,31
1657259525265,MATH 20A,A01,083754,Zheng; Zequn,14,0,40,26
1657259531289,MATH 20B,A01,083756,Briones; Jor-el Thomas Caparas,3,0,36,33
1657259531289,MATH 20B,A02,083757,Briones; Jor-el Thomas Caparas,1,0,36,35
1657259531289,MATH 20B,A03,093475,Briones; Jor-el Thomas Caparas,2,0,36,34
1657259537319,MATH 20C,A01,083760,Briones; Jor-el Thomas Caparas,1,0,35,34
1657259537319,MATH 20C,A02,083761,Briones; Jor-el Thomas Caparas,8,0,35,27
1657259537319,MATH 20C,A03,093476,Briones; Jor-el Thomas Caparas,0,1,36,36
1657259537319,MATH 20C,B01,083762,Bach; Quang Tran,1,0,30,29
1657259543350,MATH 20D,A01,083765,Tran; Brian Kha,4,0,30,26
1657259543350,MATH 20D,A02,083766,Tran; Brian Kha,5,0,30,25
1657259543350,MATH 20D,A03,083767,Tran; Brian Kha,4,0,30,26
1657259549390,MATH 20E,A01,083771,Ganguly; Soumya,7,0,32,25
1657259549390,MATH 20E,A02,083772,Ganguly; Soumya,7,0,32,25
1657259549390,MATH 20E,B01,083773,Ciotti; Benjamin,19,0,35,16
1657259549390,MATH 20E,B02,083774,Ciotti; Benjamin,17,0,35,18
1657259555414,MATH 103A,A01,083777,Greenfeld; Be'Eri,3,0,36,33
1657259555414,MATH 103A,A02,083778,Greenfeld; Be'Eri,5,0,36,31
1657259555414,MATH 103A,A03,093561,Greenfeld; Be'Eri,4,0,36,32
1657259555414,MATH 103A,B01,083779,Greenfeld; Be'Eri,6,0,36,30
1657259555414,MATH 103A,B02,083780,Greenfeld; Be'Eri,3,0,36,33
1657259555414,MATH 103A,B03,093562,Greenfeld; Be'Eri,3,0,36,33
1657259561437,MATH 105,A01,085443,Carter; Anne Toulson,15,0,35,20
1657259561437,MATH 105,A02,093477,Carter; Anne Toulson,20,0,35,15
1657259567466,MATH 109,A01,083213,Ganzberger; Geoffrey Michael,2,0,34,32
1657259567466,MATH 109,A02,083214,Ganzberger; Geoffrey Michael,4,0,34,30
1657259567466,MATH 109,A03,093478,Ganzberger; Geoffrey Michael,2,0,34,32
1657259567466,MATH 109,B01,083215,Ganzberger; Geoffrey Michael,1,0,32,31
1657259567466,MATH 109,B02,083216,Ganzberger; Geoffrey Michael,1,0,32,31
1657259567466,MATH 109,B03,093479,Ganzberger; Geoffrey Michael,8,0,32,24
1657259573499,MATH 142A,A01,083219,Chow; Bennett,7,0,32,25
1657259573499,MATH 142A,A02,083220,Chow; Bennett,10,0,32,22
1657259573499,MATH 142A,A03,093480,Chow; Bennett,7,0,32,25
1657259573499,MATH 142A,B03,093481,Chow; Bennett,8,0,32,24
1657259573499,MATH 142A,B04,093558,Chow; Bennett,12,0,32,20
1657259573499,MATH 142A,B05,093559,Chow; Bennett,6,0,32,26
1657259579523,MATH 193A,A01,083224,Rotar; Vladimir,7,0,34,27
1657259579523,MATH 193A,A02,083225,Rotar; Vladimir,6,0,34,28
1657259579523,MATH 193A,A03,083781,Rotar; Vladimir,2,0,34,32
1657259579523,MATH 193A,A04,083782,Rotar; Vladimir,8,0,34,26
1657259579523,MATH 193A,A05,093482,Rotar; Vladimir,6,0,34,28
1657259585551,MATH 197,001,091859,McAuley; Julian John,9999,0,9999,0
1657259585551,MATH 197,002,095566,Kedlaya; Kiran S.,9997,0,9999,2
1657259585551,MATH 197,003,095567,Xiao; Ming,9999,0,9999,0
1657259585551,MATH 197,004,095571,Perols; Johan Lars,9998,0,9999,1
1657259592619,COGS 9,A01,083615,Shannon; Kyle Michael,8,0,75,67
1657259598642,COGS 11,A01,083617,Boyle; Mary E. T.,22,0,48,26
1657259604666,COGS 13,A01,083071,Bastos; Amalia Pinkusfeld,8,0,71,63
1657259610688,COGS 14A,A01,092681,Semenuks; Arturs,2,1,100,98
1657259616712,COGS 14B,A01,083073,Cheng; Tzu-Han,6,0,63,57
1657259622738,COGS 17,A01,092677,Semenuks; Arturs,5,0,81,76
1657259628763,COGS 100,A01,083619,Allen; Michael Gordon,16,0,70,54
1657259634786,COGS 101A,A01,083621,Davis; Joshua Daniel,9,0,68,59
1657259640809,COGS 101B,A01,091572,Allen; Michael Gordon,11,0,65,54
1657259646833,COGS 101C,A01,083625,Delgado; Tania,17,0,35,18
1657259652861,COGS 107A,A01,083627,Boyle; Mary E. T.,13,0,60,47
1657259658885,COGS 118A,A01,083075,Gupta; Anjum,18,0,76,58
1657259664913,CSE 3,A50,083646,Miranda; Gregory Joseph,24,0,50,26
1657259670941,CSE 8A,A50,083650,Miranda; Gregory Joseph,17,1,56,39
1657259676972,CSE 11,A01,083080,Cao; Yingjun,5,15,40,35
1657259683000,CSE 12,A01,083652,Krause-Levy; Sophia Louisa,26,1,120,94
1657259689026,CSE 15L,A01,083654,Morris; Justin Loren,9,0,50,41
1657259689026,CSE 15L,A02,083655,Morris; Justin Loren,9,0,50,41
1657259695058,CSE 20,A01,083657,Tran; Khoa Dang,38,0,80,42
1657259701082,CSE 21,A01,095574,Bach; Quang Tran,22,0,48,26
1657259707106,CSE 30,A01,083084,Eldon; John,4,0,80,76
1657259707106,CSE 30,B01,095061,Bhaskar; Nishant,8,0,50,42
1657259713139,CSE 100,A01,083659,Cao; Yingjun,4,4,70,66
1657259719164,CSE 134B,A01,083661,Powell; Thomas Allan,21,0,100,79
1657259725188,CSE 140,A01,083663,Gungor; Onat,13,0,85,72
1657259731213,CSE 140L,A01,083088,Eldon; John,19,0,100,81
1657259737240,CSE 175,A01,083665,Kumar; Rakesh,3,0,25,22
1657259743264,CSE 190,A00,092507,Dubnov; Shlomo,7,0,20,13
1657259749287,ECE 45,A01,083139,Congero; Spencer William,5,0,75,70
1657259755315,ECE 65,A50,083695,Saad; Andrew S,12,0,30,18
1657259755315,ECE 65,A51,095125,Saad; Andrew S,25,0,26,1
1657259761338,ECE 109,A01,091882,Touri; Behrouz,19,0,70,51
1657259767361,ECE 180,A00,083140,Abi Samra; Nicholas Camill,1,0,30,29
1657259767361,ECE 180,B00,083141,Abi Samra; Nicholas Camill,0,0,30,30
1657259773389,MATH 10A,A01,083735,Patchell; Gregory David,2,0,30,28
1657259773389,MATH 10A,A02,083736,Patchell; Gregory David,20,0,30,10
1657259773389,MATH 10A,A03,083737,Patchell; Gregory David,16,0,30,14
1657259779414,MATH 10B,A01,083207,Lim; Seonhee,7,0,34,27
1657259779414,MATH 10B,A02,083208,Lim; Seonhee,9,0,35,26
1657259779414,MATH 10B,A03,093472,Lim; Seonhee,5,0,34,29
1657259779414,MATH 10B,B01,083739,Sinha; Shubham,11,0,30,19
1657259785440,MATH 18,A01,083743,Cinel; Cameron Alexander,6,0,30,24
1657259785440,MATH 18,A02,083744,Cinel; Cameron Alexander,17,0,30,13
1657259785440,MATH 18,A03,083745,Cinel; Cameron Alexander,8,0,30,22
1657259785440,MATH 18,B01,083748,Rideout; David Porter,4,0,37,33
1657259785440,MATH 18,B02,083749,Rideout; David Porter,4,0,36,32
1657259785440,MATH 18,B03,083750,Rideout; David Porter,2,0,37,35
1657259785440,MATH 18,B04,083751,Rideout; David Porter,6,0,36,30
1657259785440,MATH 18,B05,093473,Rideout; David Porter,5,0,36,31
1657259785440,MATH 18,B06,093474,Rideout; David Porter,5,0,36,31
1657259791463,MATH 20A,A01,083754,Zheng; Zequn,14,0,40,26
1657259797489,MATH 20B,A01,083756,Briones; Jor-el Thomas Caparas,3,0,36,33
1657259797489,MATH 20B,A02,083757,Briones; Jor-el Thomas Caparas,1,0,36,35
1657259797489,MATH 20B,A03,093475,Briones; Jor-el Thomas Caparas,2,0,36,34
1657259803516,MATH 20C,A01,083760,Briones; Jor-el Thomas Caparas,1,0,35,34
1657259803516,MATH 20C,A02,083761,Briones; Jor-el Thomas Caparas,8,0,35,27
1657259803516,MATH 20C,A03,093476,Briones; Jor-el Thomas Caparas,0,1,36,36
1657259803516,MATH 20C,B01,083762,Bach; Quang Tran,1,0,30,29
1657259809541,MATH 20D,A01,083765,Tran; Brian Kha,4,0,30,26
1657259809541,MATH 20D,A02,083766,Tran; Brian Kha,5,0,30,25
1657259809541,MATH 20D,A03,083767,Tran; Brian Kha,4,0,30,26
1657259815565,MATH 20E,A01,083771,Ganguly; Soumya,7,0,32,25
1657259815565,MATH 20E,A02,083772,Ganguly; Soumya,7,0,32,25
1657259815565,MATH 20E,B01,083773,Ciotti; Benjamin,19,0,35,16
1657259815565,MATH 20E,B02,083774,Ciotti; Benjamin,17,0,35,18
1657259821595,MATH 103A,A01,083777,Greenfeld; Be'Eri,3,0,36,33
1657259821595,MATH 103A,A02,083778,Greenfeld; Be'Eri,5,0,36,31
1657259821595,MATH 103A,A03,093561,Greenfeld; Be'Eri,4,0,36,32
1657259821595,MATH 103A,B01,083779,Greenfeld; Be'Eri,6,0,36,30
1657259821595,MATH 103A,B02,083780,Greenfeld; Be'Eri,3,0,36,33
1657259821595,MATH 103A,B03,093562,Greenfeld; Be'Eri,3,0,36,33
1657259827621,MATH 105,A01,085443,Carter; Anne Toulson,15,0,35,20
1657259827621,MATH 105,A02,093477,Carter; Anne Toulson,20,0,35,15
1657259833649,MATH 109,A01,083213,Ganzberger; Geoffrey Michael,2,0,34,32
1657259833649,MATH 109,A02,083214,Ganzberger; Geoffrey Michael,4,0,34,30
1657259833649,MATH 109,A03,093478,Ganzberger; Geoffrey Michael,2,0,34,32
1657259833649,MATH 109,B01,083215,Ganzberger; Geoffrey Michael,1,0,32,31
1657259833649,MATH 109,B02,083216,Ganzberger; Geoffrey Michael,1,0,32,31
1657259833649,MATH 109,B03,093479,Ganzberger; Geoffrey Michael,8,0,32,24
1657259839676,MATH 142A,A01,083219,Chow; Bennett,7,0,32,25
1657259839676,MATH 142A,A02,083220,Chow; Bennett,10,0,32,22
1657259839676,MATH 142A,A03,093480,Chow; Bennett,7,0,32,25
1657259839676,MATH 142A,B03,093481,Chow; Bennett,8,0,32,24
1657259839676,MATH 142A,B04,093558,Chow; Bennett,12,0,32,20
1657259839676,MATH 142A,B05,093559,Chow; Bennett,6,0,32,26
1657259845705,MATH 193A,A01,083224,Rotar; Vladimir,7,0,34,27
1657259845705,MATH 193A,A02,083225,Rotar; Vladimir,6,0,34,28
1657259845705,MATH 193A,A03,083781,Rotar; Vladimir,2,0,34,32
1657259845705,MATH 193A,A04,083782,Rotar; Vladimir,8,0,34,26
1657259845705,MATH 193A,A05,093482,Rotar; Vladimir,6,0,34,28
1657259851727,MATH 197,001,091859,McAuley; Julian John,9999,0,9999,0
1657259851727,MATH 197,002,095566,Kedlaya; Kiran S.,9997,0,9999,2
1657259851727,MATH 197,003,095567,Xiao; Ming,9999,0,9999,0
1657259851727,MATH 197,004,095571,Perols; Johan Lars,9998,0,9999,1
1657259858779,COGS 9,A01,083615,Shannon; Kyle Michael,8,0,75,67
1657259864805,COGS 11,A01,083617,Boyle; Mary E. T.,22,0,48,26
1657259870828,COGS 13,A01,083071,Bastos; Amalia Pinkusfeld,8,0,71,63
1657259876853,COGS 14A,A01,092681,Semenuks; Arturs,2,1,100,98
1657259882881,COGS 14B,A01,083073,Cheng; Tzu-Han,6,0,63,57
1657259888909,COGS 17,A01,092677,Semenuks; Arturs,5,0,81,76
1657259894937,COGS 100,A01,083619,Allen; Michael Gordon,16,0,70,54
1657259900960,COGS 101A,A01,083621,Davis; Joshua Daniel,9,0,68,59
1657259906985,COGS 101B,A01,091572,Allen; Michael Gordon,11,0,65,54
1657259913013,COGS 101C,A01,083625,Delgado; Tania,17,0,35,18
1657259919044,COGS 107A,A01,083627,Boyle; Mary E. T.,13,0,60,47
1657259925073,COGS 118A,A01,083075,Gupta; Anjum,18,0,76,58
1657259931099,CSE 3,A50,083646,Miranda; Gregory Joseph,24,0,50,26
1657259937216,CSE 8A,A50,083650,Miranda; Gregory Joseph,17,1,56,39
1657259943240,CSE 11,A01,083080,Cao; Yingjun,5,15,40,35
1657259949265,CSE 12,A01,083652,Krause-Levy; Sophia Louisa,26,1,120,94
1657259955308,CSE 15L,A01,083654,Morris; Justin Loren,9,0,50,41
1657259955308,CSE 15L,A02,083655,Morris; Justin Loren,9,0,50,41
1657259961335,CSE 20,A01,083657,Tran; Khoa Dang,38,0,80,42
1657259967359,CSE 21,A01,095574,Bach; Quang Tran,22,0,48,26
1657259973388,CSE 30,A01,083084,Eldon; John,4,0,80,76
1657259973388,CSE 30,B01,095061,Bhaskar; Nishant,8,0,50,42
1657259979413,CSE 100,A01,083659,Cao; Yingjun,4,4,70,66
1657259985440,CSE 134B,A01,083661,Powell; Thomas Allan,21,0,100,79
1657259991469,CSE 140,A01,083663,Gungor; Onat,13,0,85,72
1657259997497,CSE 140L,A01,083088,Eldon; John,19,0,100,81
1657260003519,CSE 175,A01,083665,Kumar; Rakesh,3,0,25,22
1657260009542,CSE 190,A00,092507,Dubnov; Shlomo,7,0,20,13
1657260015564,ECE 45,A01,083139,Congero; Spencer William,5,0,75,70
1657260021588,ECE 65,A50,083695,Saad; Andrew S,12,0,30,18
1657260021588,ECE 65,A51,095125,Saad; Andrew S,25,0,26,1
1657260027650,ECE 109,A01,091882,Touri; Behrouz,19,0,70,51
1657260033679,ECE 180,A00,083140,Abi Samra; Nicholas Camill,1,0,30,29
1657260033679,ECE 180,B00,083141,Abi Samra; Nicholas Camill,0,0,30,30
1657260039705,MATH 10A,A01,083735,Patchell; Gregory David,2,0,30,28
1657260039705,MATH 10A,A02,083736,Patchell; Gregory David,20,0,30,10
1657260039705,MATH 10A,A03,083737,Patchell; Gregory David,16,0,30,14
1657260045731,MATH 10B,A01,083207,Lim; Seonhee,7,0,34,27
1657260045731,MATH 10B,A02,083208,Lim; Seonhee,9,0,35,26
1657260045731,MATH 10B,A03,093472,Lim; Seonhee,5,0,34,29
1657260045731,MATH 10B,B01,083739,Sinha; Shubham,11,0,30,19
1657260051767,MATH 18,A01,083743,Cinel; Cameron Alexander,6,0,30,24
1657260051767,MATH 18,A02,083744,Cinel; Cameron Alexander,17,0,30,13
1657260051767,MATH 18,A03,083745,Cinel; Cameron Alexander,8,0,30,22
1657260051767,MATH 18,B01,083748,Rideout; David Porter,4,0,37,33
1657260051767,MATH 18,B02,083749,Rideout; David Porter,4,0,36,32
1657260051767,MATH 18,B03,083750,Rideout; David Porter,2,0,37,35
1657260051767,MATH 18,B04,083751,Rideout; David Porter,6,0,36,30
1657260051767,MATH 18,B05,093473,Rideout; David Porter,5,0,36,31
1657260051767,MATH 18,B06,093474,Rideout; David Porter,5,0,36,31
1657260057792,MATH 20A,A01,083754,Zheng; Zequn,14,0,40,26
1657260063824,MATH 20B,A01,083756,Briones; Jor-el Thomas Caparas,3,0,36,33
1657260063824,MATH 20B,A02,083757,Briones; Jor-el Thomas Caparas,1,0,36,35
1657260063824,MATH 20B,A03,093475,Briones; Jor-el Thomas Caparas,2,0,36,34
1657260069849,MATH 20C,A01,083760,Briones; Jor-el Thomas Caparas,1,0,35,34
1657260069849,MATH 20C,A02,083761,Briones; Jor-el Thomas Caparas,8,0,35,27
1657260069849,MATH 20C,A03,093476,Briones; Jor-el Thomas Caparas,0,1,36,36
1657260069849,MATH 20C,B01,083762,Bach; Quang Tran,1,0,30,29
1657260075873,MATH 20D,A01,083765,Tran; Brian Kha,4,0,30,26
1657260075873,MATH 20D,A02,083766,Tran; Brian Kha,5,0,30,25
1657260075873,MATH 20D,A03,083767,Tran; Brian Kha,4,0,30,26
1657260081903,MATH 20E,A01,083771,Ganguly; Soumya,7,0,32,25
1657260081903,MATH 20E,A02,083772,Ganguly; Soumya,7,0,32,25
1657260081903,MATH 20E,B01,083773,Ciotti; Benjamin,19,0,35,16
1657260081903,MATH 20E,B02,083774,Ciotti; Benjamin,17,0,35,18
1657260087929,MATH 103A,A01,083777,Greenfeld; Be'Eri,3,0,36,33
1657260087929,MATH 103A,A02,083778,Greenfeld; Be'Eri,5,0,36,31
1657260087929,MATH 103A,A03,093561,Greenfeld; Be'Eri,4,0,36,32
1657260087929,MATH 103A,B01,083779,Greenfeld; Be'Eri,6,0,36,30
1657260087929,MATH 103A,B02,083780,Greenfeld; Be'Eri,3,0,36,33
1657260087929,MATH 103A,B03,093562,Greenfeld; Be'Eri,3,0,36,33
1657260093962,MATH 105,A01,085443,Carter; Anne Toulson,15,0,35,20
1657260093962,MATH 105,A02,093477,Carter; Anne Toulson,20,0,35,15
1657260099986,MATH 109,A01,083213,Ganzberger; Geoffrey Michael,2,0,34,32
1657260099986,MATH 109,A02,083214,Ganzberger; Geoffrey Michael,4,0,34,30
1657260099986,MATH 109,A03,093478,Ganzberger; Geoffrey Michael,2,0,34,32
1657260099986,MATH 109,B01,083215,Ganzberger; Geoffrey Michael,1,0,32,31
1657260099986,MATH 109,B02,083216,Ganzberger; Geoffrey Michael,1,0,32,31
1657260099986,MATH 109,B03,093479,Ganzberger; Geoffrey Michael,8,0,32,24
1657260106011,MATH 142A,A01,083219,Chow; Bennett,7,0,32,25
1657260106011,MATH 142A,A02,083220,Chow; Bennett,10,0,32,22
1657260106011,MATH 142A,A03,093480,Chow; Bennett,7,0,32,25
1657260106011,MATH 142A,B03,093481,Chow; Bennett,8,0,32,24
1657260106011,MATH 142A,B04,093558,Chow; Bennett,12,0,32,20
1657260106011,MATH 142A,B05,093559,Chow; Bennett,6,0,32,26
1657260112037,MATH 193A,A01,083224,Rotar; Vladimir,7,0,34,27
1657260112037,MATH 193A,A02,083225,Rotar; Vladimir,6,0,34,28
1657260112037,MATH 193A,A03,083781,Rotar; Vladimir,2,0,34,32
1657260112037,MATH 193A,A04,083782,Rotar; Vladimir,8,0,34,26
1657260112037,MATH 193A,A05,093482,Rotar; Vladimir,6,0,34,28
1657260118065,MATH 197,001,091859,McAuley; Julian John,9999,0,9999,0
1657260118065,MATH 197,002,095566,Kedlaya; Kiran S.,9997,0,9999,2
1657260118065,MATH 197,003,095567,Xiao; Ming,9999,0,9999,0
1657260118065,MATH 197,004,095571,Perols; Johan Lars,9998,0,9999,1
1657260125124,COGS 9,A01,083615,Shannon; Kyle Michael,8,0,75,67
1657260131147,COGS 11,A01,083617,Boyle; Mary E. T.,22,0,48,26
1657260137171,COGS 13,A01,083071,Bastos; Amalia Pinkusfeld,8,0,71,63
1657260143195,COGS 14A,A01,092681,Semenuks; Arturs,2,1,100,98
1657260149223,COGS 14B,A01,083073,Cheng; Tzu-Han,6,0,63,57
1657260155247,COGS 17,A01,092677,Semenuks; Arturs,5,0,81,76
1657260161272,COGS 100,A01,083619,Allen; Michael Gordon,16,0,70,54
1657260167295,COGS 101A,A01,083621,Davis; Joshua Daniel,9,0,68,59
1657260173323,COGS 101B,A01,091572,Allen; Michael Gordon,11,0,65,54
1657260179348,COGS 101C,A01,083625,Delgado; Tania,17,0,35,18
1657260185372,COGS 107A,A01,083627,Boyle; Mary E. T.,13,0,60,47
1657260191398,COGS 118A,A01,083075,Gupta; Anjum,18,0,76,58
1657260197426,CSE 3,A50,083646,Miranda; Gregory Joseph,24,0,50,26
1657260203450,CSE 8A,A50,083650,Miranda; Gregory Joseph,17,1,56,39
1657260209473,CSE 11,A01,083080,Cao; Yingjun,5,15,40,35
1657260215495,CSE 12,A01,083652,Krause-Levy; Sophia Louisa,26,1,120,94
1657260221519,CSE 15L,A01,083654,Morris; Justin Loren,9,0,50,41
1657260221519,CSE 15L,A02,083655,Morris; Justin Loren,9,0,50,41
1657260227545,CSE 20,A01,083657,Tran; Khoa Dang,38,0,80,42
1657260233572,CSE 21,A01,095574,Bach; Quang Tran,22,0,48,26
1657260239603,CSE 30,A01,083084,Eldon; John,4,0,80,76
1657260239603,CSE 30,B01,095061,Bhaskar; Nishant,8,0,50,42
1657260245631,CSE 100,A01,083659,Cao; Yingjun,4,4,70,66
1657260251657,CSE 134B,A01,083661,Powell; Thomas Allan,21,0,100,79
1657260257685,CSE 140,A01,083663,Gungor; Onat,13,0,85,72
1657260263708,CSE 140L,A01,083088,Eldon; John,19,0,100,81
1657260269730,CSE 175,A01,083665,Kumar; Rakesh,3,0,25,22
1657260275757,CSE 190,A00,092507,Dubnov; Shlomo,7,0,20,13
1657260281782,ECE 45,A01,083139,Congero; Spencer William,5,0,75,70
1657260287807,ECE 65,A50,083695,Saad; Andrew S,12,0,30,18
1657260287807,ECE 65,A51,095125,Saad; Andrew S,25,0,26,1
1657260293832,ECE 109,A01,091882,Touri; Behrouz,19,0,70,51
1657260299860,ECE 180,A00,083140,Abi Samra; Nicholas Camill,1,0,30,29
1657260299860,ECE 180,B00,083141,Abi Samra; Nicholas Camill,0,0,30,30
1657260305888,MATH 10A,A01,083735,Patchell; Gregory David,2,0,30,28
1657260305888,MATH 10A,A02,083736,Patchell; Gregory David,20,0,30,10
1657260305888,MATH 10A,A03,083737,Patchell; Gregory David,16,0,30,14
1657260311913,MATH 10B,A01,083207,Lim; Seonhee,7,0,34,27
1657260311913,MATH 10B,A02,083208,Lim; Seonhee,9,0,35,26
1657260311913,MATH 10B,A03,093472,Lim; Seonhee,5,0,34,29
1657260311913,MATH 10B,B01,083739,Sinha; Shubham,11,0,30,19
1657260317944,MATH 18,A01,083743,Cinel; Cameron Alexander,6,0,30,24
1657260317944,MATH 18,A02,083744,Cinel; Cameron Alexander,17,0,30,13
1657260317944,MATH 18,A03,083745,Cinel; Cameron Alexander,8,0,30,22
1657260317944,MATH 18,B01,083748,Rideout; David Porter,4,0,37,33
1657260317944,MATH 18,B02,083749,Rideout; David Porter,4,0,36,32
1657260317944,MATH 18,B03,083750,Rideout; David Porter,2,0,37,35
1657260317944,MATH 18,B04,083751,Rideout; David Porter,6,0,36,30
1657260317944,MATH 18,B05,093473,Rideout; David Porter,5,0,36,31
1657260317944,MATH 18,B06,093474,Rideout; David Porter,5,0,36,31
1657260323968,MATH 20A,A01,083754,Zheng; Zequn,14,0,40,26
1657260329989,MATH 20B,A01,083756,Briones; Jor-el Thomas Caparas,3,0,36,33
1657260329989,MATH 20B,A02,083757,Briones; Jor-el Thomas Caparas,1,0,36,35
1657260329989,MATH 20B,A03,093475,Briones; Jor-el Thomas Caparas,2,0,36,34
1657260336012,MATH 20C,A01,083760,Briones; Jor-el Thomas Caparas,1,0,35,34
1657260336012,MATH 20C,A02,083761,Briones; Jor-el Thomas Caparas,8,0,35,27
1657260336012,MATH 20C,A03,093476,Briones; Jor-el Thomas Caparas,0,1,36,36
1657260336012,MATH 20C,B01,083762,Bach; Quang Tran,1,0,30,29
1657260342037,MATH 20D,A01,083765,Tran; Brian Kha,4,0,30,26
1657260342037,MATH 20D,A02,083766,Tran; Brian Kha,5,0,30,25
1657260342037,MATH 20D,A03,083767,Tran; Brian Kha,4,0,30,26
1657260348067,MATH 20E,A01,083771,Ganguly; Soumya,7,0,32,25
1657260348067,MATH 20E,A02,083772,Ganguly; Soumya,7,0,32,25
1657260348067,MATH 20E,B01,083773,Ciotti; Benjamin,19,0,35,16
1657260348067,MATH 20E,B02,083774,Ciotti; Benjamin,17,0,35,18
1657260354100,MATH 103A,A01,083777,Greenfeld; Be'Eri,3,0,36,33
1657260354100,MATH 103A,A02,083778,Greenfeld; Be'Eri,5,0,36,31
1657260354100,MATH 103A,A03,093561,Greenfeld; Be'Eri,4,0,36,32
1657260354100,MATH 103A,B01,083779,Greenfeld; Be'Eri,6,0,36,30
1657260354100,MATH 103A,B02,083780,Greenfeld; Be'Eri,3,0,36,33
1657260354100,MATH 103A,B03,093562,Greenfeld; Be'Eri,3,0,36,33
1657260360126,MATH 105,A01,085443,Carter; Anne Toulson,15,0,35,20
1657260360126,MATH 105,A02,093477,Carter; Anne Toulson,20,0,35,15
1657260366155,MATH 109,A01,083213,Ganzberger; Geoffrey Michael,2,0,34,32
1657260366155,MATH 109,A02,083214,Ganzberger; Geoffrey Michael,4,0,34,30
1657260366155,MATH 109,A03,093478,Ganzberger; Geoffrey Michael,2,0,34,32
1657260366155,MATH 109,B01,083215,Ganzberger; Geoffrey Michael,1,0,32,31
1657260366155,MATH 109,B02,083216,Ganzberger; Geoffrey Michael,1,0,32,31
1657260366155,MATH 109,B03,093479,Ganzberger; Geoffrey Michael,8,0,32,24
1657260372184,MATH 142A,A01,083219,Chow; Bennett,7,0,32,25
1657260372184,MATH 142A,A02,083220,Chow; Bennett,10,0,32,22
1657260372184,MATH 142A,A03,093480,Chow; Bennett,7,0,32,25
1657260372184,MATH 142A,B03,093481,Chow; Bennett,8,0,32,24
1657260372184,MATH 142A,B04,093558,Chow; Bennett,12,0,32,20
1657260372184,MATH 142A,B05,093559,Chow; Bennett,6,0,32,26
1657260378208,MATH 193A,A01,083224,Rotar; Vladimir,7,0,34,27
1657260378208,MATH 193A,A02,083225,Rotar; Vladimir,6,0,34,28
1657260378208,MATH 193A,A03,083781,Rotar; Vladimir,2,0,34,32
1657260378208,MATH 193A,A04,083782,Rotar; Vladimir,8,0,34,26
1657260378208,MATH 193A,A05,093482,Rotar; Vladimir,6,0,34,28
1657260384234,MATH 197,001,091859,McAuley; Julian John,9999,0,9999,0
1657260384234,MATH 197,002,095566,Kedlaya; Kiran S.,9997,0,9999,2
1657260384234,MATH 197,003,095567,Xiao; Ming,9999,0,9999,0
1657260384234,MATH 197,004,095571,Perols; Johan Lars,9998,0,9999,1
1657260391288,COGS 9,A01,083615,Shannon; Kyle Michael,8,0,75,67
1657260397315,COGS 11,A01,083617,Boyle; Mary E. T.,22,0,48,26
1657260403343,COGS 13,A01,083071,Bastos; Amalia Pinkusfeld,8,0,71,63
1657260409367,COGS 14A,A01,092681,Semenuks; Arturs,2,1,100,98
1657260415391,COGS 14B,A01,083073,Cheng; Tzu-Han,6,0,63,57
1657260421418,COGS 17,A01,092677,Semenuks; Arturs,5,0,81,76
1657260427446,COGS 100,A01,083619,Allen; Michael Gordon,16,0,70,54
1657260433469,COGS 101A,A01,083621,Davis; Joshua Daniel,9,0,68,59
1657260439497,COGS 101B,A01,091572,Allen; Michael Gordon,11,0,65,54
1657260445519,COGS 101C,A01,083625,Delgado; Tania,17,0,35,18
1657260451543,COGS 107A,A01,083627,Boyle; Mary E. T.,13,0,60,47
1657260457568,COGS 118A,A01,083075,Gupta; Anjum,18,0,76,58
1657260463591,CSE 3,A50,083646,Miranda; Gregory Joseph,24,0,50,26
1657260469616,CSE 8A,A50,083650,Miranda; Gregory Joseph,17,1,56,39
1657260475641,CSE 11,A01,083080,Cao; Yingjun,5,15,40,35
1657260481667,CSE 12,A01,083652,Krause-Levy; Sophia Louisa,26,1,120,94
1657260487693,CSE 15L,A01,083654,Morris; Justin Loren,9,0,50,41
1657260487693,CSE 15L,A02,083655,Morris; Justin Loren,9,0,50,41
1657260493716,CSE 20,A01,083657,Tran; Khoa Dang,38,0,80,42
1657260499743,CSE 21,A01,095574,Bach; Quang Tran,22,0,48,26
1657260505767,CSE 30,A01,083084,Eldon; John,4,0,80,76
1657260505767,CSE 30,B01,095061,Bhaskar; Nishant,8,0,50,42
1657260511792,CSE 100,A01,083659,Cao; Yingjun,4,4,70,66
1657260517822,CSE 134B,A01,083661,Powell; Thomas Allan,21,0,100,79
1657260523859,CSE 140,A01,083663,Gungor; Onat,13,0,85,72
1657260529881,CSE 140L,A01,083088,Eldon; John,19,0,100,81
1657260535976,CSE 175,A01,083665,Kumar; Rakesh,3,0,25,22
1657260542000,CSE 190,A00,092507,Dubnov; Shlomo,7,0,20,13
1657260548027,ECE 45,A01,083139,Congero; Spencer William,5,0,75,70
1657260554052,ECE 65,A50,083695,Saad; Andrew S,12,0,30,18
1657260554052,ECE 65,A51,095125,Saad; Andrew S,25,0,26,1
1657260560079,ECE 109,A01,091882,Touri; Behrouz,19,0,70,51
1657260566117,ECE 180,A00,083140,Abi Samra; Nicholas Camill,1,0,30,29
1657260566117,ECE 180,B00,083141,Abi Samra; Nicholas Camill,0,0,30,30
1657260572144,MATH 10A,A01,083735,Patchell; Gregory David,2,0,30,28
1657260572144,MATH 10A,A02,083736,Patchell; Gregory David,20,0,30,10
1657260572144,MATH 10A,A03,083737,Patchell; Gregory David,16,0,30,14
1657260578168,MATH 10B,A01,083207,Lim; Seonhee,7,0,34,27
1657260578168,MATH 10B,A02,083208,Lim; Seonhee,9,0,35,26
1657260578168,MATH 10B,A03,093472,Lim; Seonhee,5,0,34,29
1657260578168,MATH 10B,B01,083739,Sinha; Shubham,11,0,30,19
1657260584191,MATH 18,A01,083743,Cinel; Cameron Alexander,6,0,30,24
1657260584191,MATH 18,A02,083744,Cinel; Cameron Alexander,17,0,30,13
1657260584191,MATH 18,A03,083745,Cinel; Cameron Alexander,8,0,30,22
1657260584191,MATH 18,B01,083748,Rideout; David Porter,4,0,37,33
1657260584191,MATH 18,B02,083749,Rideout; David Porter,4,0,36,32
1657260584191,MATH 18,B03,083750,Rideout; David Porter,2,0,37,35
1657260584191,MATH 18,B04,083751,Rideout; David Porter,6,0,36,30
1657260584191,MATH 18,B05,093473,Rideout; David Porter,5,0,36,31
1657260584191,MATH 18,B06,093474,Rideout; David Porter,5,0,36,31
1657260590214,MATH 20A,A01,083754,Zheng; Zequn,14,0,40,26
1657260596250,MATH 20B,A01,083756,Briones; Jor-el Thomas Caparas,3,0,36,33
1657260596250,MATH 20B,A02,083757,Briones; Jor-el Thomas Caparas,1,0,36,35
1657260596250,MATH 20B,A03,093475,Briones; Jor-el Thomas Caparas,2,0,36,34
1657260602275,MATH 20C,A01,083760,Briones; Jor-el Thomas Caparas,1,0,35,34
1657260602275,MATH 20C,A02,083761,Briones; Jor-el Thomas Caparas,8,0,35,27
1657260602275,MATH 20C,A03,093476,Briones; Jor-el Thomas Caparas,0,1,36,36
1657260602275,MATH 20C,B01,083762,Bach; Quang Tran,1,0,30,29
1657260608298,MATH 20D,A01,083765,Tran; Brian Kha,4,0,30,26
1657260608298,MATH 20D,A02,083766,Tran; Brian Kha,5,0,30,25
1657260608298,MATH 20D,A03,083767,Tran; Brian Kha,4,0,30,26
1657260614332,MATH 20E,A01,083771,Ganguly; Soumya,7,0,32,25
1657260614332,MATH 20E,A02,083772,Ganguly; Soumya,7,0,32,25
1657260614332,MATH 20E,B01,083773,Ciotti; Benjamin,19,0,35,16
1657260614332,MATH 20E,B02,083774,Ciotti; Benjamin,17,0,35,18
1657260620367,MATH 103A,A01,083777,Greenfeld; Be'Eri,3,0,36,33
1657260620367,MATH 103A,A02,083778,Greenfeld; Be'Eri,5,0,36,31
1657260620367,MATH 103A,A03,093561,Greenfeld; Be'Eri,4,0,36,32
1657260620367,MATH 103A,B01,083779,Greenfeld; Be'Eri,6,0,36,30
1657260620367,MATH 103A,B02,083780,Greenfeld; Be'Eri,3,0,36,33
1657260620367,MATH 103A,B03,093562,Greenfeld; Be'Eri,3,0,36,33
1657260626390,MATH 105,A01,085443,Carter; Anne Toulson,15,0,35,20
1657260626390,MATH 105,A02,093477,Carter; Anne Toulson,20,0,35,15
1657260632420,MATH 109,A01,083213,Ganzberger; Geoffrey Michael,2,0,34,32
1657260632420,MATH 109,A02,083214,Ganzberger; Geoffrey Michael,4,0,34,30
1657260632420,MATH 109,A03,093478,Ganzberger; Geoffrey Michael,2,0,34,32
1657260632420,MATH 109,B01,083215,Ganzberger; Geoffrey Michael,1,0,32,31
1657260632420,MATH 109,B02,083216,Ganzberger; Geoffrey Michael,1,0,32,31
1657260632420,MATH 109,B03,093479,Ganzberger; Geoffrey Michael,8,0,32,24
1657260638446,MATH 142A,A01,083219,Chow; Bennett,7,0,32,25
1657260638446,MATH 142A,A02,083220,Chow; Bennett,10,0,32,22
1657260638446,MATH 142A,A03,093480,Chow; Bennett,7,0,32,25
1657260638446,MATH 142A,B03,093481,Chow; Bennett,8,0,32,24
1657260638446,MATH 142A,B04,093558,Chow; Bennett,12,0,32,20
1657260638446,MATH 142A,B05,093559,Chow; Bennett,6,0,32,26
1657260644469,MATH 193A,A01,083224,Rotar; Vladimir,7,0,34,27
1657260644469,MATH 193A,A02,083225,Rotar; Vladimir,6,0,34,28
1657260644469,MATH 193A,A03,083781,Rotar; Vladimir,2,0,34,32
1657260644469,MATH 193A,A04,083782,Rotar; Vladimir,8,0,34,26
1657260644469,MATH 193A,A05,093482,Rotar; Vladimir,6,0,34,28
1657260650495,MATH 197,001,091859,McAuley; Julian John,9999,0,9999,0
1657260650495,MATH 197,002,095566,Kedlaya; Kiran S.,9997,0,9999,2
1657260650495,MATH 197,003,095567,Xiao; Ming,9999,0,9999,0
1657260650495,MATH 197,004,095571,Perols; Johan Lars,9998,0,9999,1
1657260657588,COGS 9,A01,083615,Shannon; Kyle Michael,8,0,75,67
1657260663612,COGS 11,A01,083617,Boyle; Mary E. T.,22,0,48,26
1657260669639,COGS 13,A01,083071,Bastos; Amalia Pinkusfeld,8,0,71,63
1657260675662,COGS 14A,A01,092681,Semenuks; Arturs,2,1,100,98
1657260681686,COGS 14B,A01,083073,Cheng; Tzu-Han,6,0,63,57
1657260687713,COGS 17,A01,092677,Semenuks; Arturs,5,0,81,76
1657260693740,COGS 100,A01,083619,Allen; Michael Gordon,16,0,70,54
1657260699765,COGS 101A,A01,083621,Davis; Joshua Daniel,9,0,68,59
1657260705786,COGS 101B,A01,091572,Allen; Michael Gordon,11,0,65,54
1657260711815,COGS 101C,A01,083625,Delgado; Tania,17,0,35,18
1657260717838,COGS 107A,A01,083627,Boyle; Mary E. T.,13,0,60,47
1657260723865,COGS 118A,A01,083075,Gupta; Anjum,18,0,76,58
1657260729894,CSE 3,A50,083646,Miranda; Gregory Joseph,24,0,50,26
1657260735922,CSE 8A,A50,083650,Miranda; Gregory Joseph,17,1,56,39
1657260741949,CSE 11,A01,083080,Cao; Yingjun,5,15,40,35
1657260747977,CSE 12,A01,083652,Krause-Levy; Sophia Louisa,26,1,120,94
1657260754001,CSE 15L,A01,083654,Morris; Justin Loren,9,0,50,41
1657260754001,CSE 15L,A02,083655,Morris; Justin Loren,9,0,50,41
1657260760025,CSE 20,A01,083657,Tran; Khoa Dang,38,0,80,42
1657260766049,CSE 21,A01,095574,Bach; Quang Tran,22,0,48,26
1657260772073,CSE 30,A01,083084,Eldon; John,4,0,80,76
1657260772073,CSE 30,B01,095061,Bhaskar; Nishant,8,0,50,42
1657260778096,CSE 100,A01,083659,Cao; Yingjun,4,4,70,66
1657260784128,CSE 134B,A01,083661,Powell; Thomas Allan,21,0,100,79
1657260790154,CSE 140,A01,083663,Gungor; Onat,13,0,85,72
1657260796180,CSE 140L,A01,083088,Eldon; John,19,0,100,81
1657260802206,CSE 175,A01,083665,Kumar; Rakesh,3,0,25,22
1657260808230,CSE 190,A00,092507,Dubnov; Shlomo,7,0,20,13
1657260814252,ECE 45,A01,083139,Congero; Spencer William,5,0,75,70
1657260820282,ECE 65,A50,083695,Saad; Andrew S,12,0,30,18
1657260820282,ECE 65,A51,095125,Saad; Andrew S,25,0,26,1
1657260826308,ECE 109,A01,091882,Touri; Behrouz,19,0,70,51
1657260832336,ECE 180,A00,083140,Abi Samra; Nicholas Camill,1,0,30,29
1657260832336,ECE 180,B00,083141,Abi Samra; Nicholas Camill,0,0,30,30
1657260838365,MATH 10A,A01,083735,Patchell; Gregory David,2,0,30,28
1657260838365,MATH 10A,A02,083736,Patchell; Gregory David,20,0,30,10
1657260838365,MATH 10A,A03,083737,Patchell; Gregory David,16,0,30,14
1657260844393,MATH 10B,A01,083207,Lim; Seonhee,7,0,34,27
1657260844393,MATH 10B,A02,083208,Lim; Seonhee,9,0,35,26
1657260844393,MATH 10B,A03,093472,Lim; Seonhee,5,0,34,29
1657260844393,MATH 10B,B01,083739,Sinha; Shubham,11,0,30,19
1657260850419,MATH 18,A01,083743,Cinel; Cameron Alexander,6,0,30,24
1657260850419,MATH 18,A02,083744,Cinel; Cameron Alexander,17,0,30,13
1657260850419,MATH 18,A03,083745,Cinel; Cameron Alexander,8,0,30,22
1657260850419,MATH 18,B01,083748,Rideout; David Porter,4,0,37,33
1657260850419,MATH 18,B02,083749,Rideout; David Porter,4,0,36,32
1657260850419,MATH 18,B03,083750,Rideout; David Porter,2,0,37,35
1657260850419,MATH 18,B04,083751,Rideout; David Porter,6,0,36,30
1657260850419,MATH 18,B05,093473,Rideout; David Porter,5,0,36,31
1657260850419,MATH 18,B06,093474,Rideout; David Porter,5,0,36,31
1657260856443,MATH 20A,A01,083754,Zheng; Zequn,14,0,40,26
1657260862465,MATH 20B,A01,083756,Briones; Jor-el Thomas Caparas,3,0,36,33
1657260862465,MATH 20B,A02,083757,Briones; Jor-el Thomas Caparas,1,0,36,35
1657260862465,MATH 20B,A03,093475,Briones; Jor-el Thomas Caparas,2,0,36,34
1657260868487,MATH 20C,A01,083760,Briones; Jor-el Thomas Caparas,1,0,35,34
1657260868487,MATH 20C,A02,083761,Briones; Jor-el Thomas Caparas,8,0,35,27
1657260868487,MATH 20C,A03,093476,Briones; Jor-el Thomas Caparas,0,1,36,36
1657260868487,MATH 20C,B01,083762,Bach; Quang Tran,1,0,30,29
1657260874510,MATH 20D,A01,083765,Tran; Brian Kha,4,0,30,26
1657260874510,MATH 20D,A02,083766,Tran; Brian Kha,5,0,30,25
1657260874510,MATH 20D,A03,083767,Tran; Brian Kha,4,0,30,26
1657260880534,MATH 20E,A01,083771,Ganguly; Soumya,7,0,32,25
1657260880534,MATH 20E,A02,083772,Ganguly; Soumya,7,0,32,25
1657260880534,MATH 20E,B01,083773,Ciotti; Benjamin,19,0,35,16
1657260880534,MATH 20E,B02,083774,Ciotti; Benjamin,17,0,35,18
1657260886565,MATH 103A,A01,083777,Greenfeld; Be'Eri,3,0,36,33
1657260886565,MATH 103A,A02,083778,Greenfeld; Be'Eri,5,0,36,31
1657260886565,MATH 103A,A03,093561,Greenfeld; Be'Eri,4,0,36,32
1657260886565,MATH 103A,B01,083779,Greenfeld; Be'Eri,6,0,36,30
1657260886565,MATH 103A,B02,083780,Greenfeld; Be'Eri,3,0,36,33
1657260886565,MATH 103A,B03,093562,Greenfeld; Be'Eri,3,0,36,33
1657260892593,MATH 105,A01,085443,Carter; Anne Toulson,15,0,35,20
1657260892593,MATH 105,A02,093477,Carter; Anne Toulson,20,0,35,15
1657260898622,MATH 109,A01,083213,Ganzberger; Geoffrey Michael,2,0,34,32
1657260898622,MATH 109,A02,083214,Ganzberger; Geoffrey Michael,4,0,34,30
1657260898622,MATH 109,A03,093478,Ganzberger; Geoffrey Michael,2,0,34,32
1657260898622,MATH 109,B01,083215,Ganzberger; Geoffrey Michael,1,0,32,31
1657260898622,MATH 109,B02,083216,Ganzberger; Geoffrey Michael,1,0,32,31
1657260898622,MATH 109,B03,093479,Ganzberger; Geoffrey Michael,8,0,32,24
1657260904647,MATH 142A,A01,083219,Chow; Bennett,7,0,32,25
1657260904647,MATH 142A,A02,083220,Chow; Bennett,10,0,32,22
1657260904647,MATH 142A,A03,093480,Chow; Bennett,7,0,32,25
1657260904647,MATH 142A,B03,093481,Chow; Bennett,8,0,32,24
1657260904647,MATH 142A,B04,093558,Chow; Bennett,12,0,32,20
1657260904647,MATH 142A,B05,093559,Chow; Bennett,6,0,32,26
1657260910674,MATH 193A,A01,083224,Rotar; Vladimir,7,0,34,27
1657260910674,MATH 193A,A02,083225,Rotar; Vladimir,6,0,34,28
1657260910674,MATH 193A,A03,083781,Rotar; Vladimir,2,0,34,32
1657260910674,MATH 193A,A04,083782,Rotar; Vladimir,8,0,34,26
1657260910674,MATH 193A,A05,093482,Rotar; Vladimir,6,0,34,28
1657260916700,MATH 197,001,091859,McAuley; Julian John,9999,0,9999,0
1657260916700,MATH 197,002,095566,Kedlaya; Kiran S.,9997,0,9999,2
1657260916700,MATH 197,003,095567,Xiao; Ming,9999,0,9999,0
1657260916700,MATH 197,004,095571,Perols; Johan Lars,9998,0,9999,1
1657260923753,COGS 9,A01,083615,Shannon; Kyle Michael,8,0,75,67
1657260929792,COGS 11,A01,083617,Boyle; Mary E. T.,22,0,48,26
1657260935816,COGS 13,A01,083071,Bastos; Amalia Pinkusfeld,8,0,71,63
1657260941864,COGS 14A,A01,092681,Semenuks; Arturs,2,1,100,98
1657260947891,COGS 14B,A01,083073,Cheng; Tzu-Han,6,0,63,57
1657260953913,COGS 17,A01,092677,Semenuks; Arturs,5,0,81,76
1657260959938,COGS 100,A01,083619,Allen; Michael Gordon,16,0,70,54
1657260965965,COGS 101A,A01,083621,Davis; Joshua Daniel,9,0,68,59
1657260971988,COGS 101B,A01,091572,Allen; Michael Gordon,11,0,65,54
1657260978015,COGS 101C,A01,083625,Delgado; Tania,17,0,35,18
1657260984038,COGS 107A,A01,083627,Boyle; Mary E. T.,13,0,60,47
1657260990063,COGS 118A,A01,083075,Gupta; Anjum,18,0,76,58
1657260996088,CSE 3,A50,083646,Miranda; Gregory Joseph,24,0,50,26
1657261002114,CSE 8A,A50,083650,Miranda; Gregory Joseph,17,1,56,39
1657261008138,CSE 11,A01,083080,Cao; Yingjun,5,15,40,35
1657261014163,CSE 12,A01,083652,Krause-Levy; Sophia Louisa,26,1,120,94
1657261020187,CSE 15L,A01,083654,Morris; Justin Loren,9,0,50,41
1657261020187,CSE 15L,A02,083655,Morris; Justin Loren,9,0,50,41
1657261026215,CSE 20,A01,083657,Tran; Khoa Dang,38,0,80,42
1657261032245,CSE 21,A01,095574,Bach; Quang Tran,22,0,48,26
1657261038273,CSE 30,A01,083084,Eldon; John,4,0,80,76
1657261038273,CSE 30,B01,095061,Bhaskar; Nishant,8,0,50,42
1657261044298,CSE 100,A01,083659,Cao; Yingjun,4,4,70,66
1657261050322,CSE 134B,A01,083661,Powell; Thomas Allan,21,0,100,79
1657261056345,CSE 140,A01,083663,Gungor; Onat,13,0,85,72
1657261062376,CSE 140L,A01,083088,Eldon; John,19,0,100,81
1657261068406,CSE 175,A01,083665,Kumar; Rakesh,3,0,25,22
1657261074433,CSE 190,A00,092507,Dubnov; Shlomo,7,0,20,13
1657261080460,ECE 45,A01,083139,Congero; Spencer William,5,0,75,70
1657261086483,ECE 65,A50,083695,Saad; Andrew S,12,0,30,18
1657261086483,ECE 65,A51,095125,Saad; Andrew S,25,0,26,1
1657261092527,ECE 109,A01,091882,Touri; Behrouz,19,0,70,51
1657261098553,ECE 180,A00,083140,Abi Samra; Nicholas Camill,1,0,30,29
1657261098553,ECE 180,B00,083141,Abi Samra; Nicholas Camill,0,0,30,30
1657261104578,MATH 10A,A01,083735,Patchell; Gregory David,2,0,30,28
1657261104578,MATH 10A,A02,083736,Patchell; Gregory David,20,0,30,10
1657261104578,MATH 10A,A03,083737,Patchell; Gregory David,16,0,30,14
1657261110601,MATH 10B,A01,083207,Lim; Seonhee,7,0,34,27
1657261110601,MATH 10B,A02,083208,Lim; Seonhee,9,0,35,26
1657261110601,MATH 10B,A03,093472,Lim; Seonhee,5,0,34,29
1657261110601,MATH 10B,B01,083739,Sinha; Shubham,11,0,30,19
1657261116624,MATH 18,A01,083743,Cinel; Cameron Alexander,6,0,30,24
1657261116624,MATH 18,A02,083744,Cinel; Cameron Alexander,17,0,30,13
1657261116624,MATH 18,A03,083745,Cinel; Cameron Alexander,8,0,30,22
1657261116624,MATH 18,B01,083748,Rideout; David Porter,4,0,37,33
1657261116624,MATH 18,B02,083749,Rideout; David Porter,4,0,36,32
1657261116624,MATH 18,B03,083750,Rideout; David Porter,2,0,37,35
1657261116624,MATH 18,B04,083751,Rideout; David Porter,6,0,36,30
1657261116624,MATH 18,B05,093473,Rideout; David Porter,5,0,36,31
1657261116624,MATH 18,B06,093474,Rideout; David Porter,5,0,36,31
1657261122655,MATH 20A,A01,083754,Zheng; Zequn,14,0,40,26
1657261128679,MATH 20B,A01,083756,Briones; Jor-el Thomas Caparas,3,0,36,33
1657261128679,MATH 20B,A02,083757,Briones; Jor-el Thomas Caparas,1,0,36,35
1657261128679,MATH 20B,A03,093475,Briones; Jor-el Thomas Caparas,2,0,36,34
1657261134776,MATH 20C,A01,083760,Briones; Jor-el Thomas Caparas,1,0,35,34
1657261134776,MATH 20C,A02,083761,Briones; Jor-el Thomas Caparas,8,0,35,27
1657261134776,MATH 20C,A03,093476,Briones; Jor-el Thomas Caparas,0,1,36,36
1657261134776,MATH 20C,B01,083762,Bach; Quang Tran,1,0,30,29
1657261140806,MATH 20D,A01,083765,Tran; Brian Kha,4,0,30,26
1657261140806,MATH 20D,A02,083766,Tran; Brian Kha,5,0,30,25
1657261140806,MATH 20D,A03,083767,Tran; Brian Kha,4,0,30,26
1657261146834,MATH 20E,A01,083771,Ganguly; Soumya,7,0,32,25
1657261146834,MATH 20E,A02,083772,Ganguly; Soumya,7,0,32,25
1657261146834,MATH 20E,B01,083773,Ciotti; Benjamin,19,0,35,16
1657261146834,MATH 20E,B02,083774,Ciotti; Benjamin,17,0,35,18
1657261152858,MATH 103A,A01,083777,Greenfeld; Be'Eri,3,0,36,33
1657261152858,MATH 103A,A02,083778,Greenfeld; Be'Eri,5,0,36,31
1657261152858,MATH 103A,A03,093561,Greenfeld; Be'Eri,4,0,36,32
1657261152858,MATH 103A,B01,083779,Greenfeld; Be'Eri,6,0,36,30
1657261152858,MATH 103A,B02,083780,Greenfeld; Be'Eri,3,0,36,33
1657261152858,MATH 103A,B03,093562,Greenfeld; Be'Eri,3,0,36,33
1657261158882,MATH 105,A01,085443,Carter; Anne Toulson,15,0,35,20
1657261158882,MATH 105,A02,093477,Carter; Anne Toulson,20,0,35,15
1657261164907,MATH 109,A01,083213,Ganzberger; Geoffrey Michael,2,0,34,32
1657261164907,MATH 109,A02,083214,Ganzberger; Geoffrey Michael,4,0,34,30
1657261164907,MATH 109,A03,093478,Ganzberger; Geoffrey Michael,2,0,34,32
1657261164907,MATH 109,B01,083215,Ganzberger; Geoffrey Michael,1,0,32,31
1657261164907,MATH 109,B02,083216,Ganzberger; Geoffrey Michael,1,0,32,31
1657261164907,MATH 109,B03,093479,Ganzberger; Geoffrey Michael,8,0,32,24
1657261170936,MATH 142A,A01,083219,Chow; Bennett,7,0,32,25
1657261170936,MATH 142A,A02,083220,Chow; Bennett,10,0,32,22
1657261170936,MATH 142A,A03,093480,Chow; Bennett,7,0,32,25
1657261170936,MATH 142A,B03,093481,Chow; Bennett,8,0,32,24
1657261170936,MATH 142A,B04,093558,Chow; Bennett,12,0,32,20
1657261170936,MATH 142A,B05,093559,Chow; Bennett,6,0,32,26
1657261176963,MATH 193A,A01,083224,Rotar; Vladimir,7,0,34,27
1657261176963,MATH 193A,A02,083225,Rotar; Vladimir,6,0,34,28
1657261176963,MATH 193A,A03,083781,Rotar; Vladimir,2,0,34,32
1657261176963,MATH 193A,A04,083782,Rotar; Vladimir,8,0,34,26
1657261176963,MATH 193A,A05,093482,Rotar; Vladimir,6,0,34,28
1657261182986,MATH 197,001,091859,McAuley; Julian John,9999,0,9999,0
1657261182986,MATH 197,002,095566,Kedlaya; Kiran S.,9997,0,9999,2
1657261182986,MATH 197,003,095567,Xiao; Ming,9999,0,9999,0
1657261182986,MATH 197,004,095571,Perols; Johan Lars,9998,0,9999,1
1657261190049,COGS 9,A01,083615,Shannon; Kyle Michael,8,0,75,67
1657261196079,COGS 11,A01,083617,Boyle; Mary E. T.,22,0,48,26
1657261202104,COGS 13,A01,083071,Bastos; Amalia Pinkusfeld,9,0,71,62
1657261208127,COGS 14A,A01,092681,Semenuks; Arturs,2,1,100,98
1657261214154,COGS 14B,A01,083073,Cheng; Tzu-Han,6,0,63,57
1657261220181,COGS 17,A01,092677,Semenuks; Arturs,5,0,81,76
1657261226203,COGS 100,A01,083619,Allen; Michael Gordon,16,0,70,54
1657261232226,COGS 101A,A01,083621,Davis; Joshua Daniel,9,0,68,59
1657261238251,COGS 101B,A01,091572,Allen; Michael Gordon,11,0,65,54
1657261244281,COGS 101C,A01,083625,Delgado; Tania,17,0,35,18
1657261250314,COGS 107A,A01,083627,Boyle; Mary E. T.,13,0,60,47
1657261256337,COGS 118A,A01,083075,Gupta; Anjum,18,0,76,58
1657261262361,CSE 3,A50,083646,Miranda; Gregory Joseph,24,0,50,26
1657261268384,CSE 8A,A50,083650,Miranda; Gregory Joseph,17,1,56,39
1657261274411,CSE 11,A01,083080,Cao; Yingjun,5,15,40,35
1657261280435,CSE 12,A01,083652,Krause-Levy; Sophia Louisa,26,1,120,94
1657261286458,CSE 15L,A01,083654,Morris; Justin Loren,9,0,50,41
1657261286458,CSE 15L,A02,083655,Morris; Justin Loren,9,0,50,41
1657261292483,CSE 20,A01,083657,Tran; Khoa Dang,38,0,80,42
1657261298510,CSE 21,A01,095574,Bach; Quang Tran,22,0,48,26
1657261304539,CSE 30,A01,083084,Eldon; John,4,0,80,76
1657261304539,CSE 30,B01,095061,Bhaskar; Nishant,8,0,50,42
1657261310562,CSE 100,A01,083659,Cao; Yingjun,4,4,70,66
1657261316601,CSE 134B,A01,083661,Powell; Thomas Allan,21,0,100,79
1657261322626,CSE 140,A01,083663,Gungor; Onat,13,0,85,72
1657261328650,CSE 140L,A01,083088,Eldon; John,19,0,100,81
1657261334673,CSE 175,A01,083665,Kumar; Rakesh,3,0,25,22
1657261340697,CSE 190,A00,092507,Dubnov; Shlomo,7,0,20,13
1657261346721,ECE 45,A01,083139,Congero; Spencer William,5,0,75,70
1657261352745,ECE 65,A50,083695,Saad; Andrew S,12,0,30,18
1657261352745,ECE 65,A51,095125,Saad; Andrew S,25,0,26,1
1657261358769,ECE 109,A01,091882,Touri; Behrouz,19,0,70,51
1657261364793,ECE 180,A00,083140,Abi Samra; Nicholas Camill,1,0,30,29
1657261364793,ECE 180,B00,083141,Abi Samra; Nicholas Camill,0,0,30,30
1657261370822,MATH 10A,A01,083735,Patchell; Gregory David,2,0,30,28
1657261370822,MATH 10A,A02,083736,Patchell; Gregory David,20,0,30,10
1657261370822,MATH 10A,A03,083737,Patchell; Gregory David,16,0,30,14
1657261376852,MATH 10B,A01,083207,Lim; Seonhee,7,0,34,27
1657261376852,MATH 10B,A02,083208,Lim; Seonhee,9,0,35,26
1657261376852,MATH 10B,A03,093472,Lim; Seonhee,5,0,34,29
1657261376852,MATH 10B,B01,083739,Sinha; Shubham,11,0,30,19
1657261382888,MATH 18,A01,083743,Cinel; Cameron Alexander,6,0,30,24
1657261382888,MATH 18,A02,083744,Cinel; Cameron Alexander,17,0,30,13
1657261382888,MATH 18,A03,083745,Cinel; Cameron Alexander,8,0,30,22
1657261382888,MATH 18,B01,083748,Rideout; David Porter,4,0,37,33
1657261382888,MATH 18,B02,083749,Rideout; David Porter,4,0,36,32
1657261382888,MATH 18,B03,083750,Rideout; David Porter,2,0,37,35
1657261382888,MATH 18,B04,083751,Rideout; David Porter,6,0,36,30
1657261382888,MATH 18,B05,093473,Rideout; David Porter,5,0,36,31
1657261382888,MATH 18,B06,093474,Rideout; David Porter,5,0,36,31
1657261388911,MATH 20A,A01,083754,Zheng; Zequn,14,0,40,26
1657261394938,MATH 20B,A01,083756,Briones; Jor-el Thomas Caparas,3,0,36,33
1657261394938,MATH 20B,A02,083757,Briones; Jor-el Thomas Caparas,1,0,36,35
1657261394938,MATH 20B,A03,093475,Briones; Jor-el Thomas Caparas,2,0,36,34
1657261400967,MATH 20C,A01,083760,Briones; Jor-el Thomas Caparas,1,0,35,34
1657261400967,MATH 20C,A02,083761,Briones; Jor-el Thomas Caparas,8,0,35,27
1657261400967,MATH 20C,A03,093476,Briones; Jor-el Thomas Caparas,0,1,36,36
1657261400967,MATH 20C,B01,083762,Bach; Quang Tran,1,0,30,29
1657261406989,MATH 20D,A01,083765,Tran; Brian Kha,4,0,30,26
1657261406989,MATH 20D,A02,083766,Tran; Brian Kha,5,0,30,25
1657261406989,MATH 20D,A03,083767,Tran; Brian Kha,4,0,30,26
1657261413013,MATH 20E,A01,083771,Ganguly; Soumya,7,0,32,25
1657261413013,MATH 20E,A02,083772,Ganguly; Soumya,7,0,32,25
1657261413013,MATH 20E,B01,083773,Ciotti; Benjamin,19,0,35,16
1657261413013,MATH 20E,B02,083774,Ciotti; Benjamin,17,0,35,18
1657261419040,MATH 103A,A01,083777,Greenfeld; Be'Eri,3,0,36,33
1657261419040,MATH 103A,A02,083778,Greenfeld; Be'Eri,5,0,36,31
1657261419040,MATH 103A,A03,093561,Greenfeld; Be'Eri,4,0,36,32
1657261419040,MATH 103A,B01,083779,Greenfeld; Be'Eri,6,0,36,30
1657261419040,MATH 103A,B02,083780,Greenfeld; Be'Eri,3,0,36,33
1657261419040,MATH 103A,B03,093562,Greenfeld; Be'Eri,3,0,36,33
1657261425071,MATH 105,A01,085443,Carter; Anne Toulson,15,0,35,20
1657261425071,MATH 105,A02,093477,Carter; Anne Toulson,20,0,35,15
1657261431094,MATH 109,A01,083213,Ganzberger; Geoffrey Michael,2,0,34,32
1657261431094,MATH 109,A02,083214,Ganzberger; Geoffrey Michael,4,0,34,30
1657261431094,MATH 109,A03,093478,Ganzberger; Geoffrey Michael,2,0,34,32
1657261431094,MATH 109,B01,083215,Ganzberger; Geoffrey Michael,1,0,32,31
1657261431094,MATH 109,B02,083216,Ganzberger; Geoffrey Michael,1,0,32,31
1657261431094,MATH 109,B03,093479,Ganzberger; Geoffrey Michael,8,0,32,24
1657261437120,MATH 142A,A01,083219,Chow; Bennett,7,0,32,25
1657261437120,MATH 142A,A02,083220,Chow; Bennett,10,0,32,22
1657261437120,MATH 142A,A03,093480,Chow; Bennett,7,0,32,25
1657261437120,MATH 142A,B03,093481,Chow; Bennett,8,0,32,24
1657261437120,MATH 142A,B04,093558,Chow; Bennett,12,0,32,20
1657261437120,MATH 142A,B05,093559,Chow; Bennett,6,0,32,26
1657261443144,MATH 193A,A01,083224,Rotar; Vladimir,7,0,34,27
1657261443144,MATH 193A,A02,083225,Rotar; Vladimir,6,0,34,28
1657261443144,MATH 193A,A03,083781,Rotar; Vladimir,2,0,34,32
1657261443144,MATH 193A,A04,083782,Rotar; Vladimir,8,0,34,26
1657261443144,MATH 193A,A05,093482,Rotar; Vladimir,6,0,34,28
1657261449167,MATH 197,001,091859,McAuley; Julian John,9999,0,9999,0
1657261449167,MATH 197,002,095566,Kedlaya; Kiran S.,9997,0,9999,2
1657261449167,MATH 197,003,095567,Xiao; Ming,9999,0,9999,0
1657261449167,MATH 197,004,095571,Perols; Johan Lars,9998,0,9999,1
1657261456221,COGS 9,A01,083615,Shannon; Kyle Michael,8,0,75,67
1657261462255,COGS 11,A01,083617,Boyle; Mary E. T.,22,0,48,26
1657261468282,COGS 13,A01,083071,Bastos; Amalia Pinkusfeld,9,0,71,62
1657261474306,COGS 14A,A01,092681,Semenuks; Arturs,2,1,100,98
1657261480333,COGS 14B,A01,083073,Cheng; Tzu-Han,6,0,63,57
1657261486362,COGS 17,A01,092677,Semenuks; Arturs,5,0,81,76
1657261492404,COGS 100,A01,083619,Allen; Michael Gordon,16,0,70,54
1657261498431,COGS 101A,A01,083621,Davis; Joshua Daniel,9,0,68,59
1657261504469,COGS 101B,A01,091572,Allen; Michael Gordon,11,0,65,54
1657261510491,COGS 101C,A01,083625,Delgado; Tania,17,0,35,18
1657261516517,COGS 107A,A01,083627,Boyle; Mary E. T.,13,0,60,47
1657261522539,COGS 118A,A01,083075,Gupta; Anjum,18,0,76,58
1657261528561,CSE 3,A50,083646,Miranda; Gregory Joseph,24,0,50,26
1657261534589,CSE 8A,A50,083650,Miranda; Gregory Joseph,17,1,56,39
1657261540612,CSE 11,A01,083080,Cao; Yingjun,5,15,40,35
1657261546649,CSE 12,A01,083652,Krause-Levy; Sophia Louisa,26,1,120,94
1657261552679,CSE 15L,A01,083654,Morris; Justin Loren,9,0,50,41
1657261552679,CSE 15L,A02,083655,Morris; Justin Loren,9,0,50,41
1657261558702,CSE 20,A01,083657,Tran; Khoa Dang,38,0,80,42
1657261564727,CSE 21,A01,095574,Bach; Quang Tran,22,0,48,26
1657261570755,CSE 30,A01,083084,Eldon; John,4,0,80,76
1657261570755,CSE 30,B01,095061,Bhaskar; Nishant,8,0,50,42
1657261576777,CSE 100,A01,083659,Cao; Yingjun,4,4,70,66
1657261582800,CSE 134B,A01,083661,Powell; Thomas Allan,21,0,100,79
1657261588827,CSE 140,A01,083663,Gungor; Onat,13,0,85,72
1657261594849,CSE 140L,A01,083088,Eldon; John,19,0,100,81
1657261600873,CSE 175,A01,083665,Kumar; Rakesh,3,0,25,22
1657261606895,CSE 190,A00,092507,Dubnov; Shlomo,7,0,20,13
1657261612919,ECE 45,A01,083139,Congero; Spencer William,5,0,75,70
1657261618943,ECE 65,A50,083695,Saad; Andrew S,12,0,30,18
1657261618943,ECE 65,A51,095125,Saad; Andrew S,25,0,26,1
1657261624969,ECE 109,A01,091882,Touri; Behrouz,19,0,70,51
1657261631001,ECE 180,A00,083140,Abi Samra; Nicholas Camill,1,0,30,29
1657261631001,ECE 180,B00,083141,Abi Samra; Nicholas Camill,0,0,30,30
1657261637025,MATH 10A,A01,083735,Patchell; Gregory David,2,0,30,28
1657261637025,MATH 10A,A02,083736,Patchell; Gregory David,20,0,30,10
1657261637025,MATH 10A,A03,083737,Patchell; Gregory David,16,0,30,14
1657261643050,MATH 10B,A01,083207,Lim; Seonhee,7,0,34,27
1657261643050,MATH 10B,A02,083208,Lim; Seonhee,9,0,35,26
1657261643050,MATH 10B,A03,093472,Lim; Seonhee,5,0,34,29
1657261643050,MATH 10B,B01,083739,Sinha; Shubham,11,0,30,19
1657261649089,MATH 18,A01,083743,Cinel; Cameron Alexander,6,0,30,24
1657261649089,MATH 18,A02,083744,Cinel; Cameron Alexander,17,0,30,13
1657261649089,MATH 18,A03,083745,Cinel; Cameron Alexander,8,0,30,22
1657261649089,MATH 18,B01,083748,Rideout; David Porter,4,0,37,33
1657261649089,MATH 18,B02,083749,Rideout; David Porter,4,0,36,32
1657261649089,MATH 18,B03,083750,Rideout; David Porter,2,0,37,35
1657261649089,MATH 18,B04,083751,Rideout; David Porter,6,0,36,30
1657261649089,MATH 18,B05,093473,Rideout; David Porter,5,0,36,31
1657261649089,MATH 18,B06,093474,Rideout; David Porter,5,0,36,31
1657261655115,MATH 20A,A01,083754,Zheng; Zequn,14,0,40,26
1657261661139,MATH 20B,A01,083756,Briones; Jor-el Thomas Caparas,3,0,36,33
1657261661139,MATH 20B,A02,083757,Briones; Jor-el Thomas Caparas,1,0,36,35
1657261661139,MATH 20B,A03,093475,Briones; Jor-el Thomas Caparas,2,0,36,34
1657261667163,MATH 20C,A01,083760,Briones; Jor-el Thomas Caparas,1,0,35,34
1657261667163,MATH 20C,A02,083761,Briones; Jor-el Thomas Caparas,8,0,35,27
1657261667163,MATH 20C,A03,093476,Briones; Jor-el Thomas Caparas,0,1,36,36
1657261667163,MATH 20C,B01,083762,Bach; Quang Tran,1,0,30,29
1657261673192,MATH 20D,A01,083765,Tran; Brian Kha,4,0,30,26
1657261673192,MATH 20D,A02,083766,Tran; Brian Kha,5,0,30,25
1657261673192,MATH 20D,A03,083767,Tran; Brian Kha,4,0,30,26
1657261679222,MATH 20E,A01,083771,Ganguly; Soumya,7,0,32,25
1657261679222,MATH 20E,A02,083772,Ganguly; Soumya,7,0,32,25
1657261679222,MATH 20E,B01,083773,Ciotti; Benjamin,19,0,35,16
1657261679222,MATH 20E,B02,083774,Ciotti; Benjamin,17,0,35,18
1657261685246,MATH 103A,A01,083777,Greenfeld; Be'Eri,3,0,36,33
1657261685246,MATH 103A,A02,083778,Greenfeld; Be'Eri,5,0,36,31
1657261685246,MATH 103A,A03,093561,Greenfeld; Be'Eri,4,0,36,32
1657261685246,MATH 103A,B01,083779,Greenfeld; Be'Eri,6,0,36,30
1657261685246,MATH 103A,B02,083780,Greenfeld; Be'Eri,3,0,36,33
1657261685246,MATH 103A,B03,093562,Greenfeld; Be'Eri,3,0,36,33
1657261691275,MATH 105,A01,085443,Carter; Anne Toulson,15,0,35,20
1657261691275,MATH 105,A02,093477,Carter; Anne Toulson,20,0,35,15
1657261697304,MATH 109,A01,083213,Ganzberger; Geoffrey Michael,2,0,34,32
1657261697304,MATH 109,A02,083214,Ganzberger; Geoffrey Michael,4,0,34,30
1657261697304,MATH 109,A03,093478,Ganzberger; Geoffrey Michael,2,0,34,32
1657261697304,MATH 109,B01,083215,Ganzberger; Geoffrey Michael,1,0,32,31
1657261697304,MATH 109,B02,083216,Ganzberger; Geoffrey Michael,1,0,32,31
1657261697304,MATH 109,B03,093479,Ganzberger; Geoffrey Michael,8,0,32,24
1657261703332,MATH 142A,A01,083219,Chow; Bennett,7,0,32,25
1657261703332,MATH 142A,A02,083220,Chow; Bennett,10,0,32,22
1657261703332,MATH 142A,A03,093480,Chow; Bennett,7,0,32,25
1657261703332,MATH 142A,B03,093481,Chow; Bennett,8,0,32,24
1657261703332,MATH 142A,B04,093558,Chow; Bennett,12,0,32,20
1657261703332,MATH 142A,B05,093559,Chow; Bennett,6,0,32,26
1657261709355,MATH 193A,A01,083224,Rotar; Vladimir,7,0,34,27
1657261709355,MATH 193A,A02,083225,Rotar; Vladimir,6,0,34,28
1657261709355,MATH 193A,A03,083781,Rotar; Vladimir,2,0,34,32
1657261709355,MATH 193A,A04,083782,Rotar; Vladimir,8,0,34,26
1657261709355,MATH 193A,A05,093482,Rotar; Vladimir,6,0,34,28
1657261715383,MATH 197,001,091859,McAuley; Julian John,9999,0,9999,0
1657261715383,MATH 197,002,095566,Kedlaya; Kiran S.,9997,0,9999,2
1657261715383,MATH 197,003,095567,Xiao; Ming,9999,0,9999,0
1657261715383,MATH 197,004,095571,Perols; Johan Lars,9998,0,9999,1
1657261722446,COGS 9,A01,083615,Shannon; Kyle Michael,8,0,75,67
1657261728556,COGS 11,A01,083617,Boyle; Mary E. T.,22,0,48,26
1657261734587,COGS 13,A01,083071,Bastos; Amalia Pinkusfeld,9,0,71,62
1657261740615,COGS 14A,A01,092681,Semenuks; Arturs,2,1,100,98
1657261746642,COGS 14B,A01,083073,Cheng; Tzu-Han,6,0,63,57
1657261752664,COGS 17,A01,092677,Semenuks; Arturs,5,0,81,76
1657261758698,COGS 100,A01,083619,Allen; Michael Gordon,16,0,70,54
1657261764727,COGS 101A,A01,083621,Davis; Joshua Daniel,9,0,68,59
1657261770750,COGS 101B,A01,091572,Allen; Michael Gordon,11,0,65,54
1657261776774,COGS 101C,A01,083625,Delgado; Tania,17,0,35,18
1657261782800,COGS 107A,A01,083627,Boyle; Mary E. T.,13,0,60,47
1657261788834,COGS 118A,A01,083075,Gupta; Anjum,18,0,76,58
1657261794879,CSE 3,A50,083646,Miranda; Gregory Joseph,24,0,50,26
1657261800917,CSE 8A,A50,083650,Miranda; Gregory Joseph,17,1,56,39
1657261806939,CSE 11,A01,083080,Cao; Yingjun,5,15,40,35
1657261812962,CSE 12,A01,083652,Krause-Levy; Sophia Louisa,26,1,120,94
1657261818986,CSE 15L,A01,083654,Morris; Justin Loren,9,0,50,41
1657261818986,CSE 15L,A02,083655,Morris; Justin Loren,9,0,50,41
1657261825010,CSE 20,A01,083657,Tran; Khoa Dang,38,0,80,42
1657261831036,CSE 21,A01,095574,Bach; Quang Tran,22,0,48,26
1657261837060,CSE 30,A01,083084,Eldon; John,4,0,80,76
1657261837060,CSE 30,B01,095061,Bhaskar; Nishant,8,0,50,42
1657261843085,CSE 100,A01,083659,Cao; Yingjun,4,4,70,66
1657261849112,CSE 134B,A01,083661,Powell; Thomas Allan,21,0,100,79
1657261855146,CSE 140,A01,083663,Gungor; Onat,13,0,85,72
1657261861172,CSE 140L,A01,083088,Eldon; John,19,0,100,81
1657261867197,CSE 175,A01,083665,Kumar; Rakesh,3,0,25,22
1657261873222,CSE 190,A00,092507,Dubnov; Shlomo,7,0,20,13
1657261879253,ECE 45,A01,083139,Congero; Spencer William,5,0,75,70
1657261885275,ECE 65,A50,083695,Saad; Andrew S,12,0,30,18
1657261885275,ECE 65,A51,095125,Saad; Andrew S,25,0,26,1
1657261891301,ECE 109,A01,091882,Touri; Behrouz,19,0,70,51
1657261897331,ECE 180,A00,083140,Abi Samra; Nicholas Camill,1,0,30,29
1657261897331,ECE 180,B00,083141,Abi Samra; Nicholas Camill,0,0,30,30
1657261903359,MATH 10A,A01,083735,Patchell; Gregory David,2,0,30,28
1657261903359,MATH 10A,A02,083736,Patchell; Gregory David,20,0,30,10
1657261903359,MATH 10A,A03,083737,Patchell; Gregory David,16,0,30,14
1657261909383,MATH 10B,A01,083207,Lim; Seonhee,7,0,34,27
1657261909383,MATH 10B,A02,083208,Lim; Seonhee,9,0,35,26
1657261909383,MATH 10B,A03,093472,Lim; Seonhee,5,0,34,29
1657261909383,MATH 10B,B01,083739,Sinha; Shubham,11,0,30,19
1657261915415,MATH 18,A01,083743,Cinel; Cameron Alexander,6,0,30,24
1657261915415,MATH 18,A02,083744,Cinel; Cameron Alexander,17,0,30,13
1657261915415,MATH 18,A03,083745,Cinel; Cameron Alexander,8,0,30,22
1657261915415,MATH 18,B01,083748,Rideout; David Porter,4,0,37,33
1657261915415,MATH 18,B02,083749,Rideout; David Porter,4,0,36,32
1657261915415,MATH 18,B03,083750,Rideout; David Porter,2,0,37,35
1657261915415,MATH 18,B04,083751,Rideout; David Porter,6,0,36,30
1657261915415,MATH 18,B05,093473,Rideout; David Porter,5,0,36,31
1657261915415,MATH 18,B06,093474,Rideout; David Porter,5,0,36,31
1657261921439,MATH 20A,A01,083754,Zheng; Zequn,14,0,40,26
1657261927467,MATH 20B,A01,083756,Briones; Jor-el Thomas Caparas,3,0,36,33
1657261927467,MATH 20B,A02,083757,Briones; Jor-el Thomas Caparas,1,0,36,35
1657261927467,MATH 20B,A03,093475,Briones; Jor-el Thomas Caparas,2,0,36,34
1657261933491,MATH 20C,A01,083760,Briones; Jor-el Thomas Caparas,1,0,35,34
1657261933491,MATH 20C,A02,083761,Briones; Jor-el Thomas Caparas,8,0,35,27
1657261933491,MATH 20C,A03,093476,Briones; Jor-el Thomas Caparas,0,1,36,36
1657261933491,MATH 20C,B01,083762,Bach; Quang Tran,1,0,30,29
1657261939518,MATH 20D,A01,083765,Tran; Brian Kha,4,0,30,26
1657261939518,MATH 20D,A02,083766,Tran; Brian Kha,5,0,30,25
1657261939518,MATH 20D,A03,083767,Tran; Brian Kha,4,0,30,26
1657261945542,MATH 20E,A01,083771,Ganguly; Soumya,7,0,32,25
1657261945542,MATH 20E,A02,083772,Ganguly; Soumya,7,0,32,25
1657261945542,MATH 20E,B01,083773,Ciotti; Benjamin,19,0,35,16
1657261945542,MATH 20E,B02,083774,Ciotti; Benjamin,17,0,35,18
1657261951572,MATH 103A,A01,083777,Greenfeld; Be'Eri,3,0,36,33
1657261951572,MATH 103A,A02,083778,Greenfeld; Be'Eri,5,0,36,31
1657261951572,MATH 103A,A03,093561,Greenfeld; Be'Eri,4,0,36,32
1657261951572,MATH 103A,B01,083779,Greenfeld; Be'Eri,6,0,36,30
1657261951572,MATH 103A,B02,083780,Greenfeld; Be'Eri,3,0,36,33
1657261951572,MATH 103A,B03,093562,Greenfeld; Be'Eri,3,0,36,33
1657261957594,MATH 105,A01,085443,Carter; Anne Toulson,15,0,35,20
1657261957594,MATH 105,A02,093477,Carter; Anne Toulson,20,0,35,15
1657261963624,MATH 109,A01,083213,Ganzberger; Geoffrey Michael,2,0,34,32
1657261963624,MATH 109,A02,083214,Ganzberger; Geoffrey Michael,4,0,34,30
1657261963624,MATH 109,A03,093478,Ganzberger; Geoffrey Michael,2,0,34,32
1657261963624,MATH 109,B01,083215,Ganzberger; Geoffrey Michael,1,0,32,31
1657261963624,MATH 109,B02,083216,Ganzberger; Geoffrey Michael,1,0,32,31
1657261963624,MATH 109,B03,093479,Ganzberger; Geoffrey Michael,8,0,32,24
1657261969654,MATH 142A,A01,083219,Chow; Bennett,7,0,32,25
1657261969654,MATH 142A,A02,083220,Chow; Bennett,10,0,32,22
1657261969654,MATH 142A,A03,093480,Chow; Bennett,7,0,32,25
1657261969654,MATH 142A,B03,093481,Chow; Bennett,8,0,32,24
1657261969654,MATH 142A,B04,093558,Chow; Bennett,12,0,32,20
1657261969654,MATH 142A,B05,093559,Chow; Bennett,6,0,32,26
1657261975681,MATH 193A,A01,083224,Rotar; Vladimir,7,0,34,27
1657261975681,MATH 193A,A02,083225,Rotar; Vladimir,6,0,34,28
1657261975681,MATH 193A,A03,083781,Rotar; Vladimir,2,0,34,32
1657261975681,MATH 193A,A04,083782,Rotar; Vladimir,8,0,34,26
1657261975681,MATH 193A,A05,093482,Rotar; Vladimir,6,0,34,28
1657261981708,MATH 197,001,091859,McAuley; Julian John,9999,0,9999,0
1657261981708,MATH 197,002,095566,Kedlaya; Kiran S.,9997,0,9999,2
1657261981708,MATH 197,003,095567,Xiao; Ming,9999,0,9999,0
1657261981708,MATH 197,004,095571,Perols; Johan Lars,9998,0,9999,1
1657261988768,COGS 9,A01,083615,Shannon; Kyle Michael,8,0,75,67
1657261994795,COGS 11,A01,083617,Boyle; Mary E. T.,22,0,48,26
1657262000822,COGS 13,A01,083071,Bastos; Amalia Pinkusfeld,9,0,71,62
1657262006846,COGS 14A,A01,092681,Semenuks; Arturs,2,1,100,98
1657262012873,COGS 14B,A01,083073,Cheng; Tzu-Han,6,0,63,57
1657262018895,COGS 17,A01,092677,Semenuks; Arturs,5,0,81,76
1657262024923,COGS 100,A01,083619,Allen; Michael Gordon,16,0,70,54
1657262030945,COGS 101A,A01,083621,Davis; Joshua Daniel,9,0,68,59
1657262036969,COGS 101B,A01,091572,Allen; Michael Gordon,11,0,65,54
1657262042996,COGS 101C,A01,083625,Delgado; Tania,17,0,35,18
1657262049020,COGS 107A,A01,083627,Boyle; Mary E. T.,13,0,60,47
1657262055043,COGS 118A,A01,083075,Gupta; Anjum,18,0,76,58
1657262061067,CSE 3,A50,083646,Miranda; Gregory Joseph,24,0,50,26
1657262067092,CSE 8A,A50,083650,Miranda; Gregory Joseph,17,1,56,39
1657262073119,CSE 11,A01,083080,Cao; Yingjun,5,15,40,35
1657262079144,CSE 12,A01,083652,Krause-Levy; Sophia Louisa,26,1,120,94
1657262085171,CSE 15L,A01,083654,Morris; Justin Loren,9,0,50,41
1657262085171,CSE 15L,A02,083655,Morris; Justin Loren,9,0,50,41
1657262091199,CSE 20,A01,083657,Tran; Khoa Dang,38,0,80,42
1657262097225,CSE 21,A01,095574,Bach; Quang Tran,22,0,48,26
1657262103251,CSE 30,A01,083084,Eldon; John,4,0,80,76
1657262103251,CSE 30,B01,095061,Bhaskar; Nishant,8,0,50,42
1657262109280,CSE 100,A01,083659,Cao; Yingjun,4,4,70,66
1657262115304,CSE 134B,A01,083661,Powell; Thomas Allan,21,0,100,79
1657262121343,CSE 140,A01,083663,Gungor; Onat,13,0,85,72
1657262127366,CSE 140L,A01,083088,Eldon; John,19,0,100,81
1657262133389,CSE 175,A01,083665,Kumar; Rakesh,3,0,25,22
1657262139416,CSE 190,A00,092507,Dubnov; Shlomo,7,0,20,13
1657262145440,ECE 45,A01,083139,Congero; Spencer William,5,0,75,70
1657262151463,ECE 65,A50,083695,Saad; Andrew S,12,0,30,18
1657262151463,ECE 65,A51,095125,Saad; Andrew S,25,0,26,1
1657262157488,ECE 109,A01,091882,Touri; Behrouz,19,0,70,51
1657262163512,ECE 180,A00,083140,Abi Samra; Nicholas Camill,1,0,30,29
1657262163512,ECE 180,B00,083141,Abi Samra; Nicholas Camill,0,0,30,30
1657262169537,MATH 10A,A01,083735,Patchell; Gregory David,2,0,30,28
1657262169537,MATH 10A,A02,083736,Patchell; Gregory David,20,0,30,10
1657262169537,MATH 10A,A03,083737,Patchell; Gregory David,16,0,30,14
1657262175562,MATH 10B,A01,083207,Lim; Seonhee,7,0,34,27
1657262175562,MATH 10B,A02,083208,Lim; Seonhee,9,0,35,26
1657262175562,MATH 10B,A03,093472,Lim; Seonhee,5,0,34,29
1657262175562,MATH 10B,B01,083739,Sinha; Shubham,11,0,30,19
1657262181597,MATH 18,A01,083743,Cinel; Cameron Alexander,6,0,30,24
1657262181597,MATH 18,A02,083744,Cinel; Cameron Alexander,17,0,30,13
1657262181597,MATH 18,A03,083745,Cinel; Cameron Alexander,8,0,30,22
1657262181597,MATH 18,B01,083748,Rideout; David Porter,4,0,37,33
1657262181597,MATH 18,B02,083749,Rideout; David Porter,4,0,36,32
1657262181597,MATH 18,B03,083750,Rideout; David Porter,2,0,37,35
1657262181597,MATH 18,B04,083751,Rideout; David Porter,6,0,36,30
1657262181597,MATH 18,B05,093473,Rideout; David Porter,5,0,36,31
1657262181597,MATH 18,B06,093474,Rideout; David Porter,5,0,36,31
1657262187632,MATH 20A,A01,083754,Zheng; Zequn,14,0,40,26
1657262193656,MATH 20B,A01,083756,Briones; Jor-el Thomas Caparas,3,0,36,33
1657262193656,MATH 20B,A02,083757,Briones; Jor-el Thomas Caparas,1,0,36,35
1657262193656,MATH 20B,A03,093475,Briones; Jor-el Thomas Caparas,2,0,36,34
1657262199680,MATH 20C,A01,083760,Briones; Jor-el Thomas Caparas,1,0,35,34
1657262199680,MATH 20C,A02,083761,Briones; Jor-el Thomas Caparas,8,0,35,27
1657262199680,MATH 20C,A03,093476,Briones; Jor-el Thomas Caparas,0,1,36,36
1657262199680,MATH 20C,B01,083762,Bach; Quang Tran,1,0,30,29
1657262205703,MATH 20D,A01,083765,Tran; Brian Kha,4,0,30,26
1657262205703,MATH 20D,A02,083766,Tran; Brian Kha,5,0,30,25
1657262205703,MATH 20D,A03,083767,Tran; Brian Kha,4,0,30,26
1657262211729,MATH 20E,A01,083771,Ganguly; Soumya,7,0,32,25
1657262211729,MATH 20E,A02,083772,Ganguly; Soumya,7,0,32,25
1657262211729,MATH 20E,B01,083773,Ciotti; Benjamin,19,0,35,16
1657262211729,MATH 20E,B02,083774,Ciotti; Benjamin,17,0,35,18
1657262217752,MATH 103A,A01,083777,Greenfeld; Be'Eri,3,0,36,33
1657262217752,MATH 103A,A02,083778,Greenfeld; Be'Eri,5,0,36,31
1657262217752,MATH 103A,A03,093561,Greenfeld; Be'Eri,4,0,36,32
1657262217752,MATH 103A,B01,083779,Greenfeld; Be'Eri,6,0,36,30
1657262217752,MATH 103A,B02,083780,Greenfeld; Be'Eri,3,0,36,33
1657262217752,MATH 103A,B03,093562,Greenfeld; Be'Eri,3,0,36,33
1657262223777,MATH 105,A01,085443,Carter; Anne Toulson,15,0,35,20
1657262223777,MATH 105,A02,093477,Carter; Anne Toulson,20,0,35,15
1657262229801,MATH 109,A01,083213,Ganzberger; Geoffrey Michael,2,0,34,32
1657262229801,MATH 109,A02,083214,Ganzberger; Geoffrey Michael,4,0,34,30
1657262229801,MATH 109,A03,093478,Ganzberger; Geoffrey Michael,2,0,34,32
1657262229801,MATH 109,B01,083215,Ganzberger; Geoffrey Michael,1,0,32,31
1657262229801,MATH 109,B02,083216,Ganzberger; Geoffrey Michael,1,0,32,31
1657262229801,MATH 109,B03,093479,Ganzberger; Geoffrey Michael,8,0,32,24
1657262235824,MATH 142A,A01,083219,Chow; Bennett,7,0,32,25
1657262235824,MATH 142A,A02,083220,Chow; Bennett,10,0,32,22
1657262235824,MATH 142A,A03,093480,Chow; Bennett,7,0,32,25
1657262235824,MATH 142A,B03,093481,Chow; Bennett,8,0,32,24
1657262235824,MATH 142A,B04,093558,Chow; Bennett,12,0,32,20
1657262235824,MATH 142A,B05,093559,Chow; Bennett,6,0,32,26
1657262241849,MATH 193A,A01,083224,Rotar; Vladimir,7,0,34,27
1657262241849,MATH 193A,A02,083225,Rotar; Vladimir,6,0,34,28
1657262241849,MATH 193A,A03,083781,Rotar; Vladimir,2,0,34,32
1657262241849,MATH 193A,A04,083782,Rotar; Vladimir,8,0,34,26
1657262241849,MATH 193A,A05,093482,Rotar; Vladimir,6,0,34,28
1657262247873,MATH 197,001,091859,McAuley; Julian John,9999,0,9999,0
1657262247873,MATH 197,002,095566,Kedlaya; Kiran S.,9997,0,9999,2
1657262247873,MATH 197,003,095567,Xiao; Ming,9999,0,9999,0
1657262247873,MATH 197,004,095571,Perols; Johan Lars,9998,0,9999,1
1657262254935,COGS 9,A01,083615,Shannon; Kyle Michael,8,0,75,67
1657262260959,COGS 11,A01,083617,Boyle; Mary E. T.,22,0,48,26
1657262266993,COGS 13,A01,083071,Bastos; Amalia Pinkusfeld,9,0,71,62
1657262273023,COGS 14A,A01,092681,Semenuks; Arturs,2,1,100,98
1657262279047,COGS 14B,A01,083073,Cheng; Tzu-Han,6,0,63,57
1657262285076,COGS 17,A01,092677,Semenuks; Arturs,5,0,81,76
1657262291099,COGS 100,A01,083619,Allen; Michael Gordon,16,0,70,54
1657262297125,COGS 101A,A01,083621,Davis; Joshua Daniel,9,0,68,59
1657262303149,COGS 101B,A01,091572,Allen; Michael Gordon,11,0,65,54
1657262309172,COGS 101C,A01,083625,Delgado; Tania,17,0,35,18
1657262315199,COGS 107A,A01,083627,Boyle; Mary E. T.,13,0,60,47
1657262321226,COGS 118A,A01,083075,Gupta; Anjum,18,0,76,58
1657262327345,CSE 3,A50,083646,Miranda; Gregory Joseph,24,0,50,26
1657262333373,CSE 8A,A50,083650,Miranda; Gregory Joseph,17,1,56,39
1657262339397,CSE 11,A01,083080,Cao; Yingjun,5,15,40,35
1657262345434,CSE 12,A01,083652,Krause-Levy; Sophia Louisa,26,1,120,94
1657262351457,CSE 15L,A01,083654,Morris; Justin Loren,9,0,50,41
1657262351457,CSE 15L,A02,083655,Morris; Justin Loren,9,0,50,41
1657262357484,CSE 20,A01,083657,Tran; Khoa Dang,38,0,80,42
1657262363509,CSE 21,A01,095574,Bach; Quang Tran,22,0,48,26
1657262369533,CSE 30,A01,083084,Eldon; John,4,0,80,76
1657262369533,CSE 30,B01,095061,Bhaskar; Nishant,8,0,50,42
1657262375565,CSE 100,A01,083659,Cao; Yingjun,4,4,70,66
1657262381588,CSE 134B,A01,083661,Powell; Thomas Allan,21,0,100,79
1657262387617,CSE 140,A01,083663,Gungor; Onat,13,0,85,72
1657262393639,CSE 140L,A01,083088,Eldon; John,19,0,100,81
1657262399666,CSE 175,A01,083665,Kumar; Rakesh,3,0,25,22
1657262405689,CSE 190,A00,092507,Dubnov; Shlomo,7,0,20,13
1657262411717,ECE 45,A01,083139,Congero; Spencer William,5,0,75,70
1657262417743,ECE 65,A50,083695,Saad; Andrew S,12,0,30,18
1657262417743,ECE 65,A51,095125,Saad; Andrew S,25,0,26,1
1657262423767,ECE 109,A01,091882,Touri; Behrouz,19,0,70,51
1657262429795,ECE 180,A00,083140,Abi Samra; Nicholas Camill,1,0,30,29
1657262429795,ECE 180,B00,083141,Abi Samra; Nicholas Camill,0,0,30,30
1657262435818,MATH 10A,A01,083735,Patchell; Gregory David,2,0,30,28
1657262435818,MATH 10A,A02,083736,Patchell; Gregory David,20,0,30,10
1657262435818,MATH 10A,A03,083737,Patchell; Gregory David,16,0,30,14
1657262441846,MATH 10B,A01,083207,Lim; Seonhee,7,0,34,27
1657262441846,MATH 10B,A02,083208,Lim; Seonhee,9,0,35,26
1657262441846,MATH 10B,A03,093472,Lim; Seonhee,5,0,34,29
1657262441846,MATH 10B,B01,083739,Sinha; Shubham,11,0,30,19
1657262447872,MATH 18,A01,083743,Cinel; Cameron Alexander,6,0,30,24
1657262447872,MATH 18,A02,083744,Cinel; Cameron Alexander,17,0,30,13
1657262447872,MATH 18,A03,083745,Cinel; Cameron Alexander,8,0,30,22
1657262447872,MATH 18,B01,083748,Rideout; David Porter,4,0,37,33
1657262447872,MATH 18,B02,083749,Rideout; David Porter,4,0,36,32
1657262447872,MATH 18,B03,083750,Rideout; David Porter,2,0,37,35
1657262447872,MATH 18,B04,083751,Rideout; David Porter,6,0,36,30
1657262447872,MATH 18,B05,093473,Rideout; David Porter,5,0,36,31
1657262447872,MATH 18,B06,093474,Rideout; David Porter,5,0,36,31
1657262453905,MATH 20A,A01,083754,Zheng; Zequn,14,0,40,26
1657262459928,MATH 20B,A01,083756,Briones; Jor-el Thomas Caparas,3,0,36,33
1657262459928,MATH 20B,A02,083757,Briones; Jor-el Thomas Caparas,1,0,36,35
1657262459928,MATH 20B,A03,093475,Briones; Jor-el Thomas Caparas,2,0,36,34
1657262465950,MATH 20C,A01,083760,Briones; Jor-el Thomas Caparas,1,0,35,34
1657262465950,MATH 20C,A02,083761,Briones; Jor-el Thomas Caparas,8,0,35,27
1657262465950,MATH 20C,A03,093476,Briones; Jor-el Thomas Caparas,0,1,36,36
1657262465950,MATH 20C,B01,083762,Bach; Quang Tran,1,0,30,29
1657262471981,MATH 20D,A01,083765,Tran; Brian Kha,4,0,30,26
1657262471981,MATH 20D,A02,083766,Tran; Brian Kha,5,0,30,25
1657262471981,MATH 20D,A03,083767,Tran; Brian Kha,4,0,30,26
1657262478007,MATH 20E,A01,083771,Ganguly; Soumya,7,0,32,25
1657262478007,MATH 20E,A02,083772,Ganguly; Soumya,7,0,32,25
1657262478007,MATH 20E,B01,083773,Ciotti; Benjamin,19,0,35,16
1657262478007,MATH 20E,B02,083774,Ciotti; Benjamin,17,0,35,18
1657262484030,MATH 103A,A01,083777,Greenfeld; Be'Eri,3,0,36,33
1657262484030,MATH 103A,A02,083778,Greenfeld; Be'Eri,5,0,36,31
1657262484030,MATH 103A,A03,093561,Greenfeld; Be'Eri,4,0,36,32
1657262484030,MATH 103A,B01,083779,Greenfeld; Be'Eri,6,0,36,30
1657262484030,MATH 103A,B02,083780,Greenfeld; Be'Eri,3,0,36,33
1657262484030,MATH 103A,B03,093562,Greenfeld; Be'Eri,3,0,36,33
1657262490052,MATH 105,A01,085443,Carter; Anne Toulson,15,0,35,20
1657262490052,MATH 105,A02,093477,Carter; Anne Toulson,20,0,35,15
1657262496076,MATH 109,A01,083213,Ganzberger; Geoffrey Michael,2,0,34,32
1657262496076,MATH 109,A02,083214,Ganzberger; Geoffrey Michael,4,0,34,30
1657262496076,MATH 109,A03,093478,Ganzberger; Geoffrey Michael,2,0,34,32
1657262496076,MATH 109,B01,083215,Ganzberger; Geoffrey Michael,1,0,32,31
1657262496076,MATH 109,B02,083216,Ganzberger; Geoffrey Michael,1,0,32,31
1657262496076,MATH 109,B03,093479,Ganzberger; Geoffrey Michael,8,0,32,24
1657262502106,MATH 142A,A01,083219,Chow; Bennett,7,0,32,25
1657262502106,MATH 142A,A02,083220,Chow; Bennett,10,0,32,22
1657262502106,MATH 142A,A03,093480,Chow; Bennett,7,0,32,25
1657262502106,MATH 142A,B03,093481,Chow; Bennett,8,0,32,24
1657262502106,MATH 142A,B04,093558,Chow; Bennett,12,0,32,20
1657262502106,MATH 142A,B05,093559,Chow; Bennett,6,0,32,26
1657262508134,MATH 193A,A01,083224,Rotar; Vladimir,7,0,34,27
1657262508134,MATH 193A,A02,083225,Rotar; Vladimir,6,0,34,28
1657262508134,MATH 193A,A03,083781,Rotar; Vladimir,2,0,34,32
1657262508134,MATH 193A,A04,083782,Rotar; Vladimir,8,0,34,26
1657262508134,MATH 193A,A05,093482,Rotar; Vladimir,6,0,34,28
1657262514160,MATH 197,001,091859,McAuley; Julian John,9999,0,9999,0
1657262514160,MATH 197,002,095566,Kedlaya; Kiran S.,9997,0,9999,2
1657262514160,MATH 197,003,095567,Xiao; Ming,9999,0,9999,0
1657262514160,MATH 197,004,095571,Perols; Johan Lars,9998,0,9999,1
1657262521214,COGS 9,A01,083615,Shannon; Kyle Michael,8,0,75,67
1657262527241,COGS 11,A01,083617,Boyle; Mary E. T.,22,0,48,26
1657262533268,COGS 13,A01,083071,Bastos; Amalia Pinkusfeld,9,0,71,62
1657262539295,COGS 14A,A01,092681,Semenuks; Arturs,2,1,100,98
1657262545318,COGS 14B,A01,083073,Cheng; Tzu-Han,6,0,63,57
1657262551345,COGS 17,A01,092677,Semenuks; Arturs,5,0,81,76
1657262557369,COGS 100,A01,083619,Allen; Michael Gordon,16,0,70,54
1657262563394,COGS 101A,A01,083621,Davis; Joshua Daniel,9,0,68,59
1657262569419,COGS 101B,A01,091572,Allen; Michael Gordon,11,0,65,54
1657262575441,COGS 101C,A01,083625,Delgado; Tania,17,0,35,18
1657262581466,COGS 107A,A01,083627,Boyle; Mary E. T.,13,0,60,47
1657262587493,COGS 118A,A01,083075,Gupta; Anjum,18,0,76,58
1657262593519,CSE 3,A50,083646,Miranda; Gregory Joseph,24,0,50,26
1657262599541,CSE 8A,A50,083650,Miranda; Gregory Joseph,17,1,56,39
1657262605567,CSE 11,A01,083080,Cao; Yingjun,5,15,40,35
1657262611592,CSE 12,A01,083652,Krause-Levy; Sophia Louisa,26,1,120,94
1657262617615,CSE 15L,A01,083654,Morris; Justin Loren,9,0,50,41
1657262617615,CSE 15L,A02,083655,Morris; Justin Loren,9,0,50,41
1657262623637,CSE 20,A01,083657,Tran; Khoa Dang,38,0,80,42
1657262629660,CSE 21,A01,095574,Bach; Quang Tran,22,0,48,26
1657262635683,CSE 30,A01,083084,Eldon; John,4,0,80,76
1657262635683,CSE 30,B01,095061,Bhaskar; Nishant,8,0,50,42
1657262641713,CSE 100,A01,083659,Cao; Yingjun,4,4,70,66
1657262647745,CSE 134B,A01,083661,Powell; Thomas Allan,21,0,100,79
1657262653769,CSE 140,A01,083663,Gungor; Onat,13,0,85,72
1657262659800,CSE 140L,A01,083088,Eldon; John,19,0,100,81
1657262665828,CSE 175,A01,083665,Kumar; Rakesh,3,0,25,22
1657262671888,CSE 190,A00,092507,Dubnov; Shlomo,7,0,20,13
1657262677915,ECE 45,A01,083139,Congero; Spencer William,5,0,75,70
1657262683938,ECE 65,A50,083695,Saad; Andrew S,12,0,30,18
1657262683938,ECE 65,A51,095125,Saad; Andrew S,25,0,26,1
1657262689965,ECE 109,A01,091882,Touri; Behrouz,19,0,70,51
1657262695990,ECE 180,A00,083140,Abi Samra; Nicholas Camill,1,0,30,29
1657262695990,ECE 180,B00,083141,Abi Samra; Nicholas Camill,0,0,30,30
1657262702019,MATH 10A,A01,083735,Patchell; Gregory David,2,0,30,28
1657262702019,MATH 10A,A02,083736,Patchell; Gregory David,20,0,30,10
1657262702019,MATH 10A,A03,083737,Patchell; Gregory David,16,0,30,14
1657262708051,MATH 10B,A01,083207,Lim; Seonhee,7,0,34,27
1657262708051,MATH 10B,A02,083208,Lim; Seonhee,9,0,35,26
1657262708051,MATH 10B,A03,093472,Lim; Seonhee,5,0,34,29
1657262708051,MATH 10B,B01,083739,Sinha; Shubham,11,0,30,19
1657262714077,MATH 18,A01,083743,Cinel; Cameron Alexander,6,0,30,24
1657262714077,MATH 18,A02,083744,Cinel; Cameron Alexander,17,0,30,13
1657262714077,MATH 18,A03,083745,Cinel; Cameron Alexander,8,0,30,22
1657262714077,MATH 18,B01,083748,Rideout; David Porter,4,0,37,33
1657262714077,MATH 18,B02,083749,Rideout; David Porter,4,0,36,32
1657262714077,MATH 18,B03,083750,Rideout; David Porter,2,0,37,35
1657262714077,MATH 18,B04,083751,Rideout; David Porter,6,0,36,30
1657262714077,MATH 18,B05,093473,Rideout; David Porter,5,0,36,31
1657262714077,MATH 18,B06,093474,Rideout; David Porter,5,0,36,31
1657262720100,MATH 20A,A01,083754,Zheng; Zequn,14,0,40,26
1657262726122,MATH 20B,A01,083756,Briones; Jor-el Thomas Caparas,3,0,36,33
1657262726122,MATH 20B,A02,083757,Briones; Jor-el Thomas Caparas,1,0,36,35
1657262726122,MATH 20B,A03,093475,Briones; Jor-el Thomas Caparas,2,0,36,34
1657262732144,MATH 20C,A01,083760,Briones; Jor-el Thomas Caparas,1,0,35,34
1657262732144,MATH 20C,A02,083761,Briones; Jor-el Thomas Caparas,8,0,35,27
1657262732144,MATH 20C,A03,093476,Briones; Jor-el Thomas Caparas,0,1,36,36
1657262732144,MATH 20C,B01,083762,Bach; Quang Tran,1,0,30,29
1657262738167,MATH 20D,A01,083765,Tran; Brian Kha,4,0,30,26
1657262738167,MATH 20D,A02,083766,Tran; Brian Kha,5,0,30,25
1657262738167,MATH 20D,A03,083767,Tran; Brian Kha,4,0,30,26
1657262744194,MATH 20E,A01,083771,Ganguly; Soumya,7,0,32,25
1657262744194,MATH 20E,A02,083772,Ganguly; Soumya,7,0,32,25
1657262744194,MATH 20E,B01,083773,Ciotti; Benjamin,19,0,35,16
1657262744194,MATH 20E,B02,083774,Ciotti; Benjamin,17,0,35,18
1657262750220,MATH 103A,A01,083777,Greenfeld; Be'Eri,3,0,36,33
1657262750220,MATH 103A,A02,083778,Greenfeld; Be'Eri,5,0,36,31
1657262750220,MATH 103A,A03,093561,Greenfeld; Be'Eri,4,0,36,32
1657262750220,MATH 103A,B01,083779,Greenfeld; Be'Eri,6,0,36,30
1657262750220,MATH 103A,B02,083780,Greenfeld; Be'Eri,3,0,36,33
1657262750220,MATH 103A,B03,093562,Greenfeld; Be'Eri,3,0,36,33
1657262756244,MATH 105,A01,085443,Carter; Anne Toulson,15,0,35,20
1657262756244,MATH 105,A02,093477,Carter; Anne Toulson,20,0,35,15
1657262762269,MATH 109,A01,083213,Ganzberger; Geoffrey Michael,2,0,34,32
1657262762269,MATH 109,A02,083214,Ganzberger; Geoffrey Michael,4,0,34,30
1657262762269,MATH 109,A03,093478,Ganzberger; Geoffrey Michael,2,0,34,32
1657262762269,MATH 109,B01,083215,Ganzberger; Geoffrey Michael,1,0,32,31
1657262762269,MATH 109,B02,083216,Ganzberger; Geoffrey Michael,1,0,32,31
1657262762269,MATH 109,B03,093479,Ganzberger; Geoffrey Michael,8,0,32,24
1657262768294,MATH 142A,A01,083219,Chow; Bennett,7,0,32,25
1657262768294,MATH 142A,A02,083220,Chow; Bennett,10,0,32,22
1657262768294,MATH 142A,A03,093480,Chow; Bennett,7,0,32,25
1657262768294,MATH 142A,B03,093481,Chow; Bennett,8,0,32,24
1657262768294,MATH 142A,B04,093558,Chow; Bennett,12,0,32,20
1657262768294,MATH 142A,B05,093559,Chow; Bennett,6,0,32,26
1657262774319,MATH 193A,A01,083224,Rotar; Vladimir,7,0,34,27
1657262774319,MATH 193A,A02,083225,Rotar; Vladimir,6,0,34,28
1657262774319,MATH 193A,A03,083781,Rotar; Vladimir,2,0,34,32
1657262774319,MATH 193A,A04,083782,Rotar; Vladimir,8,0,34,26
1657262774319,MATH 193A,A05,093482,Rotar; Vladimir,6,0,34,28
1657262780346,MATH 197,001,091859,McAuley; Julian John,9999,0,9999,0
1657262780346,MATH 197,002,095566,Kedlaya; Kiran S.,9997,0,9999,2
1657262780346,MATH 197,003,095567,Xiao; Ming,9999,0,9999,0
1657262780346,MATH 197,004,095571,Perols; Johan Lars,9998,0,9999,1
1657262787399,COGS 9,A01,083615,Shannon; Kyle Michael,8,0,75,67
1657262793424,COGS 11,A01,083617,Boyle; Mary E. T.,22,0,48,26
1657262799445,COGS 13,A01,083071,Bastos; Amalia Pinkusfeld,9,0,71,62
1657262805473,COGS 14A,A01,092681,Semenuks; Arturs,2,1,100,98
1657262811497,COGS 14B,A01,083073,Cheng; Tzu-Han,6,0,63,57
1657262817520,COGS 17,A01,092677,Semenuks; Arturs,5,0,81,76
1657262823546,COGS 100,A01,083619,Allen; Michael Gordon,16,0,70,54
1657262829570,COGS 101A,A01,083621,Davis; Joshua Daniel,9,0,68,59
1657262835593,COGS 101B,A01,091572,Allen; Michael Gordon,11,0,65,54
1657262841621,COGS 101C,A01,083625,Delgado; Tania,17,0,35,18
1657262847644,COGS 107A,A01,083627,Boyle; Mary E. T.,13,0,60,47
1657262853668,COGS 118A,A01,083075,Gupta; Anjum,18,0,76,58
1657262859695,CSE 3,A50,083646,Miranda; Gregory Joseph,24,0,50,26
1657262865725,CSE 8A,A50,083650,Miranda; Gregory Joseph,17,1,56,39
1657262871748,CSE 11,A01,083080,Cao; Yingjun,5,15,40,35
1657262877774,CSE 12,A01,083652,Krause-Levy; Sophia Louisa,26,1,120,94
1657262883798,CSE 15L,A01,083654,Morris; Justin Loren,9,0,50,41
1657262883798,CSE 15L,A02,083655,Morris; Justin Loren,9,0,50,41
1657262889823,CSE 20,A01,083657,Tran; Khoa Dang,38,0,80,42
1657262895849,CSE 21,A01,095574,Bach; Quang Tran,22,0,48,26
1657262901877,CSE 30,A01,083084,Eldon; John,4,0,80,76
1657262901877,CSE 30,B01,095061,Bhaskar; Nishant,8,0,50,42
1657262907901,CSE 100,A01,083659,Cao; Yingjun,4,4,70,66
1657262913925,CSE 134B,A01,083661,Powell; Thomas Allan,21,0,100,79
1657262919948,CSE 140,A01,083663,Gungor; Onat,13,0,85,72
1657262926070,CSE 140L,A01,083088,Eldon; John,19,0,100,81
1657262932099,CSE 175,A01,083665,Kumar; Rakesh,3,0,25,22
1657262938122,CSE 190,A00,092507,Dubnov; Shlomo,7,0,20,13
1657262944146,ECE 45,A01,083139,Congero; Spencer William,5,0,75,70
1657262950175,ECE 65,A50,083695,Saad; Andrew S,12,0,30,18
1657262950175,ECE 65,A51,095125,Saad; Andrew S,25,0,26,1
1657262956198,ECE 109,A01,091882,Touri; Behrouz,19,0,70,51
1657262962222,ECE 180,A00,083140,Abi Samra; Nicholas Camill,1,0,30,29
1657262962222,ECE 180,B00,083141,Abi Samra; Nicholas Camill,0,0,30,30
1657262968250,MATH 10A,A01,083735,Patchell; Gregory David,2,0,30,28
1657262968250,MATH 10A,A02,083736,Patchell; Gregory David,20,0,30,10
1657262968250,MATH 10A,A03,083737,Patchell; Gregory David,16,0,30,14
1657262974274,MATH 10B,A01,083207,Lim; Seonhee,7,0,34,27
1657262974274,MATH 10B,A02,083208,Lim; Seonhee,9,0,35,26
1657262974274,MATH 10B,A03,093472,Lim; Seonhee,5,0,34,29
1657262974274,MATH 10B,B01,083739,Sinha; Shubham,11,0,30,19
1657262980306,MATH 18,A01,083743,Cinel; Cameron Alexander,6,0,30,24
1657262980306,MATH 18,A02,083744,Cinel; Cameron Alexander,17,0,30,13
1657262980306,MATH 18,A03,083745,Cinel; Cameron Alexander,8,0,30,22
1657262980306,MATH 18,B01,083748,Rideout; David Porter,4,0,37,33
1657262980306,MATH 18,B02,083749,Rideout; David Porter,4,0,36,32
1657262980306,MATH 18,B03,083750,Rideout; David Porter,2,0,37,35
1657262980306,MATH 18,B04,083751,Rideout; David Porter,6,0,36,30
1657262980306,MATH 18,B05,093473,Rideout; David Porter,5,0,36,31
1657262980306,MATH 18,B06,093474,Rideout; David Porter,5,0,36,31
1657262986332,MATH 20A,A01,083754,Zheng; Zequn,14,0,40,26
1657262992360,MATH 20B,A01,083756,Briones; Jor-el Thomas Caparas,3,0,36,33
1657262992360,MATH 20B,A02,083757,Briones; Jor-el Thomas Caparas,1,0,36,35
1657262992360,MATH 20B,A03,093475,Briones; Jor-el Thomas Caparas,2,0,36,34
1657262998385,MATH 20C,A01,083760,Briones; Jor-el Thomas Caparas,1,0,35,34
1657262998385,MATH 20C,A02,083761,Briones; Jor-el Thomas Caparas,8,0,35,27
1657262998385,MATH 20C,A03,093476,Briones; Jor-el Thomas Caparas,0,1,36,36
1657262998385,MATH 20C,B01,083762,Bach; Quang Tran,1,0,30,29
1657263004413,MATH 20D,A01,083765,Tran; Brian Kha,4,0,30,26
1657263004413,MATH 20D,A02,083766,Tran; Brian Kha,5,0,30,25
1657263004413,MATH 20D,A03,083767,Tran; Brian Kha,4,0,30,26
1657263010442,MATH 20E,A01,083771,Ganguly; Soumya,7,0,32,25
1657263010442,MATH 20E,A02,083772,Ganguly; Soumya,7,0,32,25
1657263010442,MATH 20E,B01,083773,Ciotti; Benjamin,19,0,35,16
1657263010442,MATH 20E,B02,083774,Ciotti; Benjamin,17,0,35,18
1657263016471,MATH 103A,A01,083777,Greenfeld; Be'Eri,3,0,36,33
1657263016471,MATH 103A,A02,083778,Greenfeld; Be'Eri,5,0,36,31
1657263016471,MATH 103A,A03,093561,Greenfeld; Be'Eri,4,0,36,32
1657263016471,MATH 103A,B01,083779,Greenfeld; Be'Eri,6,0,36,30
1657263016471,MATH 103A,B02,083780,Greenfeld; Be'Eri,3,0,36,33
1657263016471,MATH 103A,B03,093562,Greenfeld; Be'Eri,3,0,36,33
1657263022493,MATH 105,A01,085443,Carter; Anne Toulson,15,0,35,20
1657263022493,MATH 105,A02,093477,Carter; Anne Toulson,20,0,35,15
1657263028517,MATH 109,A01,083213,Ganzberger; Geoffrey Michael,2,0,34,32
1657263028517,MATH 109,A02,083214,Ganzberger; Geoffrey Michael,4,0,34,30
1657263028517,MATH 109,A03,093478,Ganzberger; Geoffrey Michael,2,0,34,32
1657263028517,MATH 109,B01,083215,Ganzberger; Geoffrey Michael,1,0,32,31
1657263028517,MATH 109,B02,083216,Ganzberger; Geoffrey Michael,1,0,32,31
1657263028517,MATH 109,B03,093479,Ganzberger; Geoffrey Michael,8,0,32,24
1657263034539,MATH 142A,A01,083219,Chow; Bennett,7,0,32,25
1657263034539,MATH 142A,A02,083220,Chow; Bennett,10,0,32,22
1657263034539,MATH 142A,A03,093480,Chow; Bennett,7,0,32,25
1657263034539,MATH 142A,B03,093481,Chow; Bennett,8,0,32,24
1657263034539,MATH 142A,B04,093558,Chow; Bennett,12,0,32,20
1657263034539,MATH 142A,B05,093559,Chow; Bennett,6,0,32,26
1657263040574,MATH 193A,A01,083224,Rotar; Vladimir,7,0,34,27
1657263040574,MATH 193A,A02,083225,Rotar; Vladimir,6,0,34,28
1657263040574,MATH 193A,A03,083781,Rotar; Vladimir,2,0,34,32
1657263040574,MATH 193A,A04,083782,Rotar; Vladimir,8,0,34,26
1657263040574,MATH 193A,A05,093482,Rotar; Vladimir,6,0,34,28
1657263046596,MATH 197,001,091859,McAuley; Julian John,9999,0,9999,0
1657263046596,MATH 197,002,095566,Kedlaya; Kiran S.,9997,0,9999,2
1657263046596,MATH 197,003,095567,Xiao; Ming,9999,0,9999,0
1657263046596,MATH 197,004,095571,Perols; Johan Lars,9998,0,9999,1
1657263053657,COGS 9,A01,083615,Shannon; Kyle Michael,8,0,75,67
1657263059680,COGS 11,A01,083617,Boyle; Mary E. T.,22,0,48,26
1657263065702,COGS 13,A01,083071,Bastos; Amalia Pinkusfeld,9,0,71,62
1657263071725,COGS 14A,A01,092681,Semenuks; Arturs,2,1,100,98
1657263077753,COGS 14B,A01,083073,Cheng; Tzu-Han,6,0,63,57
1657263083775,COGS 17,A01,092677,Semenuks; Arturs,5,0,81,76
1657263089799,COGS 100,A01,083619,Allen; Michael Gordon,16,0,70,54
1657263095826,COGS 101A,A01,083621,Davis; Joshua Daniel,9,0,68,59
1657263101861,COGS 101B,A01,091572,Allen; Michael Gordon,11,0,65,54
1657263107889,COGS 101C,A01,083625,Delgado; Tania,17,0,35,18
1657263113922,COGS 107A,A01,083627,Boyle; Mary E. T.,13,0,60,47
1657263119947,COGS 118A,A01,083075,Gupta; Anjum,18,0,76,58
1657263125970,CSE 3,A50,083646,Miranda; Gregory Joseph,24,0,50,26
1657263131994,CSE 8A,A50,083650,Miranda; Gregory Joseph,17,1,56,39
1657263138019,CSE 11,A01,083080,Cao; Yingjun,5,15,40,35
1657263144042,CSE 12,A01,083652,Krause-Levy; Sophia Louisa,26,1,120,94
1657263150069,CSE 15L,A01,083654,Morris; Justin Loren,9,0,50,41
1657263150069,CSE 15L,A02,083655,Morris; Justin Loren,9,0,50,41
1657263156093,CSE 20,A01,083657,Tran; Khoa Dang,38,0,80,42
1657263162117,CSE 21,A01,095574,Bach; Quang Tran,22,0,48,26
1657263168144,CSE 30,A01,083084,Eldon; John,4,0,80,76
1657263168144,CSE 30,B01,095061,Bhaskar; Nishant,8,0,50,42
1657263174171,CSE 100,A01,083659,Cao; Yingjun,4,4,70,66
1657263180197,CSE 134B,A01,083661,Powell; Thomas Allan,21,0,100,79
1657263186219,CSE 140,A01,083663,Gungor; Onat,13,0,85,72
1657263192242,CSE 140L,A01,083088,Eldon; John,19,0,100,81
1657263198265,CSE 175,A01,083665,Kumar; Rakesh,3,0,25,22
1657263204291,CSE 190,A00,092507,Dubnov; Shlomo,7,0,20,13
1657263210313,ECE 45,A01,083139,Congero; Spencer William,5,0,75,70
1657263216339,ECE 65,A50,083695,Saad; Andrew S,12,0,30,18
1657263216339,ECE 65,A51,095125,Saad; Andrew S,25,0,26,1
1657263222362,ECE 109,A01,091882,Touri; Behrouz,19,0,70,51
1657263228385,ECE 180,A00,083140,Abi Samra; Nicholas Camill,1,0,30,29
1657263228385,ECE 180,B00,083141,Abi Samra; Nicholas Camill,0,0,30,30
1657263234412,MATH 10A,A01,083735,Patchell; Gregory David,2,0,30,28
1657263234412,MATH 10A,A02,083736,Patchell; Gregory David,20,0,30,10
1657263234412,MATH 10A,A03,083737,Patchell; Gregory David,16,0,30,14
1657263240442,MATH 10B,A01,083207,Lim; Seonhee,7,0,34,27
1657263240442,MATH 10B,A02,083208,Lim; Seonhee,9,0,35,26
1657263240442,MATH 10B,A03,093472,Lim; Seonhee,5,0,34,29
1657263240442,MATH 10B,B01,083739,Sinha; Shubham,11,0,30,19
1657263246472,MATH 18,A01,083743,Cinel; Cameron Alexander,6,0,30,24
1657263246472,MATH 18,A02,083744,Cinel; Cameron Alexander,17,0,30,13
1657263246472,MATH 18,A03,083745,Cinel; Cameron Alexander,8,0,30,22
1657263246472,MATH 18,B01,083748,Rideout; David Porter,4,0,37,33
1657263246472,MATH 18,B02,083749,Rideout; David Porter,4,0,36,32
1657263246472,MATH 18,B03,083750,Rideout; David Porter,2,0,37,35
1657263246472,MATH 18,B04,083751,Rideout; David Porter,6,0,36,30
1657263246472,MATH 18,B05,093473,Rideout; David Porter,5,0,36,31
1657263246472,MATH 18,B06,093474,Rideout; David Porter,5,0,36,31
1657263252499,MATH 20A,A01,083754,Zheng; Zequn,14,0,40,26
1657263258525,MATH 20B,A01,083756,Briones; Jor-el Thomas Caparas,3,0,36,33
1657263258525,MATH 20B,A02,083757,Briones; Jor-el Thomas Caparas,1,0,36,35
1657263258525,MATH 20B,A03,093475,Briones; Jor-el Thomas Caparas,2,0,36,34
1657263264555,MATH 20C,A01,083760,Briones; Jor-el Thomas Caparas,1,0,35,34
1657263264555,MATH 20C,A02,083761,Briones; Jor-el Thomas Caparas,8,0,35,27
1657263264555,MATH 20C,A03,093476,Briones; Jor-el Thomas Caparas,0,1,36,36
1657263264555,MATH 20C,B01,083762,Bach; Quang Tran,1,0,30,29
1657263270579,MATH 20D,A01,083765,Tran; Brian Kha,4,0,30,26
1657263270579,MATH 20D,A02,083766,Tran; Brian Kha,5,0,30,25
1657263270579,MATH 20D,A03,083767,Tran; Brian Kha,4,0,30,26
1657263276608,MATH 20E,A01,083771,Ganguly; Soumya,7,0,32,25
1657263276608,MATH 20E,A02,083772,Ganguly; Soumya,7,0,32,25
1657263276608,MATH 20E,B01,083773,Ciotti; Benjamin,19,0,35,16
1657263276608,MATH 20E,B02,083774,Ciotti; Benjamin,17,0,35,18
1657263282637,MATH 103A,A01,083777,Greenfeld; Be'Eri,3,0,36,33
1657263282637,MATH 103A,A02,083778,Greenfeld; Be'Eri,5,0,36,31
1657263282637,MATH 103A,A03,093561,Greenfeld; Be'Eri,4,0,36,32
1657263282637,MATH 103A,B01,083779,Greenfeld; Be'Eri,6,0,36,30
1657263282637,MATH 103A,B02,083780,Greenfeld; Be'Eri,3,0,36,33
1657263282637,MATH 103A,B03,093562,Greenfeld; Be'Eri,3,0,36,33
1657263288660,MATH 105,A01,085443,Carter; Anne Toulson,15,0,35,20
1657263288660,MATH 105,A02,093477,Carter; Anne Toulson,20,0,35,15
1657263294684,MATH 109,A01,083213,Ganzberger; Geoffrey Michael,2,0,34,32
1657263294684,MATH 109,A02,083214,Ganzberger; Geoffrey Michael,4,0,34,30
1657263294684,MATH 109,A03,093478,Ganzberger; Geoffrey Michael,2,0,34,32
1657263294684,MATH 109,B01,083215,Ganzberger; Geoffrey Michael,1,0,32,31
1657263294684,MATH 109,B02,083216,Ganzberger; Geoffrey Michael,1,0,32,31
1657263294684,MATH 109,B03,093479,Ganzberger; Geoffrey Michael,8,0,32,24
1657263300709,MATH 142A,A01,083219,Chow; Bennett,7,0,32,25
1657263300709,MATH 142A,A02,083220,Chow; Bennett,10,0,32,22
1657263300709,MATH 142A,A03,093480,Chow; Bennett,7,0,32,25
1657263300709,MATH 142A,B03,093481,Chow; Bennett,8,0,32,24
1657263300709,MATH 142A,B04,093558,Chow; Bennett,12,0,32,20
1657263300709,MATH 142A,B05,093559,Chow; Bennett,6,0,32,26
1657263306736,MATH 193A,A01,083224,Rotar; Vladimir,7,0,34,27
1657263306736,MATH 193A,A02,083225,Rotar; Vladimir,6,0,34,28
1657263306736,MATH 193A,A03,083781,Rotar; Vladimir,2,0,34,32
1657263306736,MATH 193A,A04,083782,Rotar; Vladimir,8,0,34,26
1657263306736,MATH 193A,A05,093482,Rotar; Vladimir,6,0,34,28
1657263312762,MATH 197,001,091859,McAuley; Julian John,9999,0,9999,0
1657263312762,MATH 197,002,095566,Kedlaya; Kiran S.,9997,0,9999,2
1657263312762,MATH 197,003,095567,Xiao; Ming,9999,0,9999,0
1657263312762,MATH 197,004,095571,Perols; Johan Lars,9998,0,9999,1
1657263319818,COGS 9,A01,083615,Shannon; Kyle Michael,8,0,75,67
1657263325851,COGS 11,A01,083617,Boyle; Mary E. T.,22,0,48,26
1657263331878,COGS 13,A01,083071,Bastos; Amalia Pinkusfeld,9,0,71,62
1657263337899,COGS 14A,A01,092681,Semenuks; Arturs,2,1,100,98
1657263343923,COGS 14B,A01,083073,Cheng; Tzu-Han,6,0,63,57
1657263349946,COGS 17,A01,092677,Semenuks; Arturs,5,0,81,76
1657263355968,COGS 100,A01,083619,Allen; Michael Gordon,16,0,70,54
1657263361992,COGS 101A,A01,083621,Davis; Joshua Daniel,9,0,68,59
1657263368015,COGS 101B,A01,091572,Allen; Michael Gordon,11,0,65,54
1657263374042,COGS 101C,A01,083625,Delgado; Tania,17,0,35,18
1657263380070,COGS 107A,A01,083627,Boyle; Mary E. T.,13,0,60,47
1657263386092,COGS 118A,A01,083075,Gupta; Anjum,18,0,76,58
1657263392115,CSE 3,A50,083646,Miranda; Gregory Joseph,24,0,50,26
1657263398142,CSE 8A,A50,083650,Miranda; Gregory Joseph,17,1,56,39
1657263404166,CSE 11,A01,083080,Cao; Yingjun,5,15,40,35
1657263410202,CSE 12,A01,083652,Krause-Levy; Sophia Louisa,26,1,120,94
1657263416227,CSE 15L,A01,083654,Morris; Justin Loren,9,0,50,41
1657263416227,CSE 15L,A02,083655,Morris; Justin Loren,9,0,50,41
1657263422251,CSE 20,A01,083657,Tran; Khoa Dang,38,0,80,42
1657263428280,CSE 21,A01,095574,Bach; Quang Tran,22,0,48,26
1657263434304,CSE 30,A01,083084,Eldon; John,4,0,80,76
1657263434304,CSE 30,B01,095061,Bhaskar; Nishant,8,0,50,42
1657263440331,CSE 100,A01,083659,Cao; Yingjun,4,4,70,66
1657263446357,CSE 134B,A01,083661,Powell; Thomas Allan,21,0,100,79
1657263452380,CSE 140,A01,083663,Gungor; Onat,13,0,85,72
1657263458403,CSE 140L,A01,083088,Eldon; John,19,0,100,81
1657263464428,CSE 175,A01,083665,Kumar; Rakesh,3,0,25,22
1657263470453,CSE 190,A00,092507,Dubnov; Shlomo,7,0,20,13
1657263476476,ECE 45,A01,083139,Congero; Spencer William,5,0,75,70
1657263482524,ECE 65,A50,083695,Saad; Andrew S,12,0,30,18
1657263482524,ECE 65,A51,095125,Saad; Andrew S,25,0,26,1
1657263488547,ECE 109,A01,091882,Touri; Behrouz,19,0,70,51
1657263494578,ECE 180,A00,083140,Abi Samra; Nicholas Camill,1,0,30,29
1657263494578,ECE 180,B00,083141,Abi Samra; Nicholas Camill,0,0,30,30
1657263500601,MATH 10A,A01,083735,Patchell; Gregory David,2,0,30,28
1657263500601,MATH 10A,A02,083736,Patchell; Gregory David,20,0,30,10
1657263500601,MATH 10A,A03,083737,Patchell; Gregory David,16,0,30,14
1657263506626,MATH 10B,A01,083207,Lim; Seonhee,7,0,34,27
1657263506626,MATH 10B,A02,083208,Lim; Seonhee,9,0,35,26
1657263506626,MATH 10B,A03,093472,Lim; Seonhee,5,0,34,29
1657263506626,MATH 10B,B01,083739,Sinha; Shubham,11,0,30,19
1657263512657,MATH 18,A01,083743,Cinel; Cameron Alexander,6,0,30,24
1657263512657,MATH 18,A02,083744,Cinel; Cameron Alexander,17,0,30,13
1657263512657,MATH 18,A03,083745,Cinel; Cameron Alexander,8,0,30,22
1657263512657,MATH 18,B01,083748,Rideout; David Porter,4,0,37,33
1657263512657,MATH 18,B02,083749,Rideout; David Porter,4,0,36,32
1657263512657,MATH 18,B03,083750,Rideout; David Porter,2,0,37,35
1657263512657,MATH 18,B04,083751,Rideout; David Porter,6,0,36,30
1657263512657,MATH 18,B05,093473,Rideout; David Porter,5,0,36,31
1657263512657,MATH 18,B06,093474,Rideout; David Porter,5,0,36,31
1657263518683,MATH 20A,A01,083754,Zheng; Zequn,14,0,40,26
1657263524781,MATH 20B,A01,083756,Briones; Jor-el Thomas Caparas,3,0,36,33
1657263524781,MATH 20B,A02,083757,Briones; Jor-el Thomas Caparas,1,0,36,35
1657263524781,MATH 20B,A03,093475,Briones; Jor-el Thomas Caparas,2,0,36,34
1657263530809,MATH 20C,A01,083760,Briones; Jor-el Thomas Caparas,1,0,35,34
1657263530809,MATH 20C,A02,083761,Briones; Jor-el Thomas Caparas,8,0,35,27
1657263530809,MATH 20C,A03,093476,Briones; Jor-el Thomas Caparas,0,1,36,36
1657263530809,MATH 20C,B01,083762,Bach; Quang Tran,1,0,30,29
1657263536838,MATH 20D,A01,083765,Tran; Brian Kha,4,0,30,26
1657263536838,MATH 20D,A02,083766,Tran; Brian Kha,5,0,30,25
1657263536838,MATH 20D,A03,083767,Tran; Brian Kha,4,0,30,26
1657263542866,MATH 20E,A01,083771,Ganguly; Soumya,7,0,32,25
1657263542866,MATH 20E,A02,083772,Ganguly; Soumya,7,0,32,25
1657263542866,MATH 20E,B01,083773,Ciotti; Benjamin,19,0,35,16
1657263542866,MATH 20E,B02,083774,Ciotti; Benjamin,17,0,35,18
1657263548890,MATH 103A,A01,083777,Greenfeld; Be'Eri,3,0,36,33
1657263548890,MATH 103A,A02,083778,Greenfeld; Be'Eri,5,0,36,31
1657263548890,MATH 103A,A03,093561,Greenfeld; Be'Eri,4,0,36,32
1657263548890,MATH 103A,B01,083779,Greenfeld; Be'Eri,6,0,36,30
1657263548890,MATH 103A,B02,083780,Greenfeld; Be'Eri,3,0,36,33
1657263548890,MATH 103A,B03,093562,Greenfeld; Be'Eri,3,0,36,33
1657263554917,MATH 105,A01,085443,Carter; Anne Toulson,15,0,35,20
1657263554917,MATH 105,A02,093477,Carter; Anne Toulson,20,0,35,15
1657263566425,MATH 109,A01,083213,Ganzberger; Geoffrey Michael,2,0,34,32
1657263566425,MATH 109,A02,083214,Ganzberger; Geoffrey Michael,4,0,34,30
1657263566425,MATH 109,A03,093478,Ganzberger; Geoffrey Michael,2,0,34,32
1657263566425,MATH 109,B01,083215,Ganzberger; Geoffrey Michael,1,0,32,31
1657263566425,MATH 109,B02,083216,Ganzberger; Geoffrey Michael,1,0,32,31
1657263566425,MATH 109,B03,093479,Ganzberger; Geoffrey Michael,8,0,32,24
1657263572455,MATH 142A,A01,083219,Chow; Bennett,7,0,32,25
1657263572455,MATH 142A,A02,083220,Chow; Bennett,10,0,32,22
1657263572455,MATH 142A,A03,093480,Chow; Bennett,7,0,32,25
1657263572455,MATH 142A,B03,093481,Chow; Bennett,8,0,32,24
1657263572455,MATH 142A,B04,093558,Chow; Bennett,12,0,32,20
1657263572455,MATH 142A,B05,093559,Chow; Bennett,6,0,32,26
1657263578478,MATH 193A,A01,083224,Rotar; Vladimir,7,0,34,27
1657263578478,MATH 193A,A02,083225,Rotar; Vladimir,6,0,34,28
1657263578478,MATH 193A,A03,083781,Rotar; Vladimir,2,0,34,32
1657263578478,MATH 193A,A04,083782,Rotar; Vladimir,8,0,34,26
1657263578478,MATH 193A,A05,093482,Rotar; Vladimir,6,0,34,28
1657263584501,MATH 197,001,091859,McAuley; Julian John,9999,0,9999,0
1657263584501,MATH 197,002,095566,Kedlaya; Kiran S.,9997,0,9999,2
1657263584501,MATH 197,003,095567,Xiao; Ming,9999,0,9999,0
1657263584501,MATH 197,004,095571,Perols; Johan Lars,9998,0,9999,1
1657263591566,COGS 9,A01,083615,Shannon; Kyle Michael,8,0,75,67
1657263597596,COGS 11,A01,083617,Boyle; Mary E. T.,22,0,48,26
1657263603623,COGS 13,A01,083071,Bastos; Amalia Pinkusfeld,9,0,71,62
1657263609652,COGS 14A,A01,092681,Semenuks; Arturs,2,1,100,98
1657263615676,COGS 14B,A01,083073,Cheng; Tzu-Han,6,0,63,57
1657263621711,COGS 17,A01,092677,Semenuks; Arturs,5,0,81,76
1657263627734,COGS 100,A01,083619,Allen; Michael Gordon,16,0,70,54
1657263633761,COGS 101A,A01,083621,Davis; Joshua Daniel,9,0,68,59
1657263639788,COGS 101B,A01,091572,Allen; Michael Gordon,11,0,65,54
1657263645810,COGS 101C,A01,083625,Delgado; Tania,17,0,35,18
1657263651833,COGS 107A,A01,083627,Boyle; Mary E. T.,13,0,60,47
1657263657861,COGS 118A,A01,083075,Gupta; Anjum,18,0,76,58
1657263663904,CSE 3,A50,083646,Miranda; Gregory Joseph,24,0,50,26
1657263669928,CSE 8A,A50,083650,Miranda; Gregory Joseph,17,1,56,39
1657263675952,CSE 11,A01,083080,Cao; Yingjun,5,15,40,35
1657263681974,CSE 12,A01,083652,Krause-Levy; Sophia Louisa,26,1,120,94
1657263687999,CSE 15L,A01,083654,Morris; Justin Loren,9,0,50,41
1657263687999,CSE 15L,A02,083655,Morris; Justin Loren,9,0,50,41
1657263694028,CSE 20,A01,083657,Tran; Khoa Dang,38,0,80,42
1657263700056,CSE 21,A01,095574,Bach; Quang Tran,22,0,48,26
1657263706079,CSE 30,A01,083084,Eldon; John,4,0,80,76
1657263706079,CSE 30,B01,095061,Bhaskar; Nishant,8,0,50,42
1657263712109,CSE 100,A01,083659,Cao; Yingjun,4,4,70,66
1657263718133,CSE 134B,A01,083661,Powell; Thomas Allan,21,0,100,79
1657263724163,CSE 140,A01,083663,Gungor; Onat,13,0,85,72
1657263730185,CSE 140L,A01,083088,Eldon; John,19,0,100,81
1657263736216,CSE 175,A01,083665,Kumar; Rakesh,3,0,25,22
1657263742242,CSE 190,A00,092507,Dubnov; Shlomo,7,0,20,13
1657263748265,ECE 45,A01,083139,Congero; Spencer William,5,0,75,70
1657263754290,ECE 65,A50,083695,Saad; Andrew S,12,0,30,18
1657263754290,ECE 65,A51,095125,Saad; Andrew S,25,0,26,1
1657263760315,ECE 109,A01,091882,Touri; Behrouz,19,0,70,51
1657263766338,ECE 180,A00,083140,Abi Samra; Nicholas Camill,1,0,30,29
1657263766338,ECE 180,B00,083141,Abi Samra; Nicholas Camill,0,0,30,30
1657263772362,MATH 10A,A01,083735,Patchell; Gregory David,2,0,30,28
1657263772362,MATH 10A,A02,083736,Patchell; Gregory David,20,0,30,10
1657263772362,MATH 10A,A03,083737,Patchell; Gregory David,16,0,30,14
1657263778394,MATH 10B,A01,083207,Lim; Seonhee,7,0,34,27
1657263778394,MATH 10B,A02,083208,Lim; Seonhee,9,0,35,26
1657263778394,MATH 10B,A03,093472,Lim; Seonhee,5,0,34,29
1657263778394,MATH 10B,B01,083739,Sinha; Shubham,11,0,30,19
1657263784420,MATH 18,A01,083743,Cinel; Cameron Alexander,6,0,30,24
1657263784420,MATH 18,A02,083744,Cinel; Cameron Alexander,17,0,30,13
1657263784420,MATH 18,A03,083745,Cinel; Cameron Alexander,8,0,30,22
1657263784420,MATH 18,B01,083748,Rideout; David Porter,4,0,37,33
1657263784420,MATH 18,B02,083749,Rideout; David Porter,4,0,36,32
1657263784420,MATH 18,B03,083750,Rideout; David Porter,2,0,37,35
1657263784420,MATH 18,B04,083751,Rideout; David Porter,6,0,36,30
1657263784420,MATH 18,B05,093473,Rideout; David Porter,5,0,36,31
1657263784420,MATH 18,B06,093474,Rideout; David Porter,5,0,36,31
1657263790444,MATH 20A,A01,083754,Zheng; Zequn,14,0,40,26
1657263796474,MATH 20B,A01,083756,Briones; Jor-el Thomas Caparas,3,0,36,33
1657263796474,MATH 20B,A02,083757,Briones; Jor-el Thomas Caparas,1,0,36,35
1657263796474,MATH 20B,A03,093475,Briones; Jor-el Thomas Caparas,2,0,36,34
1657263802505,MATH 20C,A01,083760,Briones; Jor-el Thomas Caparas,1,0,35,34
1657263802505,MATH 20C,A02,083761,Briones; Jor-el Thomas Caparas,8,0,35,27
1657263802505,MATH 20C,A03,093476,Briones; Jor-el Thomas Caparas,0,1,36,36
1657263802505,MATH 20C,B01,083762,Bach; Quang Tran,1,0,30,29
1657263808529,MATH 20D,A01,083765,Tran; Brian Kha,4,0,30,26
1657263808529,MATH 20D,A02,083766,Tran; Brian Kha,5,0,30,25
1657263808529,MATH 20D,A03,083767,Tran; Brian Kha,4,0,30,26
1657263814552,MATH 20E,A01,083771,Ganguly; Soumya,7,0,32,25
1657263814552,MATH 20E,A02,083772,Ganguly; Soumya,7,0,32,25
1657263814552,MATH 20E,B01,083773,Ciotti; Benjamin,19,0,35,16
1657263814552,MATH 20E,B02,083774,Ciotti; Benjamin,17,0,35,18
1657263820581,MATH 103A,A01,083777,Greenfeld; Be'Eri,3,0,36,33
1657263820581,MATH 103A,A02,083778,Greenfeld; Be'Eri,5,0,36,31
1657263820581,MATH 103A,A03,093561,Greenfeld; Be'Eri,4,0,36,32
1657263820581,MATH 103A,B01,083779,Greenfeld; Be'Eri,6,0,36,30
1657263820581,MATH 103A,B02,083780,Greenfeld; Be'Eri,3,0,36,33
1657263820581,MATH 103A,B03,093562,Greenfeld; Be'Eri,3,0,36,33
1657263826605,MATH 105,A01,085443,Carter; Anne Toulson,15,0,35,20
1657263826605,MATH 105,A02,093477,Carter; Anne Toulson,20,0,35,15
1657263832630,MATH 109,A01,083213,Ganzberger; Geoffrey Michael,2,0,34,32
1657263832630,MATH 109,A02,083214,Ganzberger; Geoffrey Michael,4,0,34,30
1657263832630,MATH 109,A03,093478,Ganzberger; Geoffrey Michael,2,0,34,32
1657263832630,MATH 109,B01,083215,Ganzberger; Geoffrey Michael,1,0,32,31
1657263832630,MATH 109,B02,083216,Ganzberger; Geoffrey Michael,1,0,32,31
1657263832630,MATH 109,B03,093479,Ganzberger; Geoffrey Michael,8,0,32,24
1657263838662,MATH 142A,A01,083219,Chow; Bennett,7,0,32,25
1657263838662,MATH 142A,A02,083220,Chow; Bennett,10,0,32,22
1657263838662,MATH 142A,A03,093480,Chow; Bennett,7,0,32,25
1657263838662,MATH 142A,B03,093481,Chow; Bennett,8,0,32,24
1657263838662,MATH 142A,B04,093558,Chow; Bennett,12,0,32,20
1657263838662,MATH 142A,B05,093559,Chow; Bennett,6,0,32,26
1657263844685,MATH 193A,A01,083224,Rotar; Vladimir,7,0,34,27
1657263844685,MATH 193A,A02,083225,Rotar; Vladimir,6,0,34,28
1657263844685,MATH 193A,A03,083781,Rotar; Vladimir,2,0,34,32
1657263844685,MATH 193A,A04,083782,Rotar; Vladimir,8,0,34,26
1657263844685,MATH 193A,A05,093482,Rotar; Vladimir,6,0,34,28
1657263850707,MATH 197,001,091859,McAuley; Julian John,9999,0,9999,0
1657263850707,MATH 197,002,095566,Kedlaya; Kiran S.,9997,0,9999,2
1657263850707,MATH 197,003,095567,Xiao; Ming,9999,0,9999,0
1657263850707,MATH 197,004,095571,Perols; Johan Lars,9998,0,9999,1
1657263857774,COGS 9,A01,083615,Shannon; Kyle Michael,8,0,75,67
1657263863798,COGS 11,A01,083617,Boyle; Mary E. T.,22,0,48,26
1657263869820,COGS 13,A01,083071,Bastos; Amalia Pinkusfeld,9,0,71,62
1657263875851,COGS 14A,A01,092681,Semenuks; Arturs,2,1,100,98
1657263881875,COGS 14B,A01,083073,Cheng; Tzu-Han,6,0,63,57
1657263887898,COGS 17,A01,092677,Semenuks; Arturs,5,0,81,76
1657263893927,COGS 100,A01,083619,Allen; Michael Gordon,16,0,70,54
1657263899950,COGS 101A,A01,083621,Davis; Joshua Daniel,9,0,68,59
1657263905979,COGS 101B,A01,091572,Allen; Michael Gordon,11,0,65,54
1657263912001,COGS 101C,A01,083625,Delgado; Tania,17,0,35,18
1657263918025,COGS 107A,A01,083627,Boyle; Mary E. T.,13,0,60,47
1657263924049,COGS 118A,A01,083075,Gupta; Anjum,18,0,76,58
1657263930078,CSE 3,A50,083646,Miranda; Gregory Joseph,24,0,50,26
1657263936106,CSE 8A,A50,083650,Miranda; Gregory Joseph,17,1,56,39
1657263942134,CSE 11,A01,083080,Cao; Yingjun,5,15,40,35
1657263948163,CSE 12,A01,083652,Krause-Levy; Sophia Louisa,26,1,120,94
1657263954185,CSE 15L,A01,083654,Morris; Justin Loren,9,0,50,41
1657263954185,CSE 15L,A02,083655,Morris; Justin Loren,9,0,50,41
1657263960210,CSE 20,A01,083657,Tran; Khoa Dang,38,0,80,42
1657263966234,CSE 21,A01,095574,Bach; Quang Tran,22,0,48,26
1657263972274,CSE 30,A01,083084,Eldon; John,4,0,80,76
1657263972274,CSE 30,B01,095061,Bhaskar; Nishant,8,0,50,42
1657263978297,CSE 100,A01,083659,Cao; Yingjun,4,4,70,66
1657263984335,CSE 134B,A01,083661,Powell; Thomas Allan,21,0,100,79
1657263990359,CSE 140,A01,083663,Gungor; Onat,13,0,85,72
1657263996385,CSE 140L,A01,083088,Eldon; John,19,0,100,81
1657264002408,CSE 175,A01,083665,Kumar; Rakesh,3,0,25,22
1657264008436,CSE 190,A00,092507,Dubnov; Shlomo,7,0,20,13
1657264014460,ECE 45,A01,083139,Congero; Spencer William,5,0,75,70
1657264020490,ECE 65,A50,083695,Saad; Andrew S,12,0,30,18
1657264020490,ECE 65,A51,095125,Saad; Andrew S,25,0,26,1
1657264026520,ECE 109,A01,091882,Touri; Behrouz,19,0,70,51
1657264032543,ECE 180,A00,083140,Abi Samra; Nicholas Camill,1,0,30,29
1657264032543,ECE 180,B00,083141,Abi Samra; Nicholas Camill,0,0,30,30
1657264038570,MATH 10A,A01,083735,Patchell; Gregory David,2,0,30,28
1657264038570,MATH 10A,A02,083736,Patchell; Gregory David,20,0,30,10
1657264038570,MATH 10A,A03,083737,Patchell; Gregory David,16,0,30,14
1657264044600,MATH 10B,A01,083207,Lim; Seonhee,7,0,34,27
1657264044600,MATH 10B,A02,083208,Lim; Seonhee,9,0,35,26
1657264044600,MATH 10B,A03,093472,Lim; Seonhee,5,0,34,29
1657264044600,MATH 10B,B01,083739,Sinha; Shubham,11,0,30,19
1657264050636,MATH 18,A01,083743,Cinel; Cameron Alexander,6,0,30,24
1657264050636,MATH 18,A02,083744,Cinel; Cameron Alexander,17,0,30,13
1657264050636,MATH 18,A03,083745,Cinel; Cameron Alexander,8,0,30,22
1657264050636,MATH 18,B01,083748,Rideout; David Porter,4,0,37,33
1657264050636,MATH 18,B02,083749,Rideout; David Porter,4,0,36,32
1657264050636,MATH 18,B03,083750,Rideout; David Porter,2,0,37,35
1657264050636,MATH 18,B04,083751,Rideout; David Porter,6,0,36,30
1657264050636,MATH 18,B05,093473,Rideout; David Porter,5,0,36,31
1657264050636,MATH 18,B06,093474,Rideout; David Porter,5,0,36,31
1657264056665,MATH 20A,A01,083754,Zheng; Zequn,14,0,40,26
1657264062690,MATH 20B,A01,083756,Briones; Jor-el Thomas Caparas,3,0,36,33
1657264062690,MATH 20B,A02,083757,Briones; Jor-el Thomas Caparas,1,0,36,35
1657264062690,MATH 20B,A03,093475,Briones; Jor-el Thomas Caparas,2,0,36,34
1657264068718,MATH 20C,A01,083760,Briones; Jor-el Thomas Caparas,1,0,35,34
1657264068718,MATH 20C,A02,083761,Briones; Jor-el Thomas Caparas,8,0,35,27
1657264068718,MATH 20C,A03,093476,Briones; Jor-el Thomas Caparas,0,1,36,36
1657264068718,MATH 20C,B01,083762,Bach; Quang Tran,1,0,30,29
1657264074743,MATH 20D,A01,083765,Tran; Brian Kha,4,0,30,26
1657264074743,MATH 20D,A02,083766,Tran; Brian Kha,5,0,30,25
1657264074743,MATH 20D,A03,083767,Tran; Brian Kha,4,0,30,26
1657264080767,MATH 20E,A01,083771,Ganguly; Soumya,7,0,32,25
1657264080767,MATH 20E,A02,083772,Ganguly; Soumya,7,0,32,25
1657264080767,MATH 20E,B01,083773,Ciotti; Benjamin,19,0,35,16
1657264080767,MATH 20E,B02,083774,Ciotti; Benjamin,17,0,35,18
1657264086801,MATH 103A,A01,083777,Greenfeld; Be'Eri,3,0,36,33
1657264086801,MATH 103A,A02,083778,Greenfeld; Be'Eri,5,0,36,31
1657264086801,MATH 103A,A03,093561,Greenfeld; Be'Eri,4,0,36,32
1657264086801,MATH 103A,B01,083779,Greenfeld; Be'Eri,6,0,36,30
1657264086801,MATH 103A,B02,083780,Greenfeld; Be'Eri,3,0,36,33
1657264086801,MATH 103A,B03,093562,Greenfeld; Be'Eri,3,0,36,33
1657264092827,MATH 105,A01,085443,Carter; Anne Toulson,15,0,35,20
1657264092827,MATH 105,A02,093477,Carter; Anne Toulson,20,0,35,15
1657264098850,MATH 109,A01,083213,Ganzberger; Geoffrey Michael,2,0,34,32
1657264098850,MATH 109,A02,083214,Ganzberger; Geoffrey Michael,4,0,34,30
1657264098850,MATH 109,A03,093478,Ganzberger; Geoffrey Michael,2,0,34,32
1657264098850,MATH 109,B01,083215,Ganzberger; Geoffrey Michael,1,0,32,31
1657264098850,MATH 109,B02,083216,Ganzberger; Geoffrey Michael,1,0,32,31
1657264098850,MATH 109,B03,093479,Ganzberger; Geoffrey Michael,8,0,32,24
1657264104887,MATH 142A,A01,083219,Chow; Bennett,7,0,32,25
1657264104887,MATH 142A,A02,083220,Chow; Bennett,10,0,32,22
1657264104887,MATH 142A,A03,093480,Chow; Bennett,7,0,32,25
1657264104887,MATH 142A,B03,093481,Chow; Bennett,8,0,32,24
1657264104887,MATH 142A,B04,093558,Chow; Bennett,12,0,32,20
1657264104887,MATH 142A,B05,093559,Chow; Bennett,6,0,32,26
1657264110910,MATH 193A,A01,083224,Rotar; Vladimir,7,0,34,27
1657264110910,MATH 193A,A02,083225,Rotar; Vladimir,6,0,34,28
1657264110910,MATH 193A,A03,083781,Rotar; Vladimir,2,0,34,32
1657264110910,MATH 193A,A04,083782,Rotar; Vladimir,8,0,34,26
1657264110910,MATH 193A,A05,093482,Rotar; Vladimir,6,0,34,28
1657264116932,MATH 197,001,091859,McAuley; Julian John,9999,0,9999,0
1657264116932,MATH 197,002,095566,Kedlaya; Kiran S.,9997,0,9999,2
1657264116932,MATH 197,003,095567,Xiao; Ming,9999,0,9999,0
1657264116932,MATH 197,004,095571,Perols; Johan Lars,9998,0,9999,1
1657264124091,COGS 9,A01,083615,Shannon; Kyle Michael,8,0,75,67
1657264130115,COGS 11,A01,083617,Boyle; Mary E. T.,22,0,48,26
1657264136138,COGS 13,A01,083071,Bastos; Amalia Pinkusfeld,9,0,71,62
1657264142176,COGS 14A,A01,092681,Semenuks; Arturs,2,1,100,98
1657264148204,COGS 14B,A01,083073,Cheng; Tzu-Han,6,0,63,57
1657264154322,COGS 17,A01,092677,Semenuks; Arturs,5,0,81,76
1657264160351,COGS 100,A01,083619,Allen; Michael Gordon,16,0,70,54
1657264166373,COGS 101A,A01,083621,Davis; Joshua Daniel,9,0,68,59
1657264172401,COGS 101B,A01,091572,Allen; Michael Gordon,11,0,65,54
1657264178429,COGS 101C,A01,083625,Delgado; Tania,17,0,35,18
1657264184459,COGS 107A,A01,083627,Boyle; Mary E. T.,13,0,60,47
1657264190487,COGS 118A,A01,083075,Gupta; Anjum,18,0,76,58
1657264196515,CSE 3,A50,083646,Miranda; Gregory Joseph,24,0,50,26
1657264202540,CSE 8A,A50,083650,Miranda; Gregory Joseph,17,1,56,39
1657264208567,CSE 11,A01,083080,Cao; Yingjun,5,15,40,35
1657264214595,CSE 12,A01,083652,Krause-Levy; Sophia Louisa,26,1,120,94
1657264220627,CSE 15L,A01,083654,Morris; Justin Loren,9,0,50,41
1657264220627,CSE 15L,A02,083655,Morris; Justin Loren,9,0,50,41
1657264226662,CSE 20,A01,083657,Tran; Khoa Dang,38,0,80,42
1657264232684,CSE 21,A01,095574,Bach; Quang Tran,22,0,48,26
1657264238713,CSE 30,A01,083084,Eldon; John,4,0,80,76
1657264238713,CSE 30,B01,095061,Bhaskar; Nishant,8,0,50,42
1657264244738,CSE 100,A01,083659,Cao; Yingjun,4,4,70,66
1657264250771,CSE 134B,A01,083661,Powell; Thomas Allan,21,0,100,79
1657264256797,CSE 140,A01,083663,Gungor; Onat,13,0,85,72
1657264262822,CSE 140L,A01,083088,Eldon; John,19,0,100,81
1657264268851,CSE 175,A01,083665,Kumar; Rakesh,3,0,25,22
1657264274874,CSE 190,A00,092507,Dubnov; Shlomo,7,0,20,13
1657264280903,ECE 45,A01,083139,Congero; Spencer William,5,0,75,70
1657264286932,ECE 65,A50,083695,Saad; Andrew S,12,0,30,18
1657264286932,ECE 65,A51,095125,Saad; Andrew S,25,0,26,1
1657264292964,ECE 109,A01,091882,Touri; Behrouz,19,0,70,51
1657264298995,ECE 180,A00,083140,Abi Samra; Nicholas Camill,1,0,30,29
1657264298995,ECE 180,B00,083141,Abi Samra; Nicholas Camill,0,0,30,30
1657264305026,MATH 10A,A01,083735,Patchell; Gregory David,2,0,30,28
1657264305026,MATH 10A,A02,083736,Patchell; Gregory David,20,0,30,10
1657264305026,MATH 10A,A03,083737,Patchell; Gregory David,16,0,30,14
1657264311048,MATH 10B,A01,083207,Lim; Seonhee,7,0,34,27
1657264311048,MATH 10B,A02,083208,Lim; Seonhee,9,0,35,26
1657264311048,MATH 10B,A03,093472,Lim; Seonhee,5,0,34,29
1657264311048,MATH 10B,B01,083739,Sinha; Shubham,11,0,30,19
1657264317087,MATH 18,A01,083743,Cinel; Cameron Alexander,6,0,30,24
1657264317087,MATH 18,A02,083744,Cinel; Cameron Alexander,17,0,30,13
1657264317087,MATH 18,A03,083745,Cinel; Cameron Alexander,8,0,30,22
1657264317087,MATH 18,B01,083748,Rideout; David Porter,4,0,37,33
1657264317087,MATH 18,B02,083749,Rideout; David Porter,4,0,36,32
1657264317087,MATH 18,B03,083750,Rideout; David Porter,2,0,37,35
1657264317087,MATH 18,B04,083751,Rideout; David Porter,6,0,36,30
1657264317087,MATH 18,B05,093473,Rideout; David Porter,5,0,36,31
1657264317087,MATH 18,B06,093474,Rideout; David Porter,5,0,36,31
1657264323119,MATH 20A,A01,083754,Zheng; Zequn,14,0,40,26
1657264329148,MATH 20B,A01,083756,Briones; Jor-el Thomas Caparas,3,0,36,33
1657264329148,MATH 20B,A02,083757,Briones; Jor-el Thomas Caparas,1,0,36,35
1657264329148,MATH 20B,A03,093475,Briones; Jor-el Thomas Caparas,2,0,36,34
1657264335175,MATH 20C,A01,083760,Briones; Jor-el Thomas Caparas,1,0,35,34
1657264335175,MATH 20C,A02,083761,Briones; Jor-el Thomas Caparas,8,0,35,27
1657264335175,MATH 20C,A03,093476,Briones; Jor-el Thomas Caparas,0,1,36,36
1657264335175,MATH 20C,B01,083762,Bach; Quang Tran,1,0,30,29
1657264341203,MATH 20D,A01,083765,Tran; Brian Kha,4,0,30,26
1657264341203,MATH 20D,A02,083766,Tran; Brian Kha,5,0,30,25
1657264341203,MATH 20D,A03,083767,Tran; Brian Kha,4,0,30,26
1657264347227,MATH 20E,A01,083771,Ganguly; Soumya,7,0,32,25
1657264347227,MATH 20E,A02,083772,Ganguly; Soumya,7,0,32,25
1657264347227,MATH 20E,B01,083773,Ciotti; Benjamin,19,0,35,16
1657264347227,MATH 20E,B02,083774,Ciotti; Benjamin,17,0,35,18
1657264353254,MATH 103A,A01,083777,Greenfeld; Be'Eri,3,0,36,33
1657264353254,MATH 103A,A02,083778,Greenfeld; Be'Eri,5,0,36,31
1657264353254,MATH 103A,A03,093561,Greenfeld; Be'Eri,4,0,36,32
1657264353254,MATH 103A,B01,083779,Greenfeld; Be'Eri,6,0,36,30
1657264353254,MATH 103A,B02,083780,Greenfeld; Be'Eri,3,0,36,33
1657264353254,MATH 103A,B03,093562,Greenfeld; Be'Eri,3,0,36,33
1657264359280,MATH 105,A01,085443,Carter; Anne Toulson,15,0,35,20
1657264359280,MATH 105,A02,093477,Carter; Anne Toulson,20,0,35,15
1657264365306,MATH 109,A01,083213,Ganzberger; Geoffrey Michael,2,0,34,32
1657264365306,MATH 109,A02,083214,Ganzberger; Geoffrey Michael,4,0,34,30
1657264365306,MATH 109,A03,093478,Ganzberger; Geoffrey Michael,2,0,34,32
1657264365306,MATH 109,B01,083215,Ganzberger; Geoffrey Michael,1,0,32,31
1657264365306,MATH 109,B02,083216,Ganzberger; Geoffrey Michael,1,0,32,31
1657264365306,MATH 109,B03,093479,Ganzberger; Geoffrey Michael,8,0,32,24
1657264371336,MATH 142A,A01,083219,Chow; Bennett,7,0,32,25
1657264371336,MATH 142A,A02,083220,Chow; Bennett,10,0,32,22
1657264371336,MATH 142A,A03,093480,Chow; Bennett,7,0,32,25
1657264371336,MATH 142A,B03,093481,Chow; Bennett,8,0,32,24
1657264371336,MATH 142A,B04,093558,Chow; Bennett,12,0,32,20
1657264371336,MATH 142A,B05,093559,Chow; Bennett,6,0,32,26
1657264377373,MATH 193A,A01,083224,Rotar; Vladimir,7,0,34,27
1657264377373,MATH 193A,A02,083225,Rotar; Vladimir,6,0,34,28
1657264377373,MATH 193A,A03,083781,Rotar; Vladimir,2,0,34,32
1657264377373,MATH 193A,A04,083782,Rotar; Vladimir,8,0,34,26
1657264377373,MATH 193A,A05,093482,Rotar; Vladimir,6,0,34,28
1657264383409,MATH 197,001,091859,McAuley; Julian John,9999,0,9999,0
1657264383409,MATH 197,002,095566,Kedlaya; Kiran S.,9997,0,9999,2
1657264383409,MATH 197,003,095567,Xiao; Ming,9999,0,9999,0
1657264383409,MATH 197,004,095571,Perols; Johan Lars,9998,0,9999,1
1657264390467,COGS 9,A01,083615,Shannon; Kyle Michael,8,0,75,67
1657264396506,COGS 11,A01,083617,Boyle; Mary E. T.,22,0,48,26
1657264402531,COGS 13,A01,083071,Bastos; Amalia Pinkusfeld,9,0,71,62
1657264408561,COGS 14A,A01,092681,Semenuks; Arturs,2,1,100,98
1657264414586,COGS 14B,A01,083073,Cheng; Tzu-Han,6,0,63,57
1657264420615,COGS 17,A01,092677,Semenuks; Arturs,5,0,81,76
1657264426644,COGS 100,A01,083619,Allen; Michael Gordon,16,0,70,54
1657264432668,COGS 101A,A01,083621,Davis; Joshua Daniel,9,0,68,59
1657264438700,COGS 101B,A01,091572,Allen; Michael Gordon,11,0,65,54
1657264444724,COGS 101C,A01,083625,Delgado; Tania,17,0,35,18
1657264450753,COGS 107A,A01,083627,Boyle; Mary E. T.,13,0,60,47
1657264456775,COGS 118A,A01,083075,Gupta; Anjum,18,0,76,58
1657264462801,CSE 3,A50,083646,Miranda; Gregory Joseph,24,0,50,26
1657264468833,CSE 8A,A50,083650,Miranda; Gregory Joseph,17,1,56,39
1657264474876,CSE 11,A01,083080,Cao; Yingjun,5,15,40,35
1657264480902,CSE 12,A01,083652,Krause-Levy; Sophia Louisa,26,1,120,94
1657264486927,CSE 15L,A01,083654,Morris; Justin Loren,9,0,50,41
1657264486927,CSE 15L,A02,083655,Morris; Justin Loren,9,0,50,41
1657264492953,CSE 20,A01,083657,Tran; Khoa Dang,38,0,80,42
1657264498976,CSE 21,A01,095574,Bach; Quang Tran,22,0,48,26
1657264505003,CSE 30,A01,083084,Eldon; John,4,0,80,76
1657264505003,CSE 30,B01,095061,Bhaskar; Nishant,8,0,50,42
1657264511041,CSE 100,A01,083659,Cao; Yingjun,4,4,70,66
1657264517072,CSE 134B,A01,083661,Powell; Thomas Allan,21,0,100,79
1657264523097,CSE 140,A01,083663,Gungor; Onat,13,0,85,72
1657264529119,CSE 140L,A01,083088,Eldon; John,19,0,100,81
1657264535142,CSE 175,A01,083665,Kumar; Rakesh,3,0,25,22
1657264541182,CSE 190,A00,092507,Dubnov; Shlomo,7,0,20,13
1657264547217,ECE 45,A01,083139,Congero; Spencer William,5,0,75,70
1657264553258,ECE 65,A50,083695,Saad; Andrew S,12,0,30,18
1657264553258,ECE 65,A51,095125,Saad; Andrew S,25,0,26,1
1657264559282,ECE 109,A01,091882,Touri; Behrouz,19,0,70,51
1657264565327,ECE 180,A00,083140,Abi Samra; Nicholas Camill,1,0,30,29
1657264565327,ECE 180,B00,083141,Abi Samra; Nicholas Camill,0,0,30,30
1657264571353,MATH 10A,A01,083735,Patchell; Gregory David,2,0,30,28
1657264571353,MATH 10A,A02,083736,Patchell; Gregory David,20,0,30,10
1657264571353,MATH 10A,A03,083737,Patchell; Gregory David,16,0,30,14
1657264577380,MATH 10B,A01,083207,Lim; Seonhee,7,0,34,27
1657264577380,MATH 10B,A02,083208,Lim; Seonhee,9,0,35,26
1657264577380,MATH 10B,A03,093472,Lim; Seonhee,5,0,34,29
1657264577380,MATH 10B,B01,083739,Sinha; Shubham,11,0,30,19
1657264583408,MATH 18,A01,083743,Cinel; Cameron Alexander,6,0,30,24
1657264583408,MATH 18,A02,083744,Cinel; Cameron Alexander,17,0,30,13
1657264583408,MATH 18,A03,083745,Cinel; Cameron Alexander,8,0,30,22
1657264583408,MATH 18,B01,083748,Rideout; David Porter,4,0,37,33
1657264583408,MATH 18,B02,083749,Rideout; David Porter,4,0,36,32
1657264583408,MATH 18,B03,083750,Rideout; David Porter,2,0,37,35
1657264583408,MATH 18,B04,083751,Rideout; David Porter,6,0,36,30
1657264583408,MATH 18,B05,093473,Rideout; David Porter,5,0,36,31
1657264583408,MATH 18,B06,093474,Rideout; David Porter,5,0,36,31
1657264589446,MATH 20A,A01,083754,Zheng; Zequn,14,0,40,26
1657264595487,MATH 20B,A01,083756,Briones; Jor-el Thomas Caparas,3,0,36,33
1657264595487,MATH 20B,A02,083757,Briones; Jor-el Thomas Caparas,1,0,36,35
1657264595487,MATH 20B,A03,093475,Briones; Jor-el Thomas Caparas,2,0,36,34
1657264601521,MATH 20C,A01,083760,Briones; Jor-el Thomas Caparas,1,0,35,34
1657264601521,MATH 20C,A02,083761,Briones; Jor-el Thomas Caparas,8,0,35,27
1657264601521,MATH 20C,A03,093476,Briones; Jor-el Thomas Caparas,0,1,36,36
1657264601521,MATH 20C,B01,083762,Bach; Quang Tran,1,0,30,29
1657264607549,MATH 20D,A01,083765,Tran; Brian Kha,4,0,30,26
1657264607549,MATH 20D,A02,083766,Tran; Brian Kha,5,0,30,25
1657264607549,MATH 20D,A03,083767,Tran; Brian Kha,4,0,30,26
1657264613577,MATH 20E,A01,083771,Ganguly; Soumya,7,0,32,25
1657264613577,MATH 20E,A02,083772,Ganguly; Soumya,7,0,32,25
1657264613577,MATH 20E,B01,083773,Ciotti; Benjamin,19,0,35,16
1657264613577,MATH 20E,B02,083774,Ciotti; Benjamin,17,0,35,18
1657264619617,MATH 103A,A01,083777,Greenfeld; Be'Eri,3,0,36,33
1657264619617,MATH 103A,A02,083778,Greenfeld; Be'Eri,5,0,36,31
1657264619617,MATH 103A,A03,093561,Greenfeld; Be'Eri,4,0,36,32
1657264619617,MATH 103A,B01,083779,Greenfeld; Be'Eri,6,0,36,30
1657264619617,MATH 103A,B02,083780,Greenfeld; Be'Eri,3,0,36,33
1657264619617,MATH 103A,B03,093562,Greenfeld; Be'Eri,3,0,36,33
1657264625643,MATH 105,A01,085443,Carter; Anne Toulson,15,0,35,20
1657264625643,MATH 105,A02,093477,Carter; Anne Toulson,20,0,35,15
1657264631675,MATH 109,A01,083213,Ganzberger; Geoffrey Michael,2,0,34,32
1657264631675,MATH 109,A02,083214,Ganzberger; Geoffrey Michael,4,0,34,30
1657264631675,MATH 109,A03,093478,Ganzberger; Geoffrey Michael,2,0,34,32
1657264631675,MATH 109,B01,083215,Ganzberger; Geoffrey Michael,1,0,32,31
1657264631675,MATH 109,B02,083216,Ganzberger; Geoffrey Michael,1,0,32,31
1657264631675,MATH 109,B03,093479,Ganzberger; Geoffrey Michael,8,0,32,24
1657264637710,MATH 142A,A01,083219,Chow; Bennett,7,0,32,25
1657264637710,MATH 142A,A02,083220,Chow; Bennett,10,0,32,22
1657264637710,MATH 142A,A03,093480,Chow; Bennett,7,0,32,25
1657264637710,MATH 142A,B03,093481,Chow; Bennett,8,0,32,24
1657264637710,MATH 142A,B04,093558,Chow; Bennett,12,0,32,20
1657264637710,MATH 142A,B05,093559,Chow; Bennett,6,0,32,26
1657264643745,MATH 193A,A01,083224,Rotar; Vladimir,7,0,34,27
1657264643745,MATH 193A,A02,083225,Rotar; Vladimir,6,0,34,28
1657264643745,MATH 193A,A03,083781,Rotar; Vladimir,2,0,34,32
1657264643745,MATH 193A,A04,083782,Rotar; Vladimir,8,0,34,26
1657264643745,MATH 193A,A05,093482,Rotar; Vladimir,6,0,34,28
1657264649772,MATH 197,001,091859,McAuley; Julian John,9999,0,9999,0
1657264649772,MATH 197,002,095566,Kedlaya; Kiran S.,9997,0,9999,2
1657264649772,MATH 197,003,095567,Xiao; Ming,9999,0,9999,0
1657264649772,MATH 197,004,095571,Perols; Johan Lars,9998,0,9999,1
1657264656871,COGS 9,A01,083615,Shannon; Kyle Michael,8,0,75,67
1657264662895,COGS 11,A01,083617,Boyle; Mary E. T.,22,0,48,26
1657264668919,COGS 13,A01,083071,Bastos; Amalia Pinkusfeld,9,0,71,62
1657264674945,COGS 14A,A01,092681,Semenuks; Arturs,2,1,100,98
1657264680969,COGS 14B,A01,083073,Cheng; Tzu-Han,6,0,63,57
1657264686997,COGS 17,A01,092677,Semenuks; Arturs,5,0,81,76
1657264693035,COGS 100,A01,083619,Allen; Michael Gordon,16,0,70,54
1657264699064,COGS 101A,A01,083621,Davis; Joshua Daniel,9,0,68,59
1657264705092,COGS 101B,A01,091572,Allen; Michael Gordon,11,0,65,54
1657264711121,COGS 101C,A01,083625,Delgado; Tania,17,0,35,18
1657264717150,COGS 107A,A01,083627,Boyle; Mary E. T.,13,0,60,47
1657264723252,COGS 118A,A01,083075,Gupta; Anjum,18,0,76,58
1657264729279,CSE 3,A50,083646,Miranda; Gregory Joseph,24,0,50,26
1657264735320,CSE 8A,A50,083650,Miranda; Gregory Joseph,17,1,56,39
1657264741351,CSE 11,A01,083080,Cao; Yingjun,5,15,40,35
1657264747375,CSE 12,A01,083652,Krause-Levy; Sophia Louisa,26,1,120,94
1657264753400,CSE 15L,A01,083654,Morris; Justin Loren,9,0,50,41
1657264753400,CSE 15L,A02,083655,Morris; Justin Loren,9,0,50,41
1657264759425,CSE 20,A01,083657,Tran; Khoa Dang,38,0,80,42
1657264765448,CSE 21,A01,095574,Bach; Quang Tran,22,0,48,26
1657264771472,CSE 30,A01,083084,Eldon; John,4,0,80,76
1657264771472,CSE 30,B01,095061,Bhaskar; Nishant,8,0,50,42
1657264777497,CSE 100,A01,083659,Cao; Yingjun,4,4,70,66
1657264783520,CSE 134B,A01,083661,Powell; Thomas Allan,21,0,100,79
1657264789544,CSE 140,A01,083663,Gungor; Onat,13,0,85,72
1657264795568,CSE 140L,A01,083088,Eldon; John,19,0,100,81
1657264801592,CSE 175,A01,083665,Kumar; Rakesh,3,0,25,22
1657264807616,CSE 190,A00,092507,Dubnov; Shlomo,7,0,20,13
1657264813647,ECE 45,A01,083139,Congero; Spencer William,5,0,75,70
1657264819672,ECE 65,A50,083695,Saad; Andrew S,12,0,30,18
1657264819672,ECE 65,A51,095125,Saad; Andrew S,25,0,26,1
1657264825750,ECE 109,A01,091882,Touri; Behrouz,19,0,70,51
1657264831775,ECE 180,A00,083140,Abi Samra; Nicholas Camill,1,0,30,29
1657264831775,ECE 180,B00,083141,Abi Samra; Nicholas Camill,0,0,30,30
1657264837804,MATH 10A,A01,083735,Patchell; Gregory David,2,0,30,28
1657264837804,MATH 10A,A02,083736,Patchell; Gregory David,20,0,30,10
1657264837804,MATH 10A,A03,083737,Patchell; Gregory David,16,0,30,14
1657264843828,MATH 10B,A01,083207,Lim; Seonhee,7,0,34,27
1657264843828,MATH 10B,A02,083208,Lim; Seonhee,9,0,35,26
1657264843828,MATH 10B,A03,093472,Lim; Seonhee,5,0,34,29
1657264843828,MATH 10B,B01,083739,Sinha; Shubham,11,0,30,19
1657264849854,MATH 18,A01,083743,Cinel; Cameron Alexander,6,0,30,24
1657264849854,MATH 18,A02,083744,Cinel; Cameron Alexander,17,0,30,13
1657264849854,MATH 18,A03,083745,Cinel; Cameron Alexander,8,0,30,22
1657264849854,MATH 18,B01,083748,Rideout; David Porter,4,0,37,33
1657264849854,MATH 18,B02,083749,Rideout; David Porter,4,0,36,32
1657264849854,MATH 18,B03,083750,Rideout; David Porter,2,0,37,35
1657264849854,MATH 18,B04,083751,Rideout; David Porter,6,0,36,30
1657264849854,MATH 18,B05,093473,Rideout; David Porter,5,0,36,31
1657264849854,MATH 18,B06,093474,Rideout; David Porter,5,0,36,31
1657264855878,MATH 20A,A01,083754,Zheng; Zequn,14,0,40,26
1657264861904,MATH 20B,A01,083756,Briones; Jor-el Thomas Caparas,3,0,36,33
1657264861904,MATH 20B,A02,083757,Briones; Jor-el Thomas Caparas,1,0,36,35
1657264861904,MATH 20B,A03,093475,Briones; Jor-el Thomas Caparas,2,0,36,34
1657264867929,MATH 20C,A01,083760,Briones; Jor-el Thomas Caparas,1,0,35,34
1657264867929,MATH 20C,A02,083761,Briones; Jor-el Thomas Caparas,8,0,35,27
1657264867929,MATH 20C,A03,093476,Briones; Jor-el Thomas Caparas,0,1,36,36
1657264867929,MATH 20C,B01,083762,Bach; Quang Tran,1,0,30,29
1657264873953,MATH 20D,A01,083765,Tran; Brian Kha,4,0,30,26
1657264873953,MATH 20D,A02,083766,Tran; Brian Kha,5,0,30,25
1657264873953,MATH 20D,A03,083767,Tran; Brian Kha,4,0,30,26
1657264879984,MATH 20E,A01,083771,Ganguly; Soumya,7,0,32,25
1657264879984,MATH 20E,A02,083772,Ganguly; Soumya,7,0,32,25
1657264879984,MATH 20E,B01,083773,Ciotti; Benjamin,19,0,35,16
1657264879984,MATH 20E,B02,083774,Ciotti; Benjamin,17,0,35,18
1657264886015,MATH 103A,A01,083777,Greenfeld; Be'Eri,3,0,36,33
1657264886015,MATH 103A,A02,083778,Greenfeld; Be'Eri,5,0,36,31
1657264886015,MATH 103A,A03,093561,Greenfeld; Be'Eri,4,0,36,32
1657264886015,MATH 103A,B01,083779,Greenfeld; Be'Eri,6,0,36,30
1657264886015,MATH 103A,B02,083780,Greenfeld; Be'Eri,3,0,36,33
1657264886015,MATH 103A,B03,093562,Greenfeld; Be'Eri,3,0,36,33
1657264892039,MATH 105,A01,085443,Carter; Anne Toulson,15,0,35,20
1657264892039,MATH 105,A02,093477,Carter; Anne Toulson,20,0,35,15
1657264898079,MATH 109,A01,083213,Ganzberger; Geoffrey Michael,2,0,34,32
1657264898079,MATH 109,A02,083214,Ganzberger; Geoffrey Michael,4,0,34,30
1657264898079,MATH 109,A03,093478,Ganzberger; Geoffrey Michael,2,0,34,32
1657264898079,MATH 109,B01,083215,Ganzberger; Geoffrey Michael,1,0,32,31
1657264898079,MATH 109,B02,083216,Ganzberger; Geoffrey Michael,1,0,32,31
1657264898079,MATH 109,B03,093479,Ganzberger; Geoffrey Michael,8,0,32,24
1657264904105,MATH 142A,A01,083219,Chow; Bennett,7,0,32,25
1657264904105,MATH 142A,A02,083220,Chow; Bennett,10,0,32,22
1657264904105,MATH 142A,A03,093480,Chow; Bennett,7,0,32,25
1657264904105,MATH 142A,B03,093481,Chow; Bennett,8,0,32,24
1657264904105,MATH 142A,B04,093558,Chow; Bennett,12,0,32,20
1657264904105,MATH 142A,B05,093559,Chow; Bennett,6,0,32,26
1657264910130,MATH 193A,A01,083224,Rotar; Vladimir,7,0,34,27
1657264910130,MATH 193A,A02,083225,Rotar; Vladimir,6,0,34,28
1657264910130,MATH 193A,A03,083781,Rotar; Vladimir,2,0,34,32
1657264910130,MATH 193A,A04,083782,Rotar; Vladimir,8,0,34,26
1657264910130,MATH 193A,A05,093482,Rotar; Vladimir,6,0,34,28
1657264916153,MATH 197,001,091859,McAuley; Julian John,9999,0,9999,0
1657264916153,MATH 197,002,095566,Kedlaya; Kiran S.,9997,0,9999,2
1657264916153,MATH 197,003,095567,Xiao; Ming,9999,0,9999,0
1657264916153,MATH 197,004,095571,Perols; Johan Lars,9998,0,9999,1
1657264923219,COGS 9,A01,083615,Shannon; Kyle Michael,8,0,75,67
1657264929248,COGS 11,A01,083617,Boyle; Mary E. T.,22,0,48,26
1657264935277,COGS 13,A01,083071,Bastos; Amalia Pinkusfeld,9,0,71,62
1657264941302,COGS 14A,A01,092681,Semenuks; Arturs,2,1,100,98
1657264947344,COGS 14B,A01,083073,Cheng; Tzu-Han,6,0,63,57
1657264953372,COGS 17,A01,092677,Semenuks; Arturs,5,0,81,76
1657264959403,COGS 100,A01,083619,Allen; Michael Gordon,16,0,70,54
1657264965433,COGS 101A,A01,083621,Davis; Joshua Daniel,9,0,68,59
1657264971462,COGS 101B,A01,091572,Allen; Michael Gordon,11,0,65,54
1657264977486,COGS 101C,A01,083625,Delgado; Tania,17,0,35,18
1657264983514,COGS 107A,A01,083627,Boyle; Mary E. T.,13,0,60,47
1657264989538,COGS 118A,A01,083075,Gupta; Anjum,18,0,76,58
1657264995568,CSE 3,A50,083646,Miranda; Gregory Joseph,24,0,50,26
1657265001592,CSE 8A,A50,083650,Miranda; Gregory Joseph,17,1,56,39
1657265007619,CSE 11,A01,083080,Cao; Yingjun,5,15,40,35
1657265013647,CSE 12,A01,083652,Krause-Levy; Sophia Louisa,26,1,120,94
1657265019671,CSE 15L,A01,083654,Morris; Justin Loren,9,0,50,41
1657265019671,CSE 15L,A02,083655,Morris; Justin Loren,9,0,50,41
1657265025704,CSE 20,A01,083657,Tran; Khoa Dang,38,0,80,42
1657265031731,CSE 21,A01,095574,Bach; Quang Tran,22,0,48,26
1657265037755,CSE 30,A01,083084,Eldon; John,4,0,80,76
1657265037755,CSE 30,B01,095061,Bhaskar; Nishant,8,0,50,42
1657265043779,CSE 100,A01,083659,Cao; Yingjun,4,4,70,66
1657265049803,CSE 134B,A01,083661,Powell; Thomas Allan,21,0,100,79
1657265055828,CSE 140,A01,083663,Gungor; Onat,13,0,85,72
1657265061856,CSE 140L,A01,083088,Eldon; John,19,0,100,81
1657265067882,CSE 175,A01,083665,Kumar; Rakesh,3,0,25,22
1657265073911,CSE 190,A00,092507,Dubnov; Shlomo,7,0,20,13
1657265079935,ECE 45,A01,083139,Congero; Spencer William,5,0,75,70
1657265085965,ECE 65,A50,083695,Saad; Andrew S,12,0,30,18
1657265085965,ECE 65,A51,095125,Saad; Andrew S,25,0,26,1
1657265091990,ECE 109,A01,091882,Touri; Behrouz,19,0,70,51
1657265098016,ECE 180,A00,083140,Abi Samra; Nicholas Camill,1,0,30,29
1657265098016,ECE 180,B00,083141,Abi Samra; Nicholas Camill,0,0,30,30
1657265104041,MATH 10A,A01,083735,Patchell; Gregory David,2,0,30,28
1657265104041,MATH 10A,A02,083736,Patchell; Gregory David,20,0,30,10
1657265104041,MATH 10A,A03,083737,Patchell; Gregory David,16,0,30,14
1657265110071,MATH 10B,A01,083207,Lim; Seonhee,7,0,34,27
1657265110071,MATH 10B,A02,083208,Lim; Seonhee,9,0,35,26
1657265110071,MATH 10B,A03,093472,Lim; Seonhee,5,0,34,29
1657265110071,MATH 10B,B01,083739,Sinha; Shubham,11,0,30,19
1657265116104,MATH 18,A01,083743,Cinel; Cameron Alexander,6,0,30,24
1657265116104,MATH 18,A02,083744,Cinel; Cameron Alexander,17,0,30,13
1657265116104,MATH 18,A03,083745,Cinel; Cameron Alexander,8,0,30,22
1657265116104,MATH 18,B01,083748,Rideout; David Porter,4,0,37,33
1657265116104,MATH 18,B02,083749,Rideout; David Porter,4,0,36,32
1657265116104,MATH 18,B03,083750,Rideout; David Porter,2,0,37,35
1657265116104,MATH 18,B04,083751,Rideout; David Porter,6,0,36,30
1657265116104,MATH 18,B05,093473,Rideout; David Porter,5,0,36,31
1657265116104,MATH 18,B06,093474,Rideout; David Porter,5,0,36,31
1657265122135,MATH 20A,A01,083754,Zheng; Zequn,14,0,40,26
1657265128166,MATH 20B,A01,083756,Briones; Jor-el Thomas Caparas,3,0,36,33
1657265128166,MATH 20B,A02,083757,Briones; Jor-el Thomas Caparas,1,0,36,35
1657265128166,MATH 20B,A03,093475,Briones; Jor-el Thomas Caparas,2,0,36,34
1657265134191,MATH 20C,A01,083760,Briones; Jor-el Thomas Caparas,1,0,35,34
1657265134191,MATH 20C,A02,083761,Briones; Jor-el Thomas Caparas,8,0,35,27
1657265134191,MATH 20C,A03,093476,Briones; Jor-el Thomas Caparas,0,1,36,36
1657265134191,MATH 20C,B01,083762,Bach; Quang Tran,1,0,30,29
1657265140223,MATH 20D,A01,083765,Tran; Brian Kha,4,0,30,26
1657265140223,MATH 20D,A02,083766,Tran; Brian Kha,5,0,30,25
1657265140223,MATH 20D,A03,083767,Tran; Brian Kha,4,0,30,26
1657265146250,MATH 20E,A01,083771,Ganguly; Soumya,7,0,32,25
1657265146250,MATH 20E,A02,083772,Ganguly; Soumya,7,0,32,25
1657265146250,MATH 20E,B01,083773,Ciotti; Benjamin,19,0,35,16
1657265146250,MATH 20E,B02,083774,Ciotti; Benjamin,17,0,35,18
1657265152274,MATH 103A,A01,083777,Greenfeld; Be'Eri,3,0,36,33
1657265152274,MATH 103A,A02,083778,Greenfeld; Be'Eri,5,0,36,31
1657265152274,MATH 103A,A03,093561,Greenfeld; Be'Eri,4,0,36,32
1657265152274,MATH 103A,B01,083779,Greenfeld; Be'Eri,6,0,36,30
1657265152274,MATH 103A,B02,083780,Greenfeld; Be'Eri,3,0,36,33
1657265152274,MATH 103A,B03,093562,Greenfeld; Be'Eri,3,0,36,33
1657265158297,MATH 105,A01,085443,Carter; Anne Toulson,15,0,35,20
1657265158297,MATH 105,A02,093477,Carter; Anne Toulson,20,0,35,15
1657265164335,MATH 109,A01,083213,Ganzberger; Geoffrey Michael,2,0,34,32
1657265164335,MATH 109,A02,083214,Ganzberger; Geoffrey Michael,4,0,34,30
1657265164335,MATH 109,A03,093478,Ganzberger; Geoffrey Michael,2,0,34,32
1657265164335,MATH 109,B01,083215,Ganzberger; Geoffrey Michael,1,0,32,31
1657265164335,MATH 109,B02,083216,Ganzberger; Geoffrey Michael,1,0,32,31
1657265164335,MATH 109,B03,093479,Ganzberger; Geoffrey Michael,8,0,32,24
1657265170367,MATH 142A,A01,083219,Chow; Bennett,7,0,32,25
1657265170367,MATH 142A,A02,083220,Chow; Bennett,10,0,32,22
1657265170367,MATH 142A,A03,093480,Chow; Bennett,7,0,32,25
1657265170367,MATH 142A,B03,093481,Chow; Bennett,8,0,32,24
1657265170367,MATH 142A,B04,093558,Chow; Bennett,12,0,32,20
1657265170367,MATH 142A,B05,093559,Chow; Bennett,6,0,32,26
1657265176393,MATH 193A,A01,083224,Rotar; Vladimir,7,0,34,27
1657265176393,MATH 193A,A02,083225,Rotar; Vladimir,6,0,34,28
1657265176393,MATH 193A,A03,083781,Rotar; Vladimir,2,0,34,32
1657265176393,MATH 193A,A04,083782,Rotar; Vladimir,8,0,34,26
1657265176393,MATH 193A,A05,093482,Rotar; Vladimir,6,0,34,28
1657265182420,MATH 197,001,091859,McAuley; Julian John,9999,0,9999,0
1657265182420,MATH 197,002,095566,Kedlaya; Kiran S.,9997,0,9999,2
1657265182420,MATH 197,003,095567,Xiao; Ming,9999,0,9999,0
1657265182420,MATH 197,004,095571,Perols; Johan Lars,9998,0,9999,1
1657265189498,COGS 9,A01,083615,Shannon; Kyle Michael,8,0,75,67
1657265195533,COGS 11,A01,083617,Boyle; Mary E. T.,22,0,48,26
1657265201560,COGS 13,A01,083071,Bastos; Amalia Pinkusfeld,9,0,71,62
1657265207588,COGS 14A,A01,092681,Semenuks; Arturs,2,1,100,98
1657265213612,COGS 14B,A01,083073,Cheng; Tzu-Han,6,0,63,57
1657265219656,COGS 17,A01,092677,Semenuks; Arturs,5,0,81,76
1657265225687,COGS 100,A01,083619,Allen; Michael Gordon,16,0,70,54
1657265231712,COGS 101A,A01,083621,Davis; Joshua Daniel,9,0,68,59
1657265237741,COGS 101B,A01,091572,Allen; Michael Gordon,11,0,65,54
1657265243765,COGS 101C,A01,083625,Delgado; Tania,17,0,35,18
1657265249790,COGS 107A,A01,083627,Boyle; Mary E. T.,13,0,60,47
1657265255818,COGS 118A,A01,083075,Gupta; Anjum,18,0,76,58
1657265261863,CSE 3,A50,083646,Miranda; Gregory Joseph,24,0,50,26
1657265267888,CSE 8A,A50,083650,Miranda; Gregory Joseph,17,1,56,39
1657265273912,CSE 11,A01,083080,Cao; Yingjun,5,15,40,35
1657265279942,CSE 12,A01,083652,Krause-Levy; Sophia Louisa,26,1,120,94
1657265285972,CSE 15L,A01,083654,Morris; Justin Loren,9,0,50,41
1657265285972,CSE 15L,A02,083655,Morris; Justin Loren,9,0,50,41
1657265291996,CSE 20,A01,083657,Tran; Khoa Dang,38,0,80,42
1657265298023,CSE 21,A01,095574,Bach; Quang Tran,22,0,48,26
1657265304047,CSE 30,A01,083084,Eldon; John,4,0,80,76
1657265304047,CSE 30,B01,095061,Bhaskar; Nishant,8,0,50,42
1657265310071,CSE 100,A01,083659,Cao; Yingjun,4,4,70,66
1657265316096,CSE 134B,A01,083661,Powell; Thomas Allan,21,0,100,79
1657265322189,CSE 140,A01,083663,Gungor; Onat,13,0,85,72
1657265328213,CSE 140L,A01,083088,Eldon; John,19,0,100,81
1657265334245,CSE 175,A01,083665,Kumar; Rakesh,3,0,25,22
1657265340267,CSE 190,A00,092507,Dubnov; Shlomo,7,0,20,13
1657265346291,ECE 45,A01,083139,Congero; Spencer William,5,0,75,70
1657265352314,ECE 65,A50,083695,Saad; Andrew S,12,0,30,18
1657265352314,ECE 65,A51,095125,Saad; Andrew S,25,0,26,1
1657265358345,ECE 109,A01,091882,Touri; Behrouz,19,0,70,51
1657265364369,ECE 180,A00,083140,Abi Samra; Nicholas Camill,1,0,30,29
1657265364369,ECE 180,B00,083141,Abi Samra; Nicholas Camill,0,0,30,30
1657265370392,MATH 10A,A01,083735,Patchell; Gregory David,2,0,30,28
1657265370392,MATH 10A,A02,083736,Patchell; Gregory David,20,0,30,10
1657265370392,MATH 10A,A03,083737,Patchell; Gregory David,16,0,30,14
1657265376421,MATH 10B,A01,083207,Lim; Seonhee,7,0,34,27
1657265376421,MATH 10B,A02,083208,Lim; Seonhee,9,0,35,26
1657265376421,MATH 10B,A03,093472,Lim; Seonhee,5,0,34,29
1657265376421,MATH 10B,B01,083739,Sinha; Shubham,11,0,30,19
1657265382447,MATH 18,A01,083743,Cinel; Cameron Alexander,6,0,30,24
1657265382447,MATH 18,A02,083744,Cinel; Cameron Alexander,17,0,30,13
1657265382447,MATH 18,A03,083745,Cinel; Cameron Alexander,8,0,30,22
1657265382447,MATH 18,B01,083748,Rideout; David Porter,4,0,37,33
1657265382447,MATH 18,B02,083749,Rideout; David Porter,4,0,36,32
1657265382447,MATH 18,B03,083750,Rideout; David Porter,2,0,37,35
1657265382447,MATH 18,B04,083751,Rideout; David Porter,6,0,36,30
1657265382447,MATH 18,B05,093473,Rideout; David Porter,5,0,36,31
1657265382447,MATH 18,B06,093474,Rideout; David Porter,5,0,36,31
1657265388475,MATH 20A,A01,083754,Zheng; Zequn,14,0,40,26
1657265394496,MATH 20B,A01,083756,Briones; Jor-el Thomas Caparas,3,0,36,33
1657265394496,MATH 20B,A02,083757,Briones; Jor-el Thomas Caparas,1,0,36,35
1657265394496,MATH 20B,A03,093475,Briones; Jor-el Thomas Caparas,2,0,36,34
1657265400522,MATH 20C,A01,083760,Briones; Jor-el Thomas Caparas,1,0,35,34
1657265400522,MATH 20C,A02,083761,Briones; Jor-el Thomas Caparas,8,0,35,27
1657265400522,MATH 20C,A03,093476,Briones; Jor-el Thomas Caparas,0,1,36,36
1657265400522,MATH 20C,B01,083762,Bach; Quang Tran,1,0,30,29
1657265406546,MATH 20D,A01,083765,Tran; Brian Kha,4,0,30,26
1657265406546,MATH 20D,A02,083766,Tran; Brian Kha,5,0,30,25
1657265406546,MATH 20D,A03,083767,Tran; Brian Kha,4,0,30,26
1657265412588,MATH 20E,A01,083771,Ganguly; Soumya,7,0,32,25
1657265412588,MATH 20E,A02,083772,Ganguly; Soumya,7,0,32,25
1657265412588,MATH 20E,B01,083773,Ciotti; Benjamin,19,0,35,16
1657265412588,MATH 20E,B02,083774,Ciotti; Benjamin,17,0,35,18
1657265418619,MATH 103A,A01,083777,Greenfeld; Be'Eri,3,0,36,33
1657265418619,MATH 103A,A02,083778,Greenfeld; Be'Eri,5,0,36,31
1657265418619,MATH 103A,A03,093561,Greenfeld; Be'Eri,4,0,36,32
1657265418619,MATH 103A,B01,083779,Greenfeld; Be'Eri,6,0,36,30
1657265418619,MATH 103A,B02,083780,Greenfeld; Be'Eri,3,0,36,33
1657265418619,MATH 103A,B03,093562,Greenfeld; Be'Eri,3,0,36,33
1657265424644,MATH 105,A01,085443,Carter; Anne Toulson,15,0,35,20
1657265424644,MATH 105,A02,093477,Carter; Anne Toulson,20,0,35,15
1657265430668,MATH 109,A01,083213,Ganzberger; Geoffrey Michael,2,0,34,32
1657265430668,MATH 109,A02,083214,Ganzberger; Geoffrey Michael,4,0,34,30
1657265430668,MATH 109,A03,093478,Ganzberger; Geoffrey Michael,2,0,34,32
1657265430668,MATH 109,B01,083215,Ganzberger; Geoffrey Michael,1,0,32,31
1657265430668,MATH 109,B02,083216,Ganzberger; Geoffrey Michael,1,0,32,31
1657265430668,MATH 109,B03,093479,Ganzberger; Geoffrey Michael,8,0,32,24
1657265436699,MATH 142A,A01,083219,Chow; Bennett,7,0,32,25
1657265436699,MATH 142A,A02,083220,Chow; Bennett,10,0,32,22
1657265436699,MATH 142A,A03,093480,Chow; Bennett,7,0,32,25
1657265436699,MATH 142A,B03,093481,Chow; Bennett,8,0,32,24
1657265436699,MATH 142A,B04,093558,Chow; Bennett,12,0,32,20
1657265436699,MATH 142A,B05,093559,Chow; Bennett,6,0,32,26
1657265442724,MATH 193A,A01,083224,Rotar; Vladimir,7,0,34,27
1657265442724,MATH 193A,A02,083225,Rotar; Vladimir,6,0,34,28
1657265442724,MATH 193A,A03,083781,Rotar; Vladimir,2,0,34,32
1657265442724,MATH 193A,A04,083782,Rotar; Vladimir,8,0,34,26
1657265442724,MATH 193A,A05,093482,Rotar; Vladimir,6,0,34,28
1657265448747,MATH 197,001,091859,McAuley; Julian John,9999,0,9999,0
1657265448747,MATH 197,002,095566,Kedlaya; Kiran S.,9997,0,9999,2
1657265448747,MATH 197,003,095567,Xiao; Ming,9999,0,9999,0
1657265448747,MATH 197,004,095571,Perols; Johan Lars,9998,0,9999,1
1657265455804,COGS 9,A01,083615,Shannon; Kyle Michael,8,0,75,67
1657265461828,COGS 11,A01,083617,Boyle; Mary E. T.,22,0,48,26
1657265467855,COGS 13,A01,083071,Bastos; Amalia Pinkusfeld,9,0,71,62
1657265473878,COGS 14A,A01,092681,Semenuks; Arturs,2,1,100,98
1657265479900,COGS 14B,A01,083073,Cheng; Tzu-Han,6,0,63,57
1657265485932,COGS 17,A01,092677,Semenuks; Arturs,5,0,81,76
1657265491957,COGS 100,A01,083619,Allen; Michael Gordon,16,0,70,54
1657265497981,COGS 101A,A01,083621,Davis; Joshua Daniel,9,0,68,59
1657265504004,COGS 101B,A01,091572,Allen; Michael Gordon,11,0,65,54
1657265510033,COGS 101C,A01,083625,Delgado; Tania,17,0,35,18
1657265516063,COGS 107A,A01,083627,Boyle; Mary E. T.,13,0,60,47
1657265522088,COGS 118A,A01,083075,Gupta; Anjum,18,0,76,58
1657265528117,CSE 3,A50,083646,Miranda; Gregory Joseph,24,0,50,26
1657265534146,CSE 8A,A50,083650,Miranda; Gregory Joseph,17,1,56,39
1657265540170,CSE 11,A01,083080,Cao; Yingjun,5,15,40,35
1657265546208,CSE 12,A01,083652,Krause-Levy; Sophia Louisa,26,1,120,94
1657265552238,CSE 15L,A01,083654,Morris; Justin Loren,9,0,50,41
1657265552238,CSE 15L,A02,083655,Morris; Justin Loren,9,0,50,41
1657265558262,CSE 20,A01,083657,Tran; Khoa Dang,38,0,80,42
1657265564287,CSE 21,A01,095574,Bach; Quang Tran,22,0,48,26
1657265570313,CSE 30,A01,083084,Eldon; John,4,0,80,76
1657265570313,CSE 30,B01,095061,Bhaskar; Nishant,8,0,50,42
1657265576338,CSE 100,A01,083659,Cao; Yingjun,4,4,70,66
1657265582375,CSE 134B,A01,083661,Powell; Thomas Allan,21,0,100,79
1657265588401,CSE 140,A01,083663,Gungor; Onat,13,0,85,72
1657265594426,CSE 140L,A01,083088,Eldon; John,19,0,100,81
1657265600454,CSE 175,A01,083665,Kumar; Rakesh,3,0,25,22
1657265606482,CSE 190,A00,092507,Dubnov; Shlomo,7,0,20,13
1657265612508,ECE 45,A01,083139,Congero; Spencer William,5,0,75,70
1657265618547,ECE 65,A50,083695,Saad; Andrew S,12,0,30,18
1657265618547,ECE 65,A51,095125,Saad; Andrew S,25,0,26,1
1657265624572,ECE 109,A01,091882,Touri; Behrouz,19,0,70,51
1657265630606,ECE 180,A00,083140,Abi Samra; Nicholas Camill,1,0,30,29
1657265630606,ECE 180,B00,083141,Abi Samra; Nicholas Camill,0,0,30,30
1657265636643,MATH 10A,A01,083735,Patchell; Gregory David,2,0,30,28
1657265636643,MATH 10A,A02,083736,Patchell; Gregory David,20,0,30,10
1657265636643,MATH 10A,A03,083737,Patchell; Gregory David,16,0,30,14
1657265642674,MATH 10B,A01,083207,Lim; Seonhee,7,0,34,27
1657265642674,MATH 10B,A02,083208,Lim; Seonhee,9,0,35,26
1657265642674,MATH 10B,A03,093472,Lim; Seonhee,5,0,34,29
1657265642674,MATH 10B,B01,083739,Sinha; Shubham,11,0,30,19
1657265648705,MATH 18,A01,083743,Cinel; Cameron Alexander,6,0,30,24
1657265648705,MATH 18,A02,083744,Cinel; Cameron Alexander,17,0,30,13
1657265648705,MATH 18,A03,083745,Cinel; Cameron Alexander,8,0,30,22
1657265648705,MATH 18,B01,083748,Rideout; David Porter,4,0,37,33
1657265648705,MATH 18,B02,083749,Rideout; David Porter,4,0,36,32
1657265648705,MATH 18,B03,083750,Rideout; David Porter,2,0,37,35
1657265648705,MATH 18,B04,083751,Rideout; David Porter,6,0,36,30
1657265648705,MATH 18,B05,093473,Rideout; David Porter,5,0,36,31
1657265648705,MATH 18,B06,093474,Rideout; David Porter,5,0,36,31
1657265654736,MATH 20A,A01,083754,Zheng; Zequn,14,0,40,26
1657265660768,MATH 20B,A01,083756,Briones; Jor-el Thomas Caparas,3,0,36,33
1657265660768,MATH 20B,A02,083757,Briones; Jor-el Thomas Caparas,1,0,36,35
1657265660768,MATH 20B,A03,093475,Briones; Jor-el Thomas Caparas,2,0,36,34
1657265666794,MATH 20C,A01,083760,Briones; Jor-el Thomas Caparas,1,0,35,34
1657265666794,MATH 20C,A02,083761,Briones; Jor-el Thomas Caparas,8,0,35,27
1657265666794,MATH 20C,A03,093476,Briones; Jor-el Thomas Caparas,0,1,36,36
1657265666794,MATH 20C,B01,083762,Bach; Quang Tran,1,0,30,29
1657265672818,MATH 20D,A01,083765,Tran; Brian Kha,4,0,30,26
1657265672818,MATH 20D,A02,083766,Tran; Brian Kha,5,0,30,25
1657265672818,MATH 20D,A03,083767,Tran; Brian Kha,4,0,30,26
1657265678846,MATH 20E,A01,083771,Ganguly; Soumya,7,0,32,25
1657265678846,MATH 20E,A02,083772,Ganguly; Soumya,7,0,32,25
1657265678846,MATH 20E,B01,083773,Ciotti; Benjamin,19,0,35,16
1657265678846,MATH 20E,B02,083774,Ciotti; Benjamin,17,0,35,18
1657265684872,MATH 103A,A01,083777,Greenfeld; Be'Eri,3,0,36,33
1657265684872,MATH 103A,A02,083778,Greenfeld; Be'Eri,5,0,36,31
1657265684872,MATH 103A,A03,093561,Greenfeld; Be'Eri,4,0,36,32
1657265684872,MATH 103A,B01,083779,Greenfeld; Be'Eri,6,0,36,30
1657265684872,MATH 103A,B02,083780,Greenfeld; Be'Eri,3,0,36,33
1657265684872,MATH 103A,B03,093562,Greenfeld; Be'Eri,3,0,36,33
1657265690902,MATH 105,A01,085443,Carter; Anne Toulson,15,0,35,20
1657265690902,MATH 105,A02,093477,Carter; Anne Toulson,20,0,35,15
1657265696930,MATH 109,A01,083213,Ganzberger; Geoffrey Michael,2,0,34,32
1657265696930,MATH 109,A02,083214,Ganzberger; Geoffrey Michael,4,0,34,30
1657265696930,MATH 109,A03,093478,Ganzberger; Geoffrey Michael,2,0,34,32
1657265696930,MATH 109,B01,083215,Ganzberger; Geoffrey Michael,1,0,32,31
1657265696930,MATH 109,B02,083216,Ganzberger; Geoffrey Michael,1,0,32,31
1657265696930,MATH 109,B03,093479,Ganzberger; Geoffrey Michael,8,0,32,24
1657265702957,MATH 142A,A01,083219,Chow; Bennett,7,0,32,25
1657265702957,MATH 142A,A02,083220,Chow; Bennett,10,0,32,22
1657265702957,MATH 142A,A03,093480,Chow; Bennett,7,0,32,25
1657265702957,MATH 142A,B03,093481,Chow; Bennett,8,0,32,24
1657265702957,MATH 142A,B04,093558,Chow; Bennett,12,0,32,20
1657265702957,MATH 142A,B05,093559,Chow; Bennett,6,0,32,26
1657265708982,MATH 193A,A01,083224,Rotar; Vladimir,7,0,34,27
1657265708982,MATH 193A,A02,083225,Rotar; Vladimir,6,0,34,28
1657265708982,MATH 193A,A03,083781,Rotar; Vladimir,2,0,34,32
1657265708982,MATH 193A,A04,083782,Rotar; Vladimir,8,0,34,26
1657265708982,MATH 193A,A05,093482,Rotar; Vladimir,6,0,34,28
1657265715008,MATH 197,001,091859,McAuley; Julian John,9999,0,9999,0
1657265715008,MATH 197,002,095566,Kedlaya; Kiran S.,9997,0,9999,2
1657265715008,MATH 197,003,095567,Xiao; Ming,9999,0,9999,0
1657265715008,MATH 197,004,095571,Perols; Johan Lars,9998,0,9999,1
1657265722088,COGS 9,A01,083615,Shannon; Kyle Michael,8,0,75,67
1657265728112,COGS 11,A01,083617,Boyle; Mary E. T.,22,0,48,26
1657265734142,COGS 13,A01,083071,Bastos; Amalia Pinkusfeld,9,0,71,62
1657265740170,COGS 14A,A01,092681,Semenuks; Arturs,2,1,100,98
1657265746199,COGS 14B,A01,083073,Cheng; Tzu-Han,6,0,63,57
1657265752225,COGS 17,A01,092677,Semenuks; Arturs,5,0,81,76
1657265758250,COGS 100,A01,083619,Allen; Michael Gordon,16,0,70,54
1657265764276,COGS 101A,A01,083621,Davis; Joshua Daniel,9,0,68,59
1657265770305,COGS 101B,A01,091572,Allen; Michael Gordon,11,0,65,54
1657265776337,COGS 101C,A01,083625,Delgado; Tania,17,0,35,18
1657265782363,COGS 107A,A01,083627,Boyle; Mary E. T.,13,0,60,47
1657265788388,COGS 118A,A01,083075,Gupta; Anjum,18,0,76,58
1657265794419,CSE 3,A50,083646,Miranda; Gregory Joseph,24,0,50,26
1657265800447,CSE 8A,A50,083650,Miranda; Gregory Joseph,17,1,56,39
1657265806470,CSE 11,A01,083080,Cao; Yingjun,5,15,40,35
1657265812494,CSE 12,A01,083652,Krause-Levy; Sophia Louisa,26,1,120,94
1657265818520,CSE 15L,A01,083654,Morris; Justin Loren,9,0,50,41
1657265818520,CSE 15L,A02,083655,Morris; Justin Loren,9,0,50,41
1657265824549,CSE 20,A01,083657,Tran; Khoa Dang,38,0,80,42
1657265830577,CSE 21,A01,095574,Bach; Quang Tran,22,0,48,26
1657265836605,CSE 30,A01,083084,Eldon; John,4,0,80,76
1657265836605,CSE 30,B01,095061,Bhaskar; Nishant,8,0,50,42
1657265842628,CSE 100,A01,083659,Cao; Yingjun,4,4,70,66
1657265848662,CSE 134B,A01,083661,Powell; Thomas Allan,21,0,100,79
1657265854689,CSE 140,A01,083663,Gungor; Onat,13,0,85,72
1657265860724,CSE 140L,A01,083088,Eldon; John,19,0,100,81
1657265866752,CSE 175,A01,083665,Kumar; Rakesh,3,0,25,22
1657265872787,CSE 190,A00,092507,Dubnov; Shlomo,7,0,20,13
1657265878810,ECE 45,A01,083139,Congero; Spencer William,5,0,75,70
1657265884836,ECE 65,A50,083695,Saad; Andrew S,12,0,30,18
1657265884836,ECE 65,A51,095125,Saad; Andrew S,25,0,26,1
1657265890865,ECE 109,A01,091882,Touri; Behrouz,19,0,70,51
1657265896890,ECE 180,A00,083140,Abi Samra; Nicholas Camill,1,0,30,29
1657265896890,ECE 180,B00,083141,Abi Samra; Nicholas Camill,0,0,30,30
1657265902922,MATH 10A,A01,083735,Patchell; Gregory David,2,0,30,28
1657265902922,MATH 10A,A02,083736,Patchell; Gregory David,20,0,30,10
1657265902922,MATH 10A,A03,083737,Patchell; Gregory David,16,0,30,14
1657265908960,MATH 10B,A01,083207,Lim; Seonhee,7,0,34,27
1657265908960,MATH 10B,A02,083208,Lim; Seonhee,9,0,35,26
1657265908960,MATH 10B,A03,093472,Lim; Seonhee,5,0,34,29
1657265908960,MATH 10B,B01,083739,Sinha; Shubham,11,0,30,19
1657265914999,MATH 18,A01,083743,Cinel; Cameron Alexander,6,0,30,24
1657265914999,MATH 18,A02,083744,Cinel; Cameron Alexander,17,0,30,13
1657265914999,MATH 18,A03,083745,Cinel; Cameron Alexander,8,0,30,22
1657265914999,MATH 18,B01,083748,Rideout; David Porter,4,0,37,33
1657265914999,MATH 18,B02,083749,Rideout; David Porter,4,0,36,32
1657265914999,MATH 18,B03,083750,Rideout; David Porter,2,0,37,35
1657265914999,MATH 18,B04,083751,Rideout; David Porter,6,0,36,30
1657265914999,MATH 18,B05,093473,Rideout; David Porter,5,0,36,31
1657265914999,MATH 18,B06,093474,Rideout; David Porter,5,0,36,31
1657265921100,MATH 20A,A01,083754,Zheng; Zequn,14,0,40,26
1657265927131,MATH 20B,A01,083756,Briones; Jor-el Thomas Caparas,3,0,36,33
1657265927131,MATH 20B,A02,083757,Briones; Jor-el Thomas Caparas,1,0,36,35
1657265927131,MATH 20B,A03,093475,Briones; Jor-el Thomas Caparas,2,0,36,34
1657265933155,MATH 20C,A01,083760,Briones; Jor-el Thomas Caparas,1,0,35,34
1657265933155,MATH 20C,A02,083761,Briones; Jor-el Thomas Caparas,8,0,35,27
1657265933155,MATH 20C,A03,093476,Briones; Jor-el Thomas Caparas,0,1,36,36
1657265933155,MATH 20C,B01,083762,Bach; Quang Tran,1,0,30,29
1657265939180,MATH 20D,A01,083765,Tran; Brian Kha,4,0,30,26
1657265939180,MATH 20D,A02,083766,Tran; Brian Kha,5,0,30,25
1657265939180,MATH 20D,A03,083767,Tran; Brian Kha,4,0,30,26
1657265945215,MATH 20E,A01,083771,Ganguly; Soumya,7,0,32,25
1657265945215,MATH 20E,A02,083772,Ganguly; Soumya,7,0,32,25
1657265945215,MATH 20E,B01,083773,Ciotti; Benjamin,19,0,35,16
1657265945215,MATH 20E,B02,083774,Ciotti; Benjamin,17,0,35,18
1657265951247,MATH 103A,A01,083777,Greenfeld; Be'Eri,3,0,36,33
1657265951247,MATH 103A,A02,083778,Greenfeld; Be'Eri,5,0,36,31
1657265951247,MATH 103A,A03,093561,Greenfeld; Be'Eri,4,0,36,32
1657265951247,MATH 103A,B01,083779,Greenfeld; Be'Eri,6,0,36,30
1657265951247,MATH 103A,B02,083780,Greenfeld; Be'Eri,3,0,36,33
1657265951247,MATH 103A,B03,093562,Greenfeld; Be'Eri,3,0,36,33
1657265957277,MATH 105,A01,085443,Carter; Anne Toulson,15,0,35,20
1657265957277,MATH 105,A02,093477,Carter; Anne Toulson,20,0,35,15
1657265963302,MATH 109,A01,083213,Ganzberger; Geoffrey Michael,2,0,34,32
1657265963302,MATH 109,A02,083214,Ganzberger; Geoffrey Michael,4,0,34,30
1657265963302,MATH 109,A03,093478,Ganzberger; Geoffrey Michael,2,0,34,32
1657265963302,MATH 109,B01,083215,Ganzberger; Geoffrey Michael,1,0,32,31
1657265963302,MATH 109,B02,083216,Ganzberger; Geoffrey Michael,1,0,32,31
1657265963302,MATH 109,B03,093479,Ganzberger; Geoffrey Michael,8,0,32,24
1657265969334,MATH 142A,A01,083219,Chow; Bennett,7,0,32,25
1657265969334,MATH 142A,A02,083220,Chow; Bennett,10,0,32,22
1657265969334,MATH 142A,A03,093480,Chow; Bennett,7,0,32,25
1657265969334,MATH 142A,B03,093481,Chow; Bennett,8,0,32,24
1657265969334,MATH 142A,B04,093558,Chow; Bennett,12,0,32,20
1657265969334,MATH 142A,B05,093559,Chow; Bennett,6,0,32,26
1657265975368,MATH 193A,A01,083224,Rotar; Vladimir,7,0,34,27
1657265975368,MATH 193A,A02,083225,Rotar; Vladimir,6,0,34,28
1657265975368,MATH 193A,A03,083781,Rotar; Vladimir,2,0,34,32
1657265975368,MATH 193A,A04,083782,Rotar; Vladimir,8,0,34,26
1657265975368,MATH 193A,A05,093482,Rotar; Vladimir,6,0,34,28
1657265981401,MATH 197,001,091859,McAuley; Julian John,9999,0,9999,0
1657265981401,MATH 197,002,095566,Kedlaya; Kiran S.,9997,0,9999,2
1657265981401,MATH 197,003,095567,Xiao; Ming,9999,0,9999,0
1657265981401,MATH 197,004,095571,Perols; Johan Lars,9998,0,9999,1
1657265988484,COGS 9,A01,083615,Shannon; Kyle Michael,8,0,75,67
1657265994507,COGS 11,A01,083617,Boyle; Mary E. T.,22,0,48,26
1657266000544,COGS 13,A01,083071,Bastos; Amalia Pinkusfeld,9,0,71,62
1657266006573,COGS 14A,A01,092681,Semenuks; Arturs,2,1,100,98
1657266012599,COGS 14B,A01,083073,Cheng; Tzu-Han,6,0,63,57
1657266018625,COGS 17,A01,092677,Semenuks; Arturs,5,0,81,76
1657266024657,COGS 100,A01,083619,Allen; Michael Gordon,16,0,70,54
1657266030686,COGS 101A,A01,083621,Davis; Joshua Daniel,9,0,68,59
1657266036715,COGS 101B,A01,091572,Allen; Michael Gordon,11,0,65,54
1657266042755,COGS 101C,A01,083625,Delgado; Tania,17,0,35,18
1657266048782,COGS 107A,A01,083627,Boyle; Mary E. T.,13,0,60,47
1657266054807,COGS 118A,A01,083075,Gupta; Anjum,18,0,76,58
1657266060839,CSE 3,A50,083646,Miranda; Gregory Joseph,24,0,50,26
1657266066863,CSE 8A,A50,083650,Miranda; Gregory Joseph,17,1,56,39
1657266072892,CSE 11,A01,083080,Cao; Yingjun,5,15,40,35
1657266078924,CSE 12,A01,083652,Krause-Levy; Sophia Louisa,26,1,120,94
1657266084953,CSE 15L,A01,083654,Morris; Justin Loren,9,0,50,41
1657266084953,CSE 15L,A02,083655,Morris; Justin Loren,9,0,50,41
1657266090979,CSE 20,A01,083657,Tran; Khoa Dang,38,0,80,42
1657266097006,CSE 21,A01,095574,Bach; Quang Tran,22,0,48,26
1657266103037,CSE 30,A01,083084,Eldon; John,4,0,80,76
1657266103037,CSE 30,B01,095061,Bhaskar; Nishant,8,0,50,42
1657266109061,CSE 100,A01,083659,Cao; Yingjun,4,4,70,66
1657266115086,CSE 134B,A01,083661,Powell; Thomas Allan,21,0,100,79
1657266121112,CSE 140,A01,083663,Gungor; Onat,13,0,85,72
1657266127140,CSE 140L,A01,083088,Eldon; John,19,0,100,81
1657266133171,CSE 175,A01,083665,Kumar; Rakesh,3,0,25,22
1657266139200,CSE 190,A00,092507,Dubnov; Shlomo,7,0,20,13
1657266145225,ECE 45,A01,083139,Congero; Spencer William,5,0,75,70
1657266151250,ECE 65,A50,083695,Saad; Andrew S,12,0,30,18
1657266151250,ECE 65,A51,095125,Saad; Andrew S,25,0,26,1
1657266157279,ECE 109,A01,091882,Touri; Behrouz,19,0,70,51
1657266163308,ECE 180,A00,083140,Abi Samra; Nicholas Camill,1,0,30,29
1657266163308,ECE 180,B00,083141,Abi Samra; Nicholas Camill,0,0,30,30
1657266169341,MATH 10A,A01,083735,Patchell; Gregory David,2,0,30,28
1657266169341,MATH 10A,A02,083736,Patchell; Gregory David,20,0,30,10
1657266169341,MATH 10A,A03,083737,Patchell; Gregory David,16,0,30,14
1657266175370,MATH 10B,A01,083207,Lim; Seonhee,7,0,34,27
1657266175370,MATH 10B,A02,083208,Lim; Seonhee,9,0,35,26
1657266175370,MATH 10B,A03,093472,Lim; Seonhee,5,0,34,29
1657266175370,MATH 10B,B01,083739,Sinha; Shubham,11,0,30,19
1657266181399,MATH 18,A01,083743,Cinel; Cameron Alexander,6,0,30,24
1657266181399,MATH 18,A02,083744,Cinel; Cameron Alexander,17,0,30,13
1657266181399,MATH 18,A03,083745,Cinel; Cameron Alexander,8,0,30,22
1657266181399,MATH 18,B01,083748,Rideout; David Porter,4,0,37,33
1657266181399,MATH 18,B02,083749,Rideout; David Porter,4,0,36,32
1657266181399,MATH 18,B03,083750,Rideout; David Porter,2,0,37,35
1657266181399,MATH 18,B04,083751,Rideout; David Porter,6,0,36,30
1657266181399,MATH 18,B05,093473,Rideout; David Porter,5,0,36,31
1657266181399,MATH 18,B06,093474,Rideout; David Porter,5,0,36,31
1657266187427,MATH 20A,A01,083754,Zheng; Zequn,14,0,40,26
1657266193458,MATH 20B,A01,083756,Briones; Jor-el Thomas Caparas,3,0,36,33
1657266193458,MATH 20B,A02,083757,Briones; Jor-el Thomas Caparas,1,0,36,35
1657266193458,MATH 20B,A03,093475,Briones; Jor-el Thomas Caparas,2,0,36,34
1657266199484,MATH 20C,A01,083760,Briones; Jor-el Thomas Caparas,1,0,35,34
1657266199484,MATH 20C,A02,083761,Briones; Jor-el Thomas Caparas,8,0,35,27
1657266199484,MATH 20C,A03,093476,Briones; Jor-el Thomas Caparas,0,1,36,36
1657266199484,MATH 20C,B01,083762,Bach; Quang Tran,1,0,30,29
1657266205508,MATH 20D,A01,083765,Tran; Brian Kha,4,0,30,26
1657266205508,MATH 20D,A02,083766,Tran; Brian Kha,5,0,30,25
1657266205508,MATH 20D,A03,083767,Tran; Brian Kha,4,0,30,26
1657266211541,MATH 20E,A01,083771,Ganguly; Soumya,7,0,32,25
1657266211541,MATH 20E,A02,083772,Ganguly; Soumya,7,0,32,25
1657266211541,MATH 20E,B01,083773,Ciotti; Benjamin,19,0,35,16
1657266211541,MATH 20E,B02,083774,Ciotti; Benjamin,17,0,35,18
1657266217578,MATH 103A,A01,083777,Greenfeld; Be'Eri,3,0,36,33
1657266217578,MATH 103A,A02,083778,Greenfeld; Be'Eri,5,0,36,31
1657266217578,MATH 103A,A03,093561,Greenfeld; Be'Eri,4,0,36,32
1657266217578,MATH 103A,B01,083779,Greenfeld; Be'Eri,6,0,36,30
1657266217578,MATH 103A,B02,083780,Greenfeld; Be'Eri,3,0,36,33
1657266217578,MATH 103A,B03,093562,Greenfeld; Be'Eri,3,0,36,33
1657266223609,MATH 105,A01,085443,Carter; Anne Toulson,15,0,35,20
1657266223609,MATH 105,A02,093477,Carter; Anne Toulson,20,0,35,15
1657266229643,MATH 109,A01,083213,Ganzberger; Geoffrey Michael,2,0,34,32
1657266229643,MATH 109,A02,083214,Ganzberger; Geoffrey Michael,4,0,34,30
1657266229643,MATH 109,A03,093478,Ganzberger; Geoffrey Michael,2,0,34,32
1657266229643,MATH 109,B01,083215,Ganzberger; Geoffrey Michael,1,0,32,31
1657266229643,MATH 109,B02,083216,Ganzberger; Geoffrey Michael,1,0,32,31
1657266229643,MATH 109,B03,093479,Ganzberger; Geoffrey Michael,8,0,32,24
1657266235670,MATH 142A,A01,083219,Chow; Bennett,7,0,32,25
1657266235670,MATH 142A,A02,083220,Chow; Bennett,10,0,32,22
1657266235670,MATH 142A,A03,093480,Chow; Bennett,7,0,32,25
1657266235670,MATH 142A,B03,093481,Chow; Bennett,8,0,32,24
1657266235670,MATH 142A,B04,093558,Chow; Bennett,12,0,32,20
1657266235670,MATH 142A,B05,093559,Chow; Bennett,6,0,32,26
1657266241701,MATH 193A,A01,083224,Rotar; Vladimir,7,0,34,27
1657266241701,MATH 193A,A02,083225,Rotar; Vladimir,6,0,34,28
1657266241701,MATH 193A,A03,083781,Rotar; Vladimir,2,0,34,32
1657266241701,MATH 193A,A04,083782,Rotar; Vladimir,8,0,34,26
1657266241701,MATH 193A,A05,093482,Rotar; Vladimir,6,0,34,28
1657266247725,MATH 197,001,091859,McAuley; Julian John,9999,0,9999,0
1657266247725,MATH 197,002,095566,Kedlaya; Kiran S.,9997,0,9999,2
1657266247725,MATH 197,003,095567,Xiao; Ming,9999,0,9999,0
1657266247725,MATH 197,004,095571,Perols; Johan Lars,9998,0,9999,1
1657266254797,COGS 9,A01,083615,Shannon; Kyle Michael,8,0,75,67
1657266260825,COGS 11,A01,083617,Boyle; Mary E. T.,22,0,48,26
1657266266850,COGS 13,A01,083071,Bastos; Amalia Pinkusfeld,9,0,71,62
1657266272876,COGS 14A,A01,092681,Semenuks; Arturs,2,1,100,98
1657266278908,COGS 14B,A01,083073,Cheng; Tzu-Han,6,0,63,57
1657266284936,COGS 17,A01,092677,Semenuks; Arturs,5,0,81,76
1657266290961,COGS 100,A01,083619,Allen; Michael Gordon,16,0,70,54
1657266296986,COGS 101A,A01,083621,Davis; Joshua Daniel,9,0,68,59
1657266303011,COGS 101B,A01,091572,Allen; Michael Gordon,11,0,65,54
1657266309035,COGS 101C,A01,083625,Delgado; Tania,17,0,35,18
1657266315063,COGS 107A,A01,083627,Boyle; Mary E. T.,13,0,60,47
1657266321093,COGS 118A,A01,083075,Gupta; Anjum,18,0,76,58
1657266327125,CSE 3,A50,083646,Miranda; Gregory Joseph,24,0,50,26
1657266333156,CSE 8A,A50,083650,Miranda; Gregory Joseph,17,1,56,39
1657266339182,CSE 11,A01,083080,Cao; Yingjun,5,15,40,35
1657266345205,CSE 12,A01,083652,Krause-Levy; Sophia Louisa,26,1,120,94
1657266351230,CSE 15L,A01,083654,Morris; Justin Loren,9,0,50,41
1657266351230,CSE 15L,A02,083655,Morris; Justin Loren,9,0,50,41
1657266357257,CSE 20,A01,083657,Tran; Khoa Dang,38,0,80,42
1657266363282,CSE 21,A01,095574,Bach; Quang Tran,22,0,48,26
1657266369311,CSE 30,A01,083084,Eldon; John,4,0,80,76
1657266369311,CSE 30,B01,095061,Bhaskar; Nishant,8,0,50,42
1657266375345,CSE 100,A01,083659,Cao; Yingjun,4,4,70,66
1657266381368,CSE 134B,A01,083661,Powell; Thomas Allan,21,0,100,79
1657266387393,CSE 140,A01,083663,Gungor; Onat,13,0,85,72
1657266393423,CSE 140L,A01,083088,Eldon; John,19,0,100,81
1657266399454,CSE 175,A01,083665,Kumar; Rakesh,3,0,25,22
1657266405478,CSE 190,A00,092507,Dubnov; Shlomo,7,0,20,13
1657266411504,ECE 45,A01,083139,Congero; Spencer William,5,0,75,70
1657266417537,ECE 65,A50,083695,Saad; Andrew S,12,0,30,18
1657266417537,ECE 65,A51,095125,Saad; Andrew S,25,0,26,1
1657266423562,ECE 109,A01,091882,Touri; Behrouz,19,0,70,51
1657266429589,ECE 180,A00,083140,Abi Samra; Nicholas Camill,1,0,30,29
1657266429589,ECE 180,B00,083141,Abi Samra; Nicholas Camill,0,0,30,30
1657266435624,MATH 10A,A01,083735,Patchell; Gregory David,2,0,30,28
1657266435624,MATH 10A,A02,083736,Patchell; Gregory David,20,0,30,10
1657266435624,MATH 10A,A03,083737,Patchell; Gregory David,16,0,30,14
1657266441659,MATH 10B,A01,083207,Lim; Seonhee,7,0,34,27
1657266441659,MATH 10B,A02,083208,Lim; Seonhee,9,0,35,26
1657266441659,MATH 10B,A03,093472,Lim; Seonhee,5,0,34,29
1657266441659,MATH 10B,B01,083739,Sinha; Shubham,11,0,30,19
1657266447688,MATH 18,A01,083743,Cinel; Cameron Alexander,6,0,30,24
1657266447688,MATH 18,A02,083744,Cinel; Cameron Alexander,17,0,30,13
1657266447688,MATH 18,A03,083745,Cinel; Cameron Alexander,8,0,30,22
1657266447688,MATH 18,B01,083748,Rideout; David Porter,4,0,37,33
1657266447688,MATH 18,B02,083749,Rideout; David Porter,4,0,36,32
1657266447688,MATH 18,B03,083750,Rideout; David Porter,2,0,37,35
1657266447688,MATH 18,B04,083751,Rideout; David Porter,6,0,36,30
1657266447688,MATH 18,B05,093473,Rideout; David Porter,5,0,36,31
1657266447688,MATH 18,B06,093474,Rideout; David Porter,5,0,36,31
1657266453713,MATH 20A,A01,083754,Zheng; Zequn,14,0,40,26
1657266459743,MATH 20B,A01,083756,Briones; Jor-el Thomas Caparas,3,0,36,33
1657266459743,MATH 20B,A02,083757,Briones; Jor-el Thomas Caparas,1,0,36,35
1657266459743,MATH 20B,A03,093475,Briones; Jor-el Thomas Caparas,2,0,36,34
1657266465776,MATH 20C,A01,083760,Briones; Jor-el Thomas Caparas,1,0,35,34
1657266465776,MATH 20C,A02,083761,Briones; Jor-el Thomas Caparas,8,0,35,27
1657266465776,MATH 20C,A03,093476,Briones; Jor-el Thomas Caparas,0,1,36,36
1657266465776,MATH 20C,B01,083762,Bach; Quang Tran,1,0,30,29
1657266471804,MATH 20D,A01,083765,Tran; Brian Kha,4,0,30,26
1657266471804,MATH 20D,A02,083766,Tran; Brian Kha,5,0,30,25
1657266471804,MATH 20D,A03,083767,Tran; Brian Kha,4,0,30,26
1657266477837,MATH 20E,A01,083771,Ganguly; Soumya,7,0,32,25
1657266477837,MATH 20E,A02,083772,Ganguly; Soumya,7,0,32,25
1657266477837,MATH 20E,B01,083773,Ciotti; Benjamin,19,0,35,16
1657266477837,MATH 20E,B02,083774,Ciotti; Benjamin,17,0,35,18
1657266483870,MATH 103A,A01,083777,Greenfeld; Be'Eri,3,0,36,33
1657266483870,MATH 103A,A02,083778,Greenfeld; Be'Eri,5,0,36,31
1657266483870,MATH 103A,A03,093561,Greenfeld; Be'Eri,4,0,36,32
1657266483870,MATH 103A,B01,083779,Greenfeld; Be'Eri,6,0,36,30
1657266483870,MATH 103A,B02,083780,Greenfeld; Be'Eri,3,0,36,33
1657266483870,MATH 103A,B03,093562,Greenfeld; Be'Eri,3,0,36,33
1657266489907,MATH 105,A01,085443,Carter; Anne Toulson,15,0,35,20
1657266489907,MATH 105,A02,093477,Carter; Anne Toulson,20,0,35,15
1657266495939,MATH 109,A01,083213,Ganzberger; Geoffrey Michael,2,0,34,32
1657266495939,MATH 109,A02,083214,Ganzberger; Geoffrey Michael,4,0,34,30
1657266495939,MATH 109,A03,093478,Ganzberger; Geoffrey Michael,2,0,34,32
1657266495939,MATH 109,B01,083215,Ganzberger; Geoffrey Michael,1,0,32,31
1657266495939,MATH 109,B02,083216,Ganzberger; Geoffrey Michael,1,0,32,31
1657266495939,MATH 109,B03,093479,Ganzberger; Geoffrey Michael,8,0,32,24
1657266501972,MATH 142A,A01,083219,Chow; Bennett,7,0,32,25
1657266501972,MATH 142A,A02,083220,Chow; Bennett,10,0,32,22
1657266501972,MATH 142A,A03,093480,Chow; Bennett,7,0,32,25
1657266501972,MATH 142A,B03,093481,Chow; Bennett,8,0,32,24
1657266501972,MATH 142A,B04,093558,Chow; Bennett,12,0,32,20
1657266501972,MATH 142A,B05,093559,Chow; Bennett,6,0,32,26
1657266508006,MATH 193A,A01,083224,Rotar; Vladimir,7,0,34,27
1657266508006,MATH 193A,A02,083225,Rotar; Vladimir,6,0,34,28
1657266508006,MATH 193A,A03,083781,Rotar; Vladimir,2,0,34,32
1657266508006,MATH 193A,A04,083782,Rotar; Vladimir,8,0,34,26
1657266508006,MATH 193A,A05,093482,Rotar; Vladimir,6,0,34,28
1657266514032,MATH 197,001,091859,McAuley; Julian John,9999,0,9999,0
1657266514032,MATH 197,002,095566,Kedlaya; Kiran S.,9997,0,9999,2
1657266514032,MATH 197,003,095567,Xiao; Ming,9999,0,9999,0
1657266514032,MATH 197,004,095571,Perols; Johan Lars,9998,0,9999,1
1657266521194,COGS 9,A01,083615,Shannon; Kyle Michael,8,0,75,67
1657266527223,COGS 11,A01,083617,Boyle; Mary E. T.,22,0,48,26
1657266533249,COGS 13,A01,083071,Bastos; Amalia Pinkusfeld,9,0,71,62
1657266539276,COGS 14A,A01,092681,Semenuks; Arturs,2,1,100,98
1657266545303,COGS 14B,A01,083073,Cheng; Tzu-Han,6,0,63,57
1657266551329,COGS 17,A01,092677,Semenuks; Arturs,5,0,81,76
1657266557355,COGS 100,A01,083619,Allen; Michael Gordon,16,0,70,54
1657266563379,COGS 101A,A01,083621,Davis; Joshua Daniel,9,0,68,59
1657266569406,COGS 101B,A01,091572,Allen; Michael Gordon,11,0,65,54
1657266575442,COGS 101C,A01,083625,Delgado; Tania,17,0,35,18
1657266581467,COGS 107A,A01,083627,Boyle; Mary E. T.,13,0,60,47
1657266587497,COGS 118A,A01,083075,Gupta; Anjum,18,0,76,58
1657266593563,CSE 3,A50,083646,Miranda; Gregory Joseph,24,0,50,26
1657266599587,CSE 8A,A50,083650,Miranda; Gregory Joseph,17,1,56,39
1657266605611,CSE 11,A01,083080,Cao; Yingjun,5,15,40,35
1657266611645,CSE 12,A01,083652,Krause-Levy; Sophia Louisa,26,1,120,94
1657266617676,CSE 15L,A01,083654,Morris; Justin Loren,9,0,50,41
1657266617676,CSE 15L,A02,083655,Morris; Justin Loren,9,0,50,41
1657266623701,CSE 20,A01,083657,Tran; Khoa Dang,38,0,80,42
1657266629725,CSE 21,A01,095574,Bach; Quang Tran,22,0,48,26
1657266635762,CSE 30,A01,083084,Eldon; John,4,0,80,76
1657266635762,CSE 30,B01,095061,Bhaskar; Nishant,8,0,50,42
1657266641794,CSE 100,A01,083659,Cao; Yingjun,4,4,70,66
1657266647820,CSE 134B,A01,083661,Powell; Thomas Allan,21,0,100,79
1657266653855,CSE 140,A01,083663,Gungor; Onat,13,0,85,72
1657266659878,CSE 140L,A01,083088,Eldon; John,19,0,100,81
1657266665904,CSE 175,A01,083665,Kumar; Rakesh,3,0,25,22
1657266671933,CSE 190,A00,092507,Dubnov; Shlomo,7,0,20,13
1657266677966,ECE 45,A01,083139,Congero; Spencer William,5,0,75,70
1657266684002,ECE 65,A50,083695,Saad; Andrew S,12,0,30,18
1657266684002,ECE 65,A51,095125,Saad; Andrew S,25,0,26,1
1657266690026,ECE 109,A01,091882,Touri; Behrouz,19,0,70,51
1657266696050,ECE 180,A00,083140,Abi Samra; Nicholas Camill,1,0,30,29
1657266696050,ECE 180,B00,083141,Abi Samra; Nicholas Camill,0,0,30,30
1657266702086,MATH 10A,A01,083735,Patchell; Gregory David,2,0,30,28
1657266702086,MATH 10A,A02,083736,Patchell; Gregory David,20,0,30,10
1657266702086,MATH 10A,A03,083737,Patchell; Gregory David,16,0,30,14
1657266708122,MATH 10B,A01,083207,Lim; Seonhee,7,0,34,27
1657266708122,MATH 10B,A02,083208,Lim; Seonhee,9,0,35,26
1657266708122,MATH 10B,A03,093472,Lim; Seonhee,5,0,34,29
1657266708122,MATH 10B,B01,083739,Sinha; Shubham,11,0,30,19
1657266714152,MATH 18,A01,083743,Cinel; Cameron Alexander,6,0,30,24
1657266714152,MATH 18,A02,083744,Cinel; Cameron Alexander,17,0,30,13
1657266714152,MATH 18,A03,083745,Cinel; Cameron Alexander,8,0,30,22
1657266714152,MATH 18,B01,083748,Rideout; David Porter,4,0,37,33
1657266714152,MATH 18,B02,083749,Rideout; David Porter,4,0,36,32
1657266714152,MATH 18,B03,083750,Rideout; David Porter,2,0,37,35
1657266714152,MATH 18,B04,083751,Rideout; David Porter,6,0,36,30
1657266714152,MATH 18,B05,093473,Rideout; David Porter,5,0,36,31
1657266714152,MATH 18,B06,093474,Rideout; David Porter,5,0,36,31
1657266720188,MATH 20A,A01,083754,Zheng; Zequn,14,0,40,26
1657266726215,MATH 20B,A01,083756,Briones; Jor-el Thomas Caparas,3,0,36,33
1657266726215,MATH 20B,A02,083757,Briones; Jor-el Thomas Caparas,1,0,36,35
1657266726215,MATH 20B,A03,093475,Briones; Jor-el Thomas Caparas,2,0,36,34
1657266732241,MATH 20C,A01,083760,Briones; Jor-el Thomas Caparas,1,0,35,34
1657266732241,MATH 20C,A02,083761,Briones; Jor-el Thomas Caparas,8,0,35,27
1657266732241,MATH 20C,A03,093476,Briones; Jor-el Thomas Caparas,0,1,36,36
1657266732241,MATH 20C,B01,083762,Bach; Quang Tran,1,0,30,29
1657266738267,MATH 20D,A01,083765,Tran; Brian Kha,4,0,30,26
1657266738267,MATH 20D,A02,083766,Tran; Brian Kha,5,0,30,25
1657266738267,MATH 20D,A03,083767,Tran; Brian Kha,4,0,30,26
1657266744304,MATH 20E,A01,083771,Ganguly; Soumya,7,0,32,25
1657266744304,MATH 20E,A02,083772,Ganguly; Soumya,7,0,32,25
1657266744304,MATH 20E,B01,083773,Ciotti; Benjamin,19,0,35,16
1657266744304,MATH 20E,B02,083774,Ciotti; Benjamin,17,0,35,18
1657266750345,MATH 103A,A01,083777,Greenfeld; Be'Eri,3,0,36,33
1657266750345,MATH 103A,A02,083778,Greenfeld; Be'Eri,5,0,36,31
1657266750345,MATH 103A,A03,093561,Greenfeld; Be'Eri,4,0,36,32
1657266750345,MATH 103A,B01,083779,Greenfeld; Be'Eri,6,0,36,30
1657266750345,MATH 103A,B02,083780,Greenfeld; Be'Eri,3,0,36,33
1657266750345,MATH 103A,B03,093562,Greenfeld; Be'Eri,3,0,36,33
1657266756370,MATH 105,A01,085443,Carter; Anne Toulson,15,0,35,20
1657266756370,MATH 105,A02,093477,Carter; Anne Toulson,20,0,35,15
1657266762402,MATH 109,A01,083213,Ganzberger; Geoffrey Michael,2,0,34,32
1657266762402,MATH 109,A02,083214,Ganzberger; Geoffrey Michael,4,0,34,30
1657266762402,MATH 109,A03,093478,Ganzberger; Geoffrey Michael,2,0,34,32
1657266762402,MATH 109,B01,083215,Ganzberger; Geoffrey Michael,1,0,32,31
1657266762402,MATH 109,B02,083216,Ganzberger; Geoffrey Michael,1,0,32,31
1657266762402,MATH 109,B03,093479,Ganzberger; Geoffrey Michael,8,0,32,24
1657266768435,MATH 142A,A01,083219,Chow; Bennett,7,0,32,25
1657266768435,MATH 142A,A02,083220,Chow; Bennett,10,0,32,22
1657266768435,MATH 142A,A03,093480,Chow; Bennett,7,0,32,25
1657266768435,MATH 142A,B03,093481,Chow; Bennett,8,0,32,24
1657266768435,MATH 142A,B04,093558,Chow; Bennett,12,0,32,20
1657266768435,MATH 142A,B05,093559,Chow; Bennett,6,0,32,26
1657266774462,MATH 193A,A01,083224,Rotar; Vladimir,7,0,34,27
1657266774462,MATH 193A,A02,083225,Rotar; Vladimir,6,0,34,28
1657266774462,MATH 193A,A03,083781,Rotar; Vladimir,2,0,34,32
1657266774462,MATH 193A,A04,083782,Rotar; Vladimir,8,0,34,26
1657266774462,MATH 193A,A05,093482,Rotar; Vladimir,6,0,34,28
1657266780488,MATH 197,001,091859,McAuley; Julian John,9999,0,9999,0
1657266780488,MATH 197,002,095566,Kedlaya; Kiran S.,9997,0,9999,2
1657266780488,MATH 197,003,095567,Xiao; Ming,9999,0,9999,0
1657266780488,MATH 197,004,095571,Perols; Johan Lars,9998,0,9999,1
1657266787558,COGS 9,A01,083615,Shannon; Kyle Michael,8,0,75,67
1657266793583,COGS 11,A01,083617,Boyle; Mary E. T.,22,0,48,26
1657266799616,COGS 13,A01,083071,Bastos; Amalia Pinkusfeld,9,0,71,62
1657266805646,COGS 14A,A01,092681,Semenuks; Arturs,2,1,100,98
1657266811671,COGS 14B,A01,083073,Cheng; Tzu-Han,6,0,63,57
1657266817697,COGS 17,A01,092677,Semenuks; Arturs,5,0,81,76
1657266823726,COGS 100,A01,083619,Allen; Michael Gordon,16,0,70,54
1657266829755,COGS 101A,A01,083621,Davis; Joshua Daniel,9,0,68,59
1657266835778,COGS 101B,A01,091572,Allen; Michael Gordon,11,0,65,54
1657266841802,COGS 101C,A01,083625,Delgado; Tania,17,0,35,18
1657266847830,COGS 107A,A01,083627,Boyle; Mary E. T.,13,0,60,47
1657266853854,COGS 118A,A01,083075,Gupta; Anjum,18,0,76,58
1657266859880,CSE 3,A50,083646,Miranda; Gregory Joseph,24,0,50,26
1657266865904,CSE 8A,A50,083650,Miranda; Gregory Joseph,17,1,56,39
1657266871929,CSE 11,A01,083080,Cao; Yingjun,5,15,40,35
1657266877971,CSE 12,A01,083652,Krause-Levy; Sophia Louisa,26,1,120,94
1657266883995,CSE 15L,A01,083654,Morris; Justin Loren,9,0,50,41
1657266883995,CSE 15L,A02,083655,Morris; Justin Loren,9,0,50,41
1657266890021,CSE 20,A01,083657,Tran; Khoa Dang,38,0,80,42
1657266896046,CSE 21,A01,095574,Bach; Quang Tran,22,0,48,26
1657266902071,CSE 30,A01,083084,Eldon; John,4,0,80,76
1657266902071,CSE 30,B01,095061,Bhaskar; Nishant,8,0,50,42
1657266908095,CSE 100,A01,083659,Cao; Yingjun,4,4,70,66
1657266914121,CSE 134B,A01,083661,Powell; Thomas Allan,21,0,100,79
1657266920150,CSE 140,A01,083663,Gungor; Onat,13,0,85,72
1657266926185,CSE 140L,A01,083088,Eldon; John,19,0,100,81
1657266932209,CSE 175,A01,083665,Kumar; Rakesh,3,0,25,22
1657266938237,CSE 190,A00,092507,Dubnov; Shlomo,7,0,20,13
1657266944262,ECE 45,A01,083139,Congero; Spencer William,5,0,75,70
1657266950286,ECE 65,A50,083695,Saad; Andrew S,12,0,30,18
1657266950286,ECE 65,A51,095125,Saad; Andrew S,25,0,26,1
1657266956311,ECE 109,A01,091882,Touri; Behrouz,19,0,70,51
1657266962334,ECE 180,A00,083140,Abi Samra; Nicholas Camill,1,0,30,29
1657266962334,ECE 180,B00,083141,Abi Samra; Nicholas Camill,0,0,30,30
1657266968359,MATH 10A,A01,083735,Patchell; Gregory David,2,0,30,28
1657266968359,MATH 10A,A02,083736,Patchell; Gregory David,20,0,30,10
1657266968359,MATH 10A,A03,083737,Patchell; Gregory David,16,0,30,14
1657266974394,MATH 10B,A01,083207,Lim; Seonhee,7,0,34,27
1657266974394,MATH 10B,A02,083208,Lim; Seonhee,9,0,35,26
1657266974394,MATH 10B,A03,093472,Lim; Seonhee,5,0,34,29
1657266974394,MATH 10B,B01,083739,Sinha; Shubham,11,0,30,19
1657266980423,MATH 18,A01,083743,Cinel; Cameron Alexander,6,0,30,24
1657266980423,MATH 18,A02,083744,Cinel; Cameron Alexander,17,0,30,13
1657266980423,MATH 18,A03,083745,Cinel; Cameron Alexander,8,0,30,22
1657266980423,MATH 18,B01,083748,Rideout; David Porter,4,0,37,33
1657266980423,MATH 18,B02,083749,Rideout; David Porter,4,0,36,32
1657266980423,MATH 18,B03,083750,Rideout; David Porter,2,0,37,35
1657266980423,MATH 18,B04,083751,Rideout; David Porter,6,0,36,30
1657266980423,MATH 18,B05,093473,Rideout; David Porter,5,0,36,31
1657266980423,MATH 18,B06,093474,Rideout; David Porter,5,0,36,31
1657266986451,MATH 20A,A01,083754,Zheng; Zequn,14,0,40,26
1657266992484,MATH 20B,A01,083756,Briones; Jor-el Thomas Caparas,3,0,36,33
1657266992484,MATH 20B,A02,083757,Briones; Jor-el Thomas Caparas,1,0,36,35
1657266992484,MATH 20B,A03,093475,Briones; Jor-el Thomas Caparas,2,0,36,34
1657266998514,MATH 20C,A01,083760,Briones; Jor-el Thomas Caparas,1,0,35,34
1657266998514,MATH 20C,A02,083761,Briones; Jor-el Thomas Caparas,8,0,35,27
1657266998514,MATH 20C,A03,093476,Briones; Jor-el Thomas Caparas,0,1,36,36
1657266998514,MATH 20C,B01,083762,Bach; Quang Tran,1,0,30,29
1657267004539,MATH 20D,A01,083765,Tran; Brian Kha,4,0,30,26
1657267004539,MATH 20D,A02,083766,Tran; Brian Kha,5,0,30,25
1657267004539,MATH 20D,A03,083767,Tran; Brian Kha,4,0,30,26
1657267010566,MATH 20E,A01,083771,Ganguly; Soumya,7,0,32,25
1657267010566,MATH 20E,A02,083772,Ganguly; Soumya,7,0,32,25
1657267010566,MATH 20E,B01,083773,Ciotti; Benjamin,19,0,35,16
1657267010566,MATH 20E,B02,083774,Ciotti; Benjamin,17,0,35,18
1657267016594,MATH 103A,A01,083777,Greenfeld; Be'Eri,3,0,36,33
1657267016594,MATH 103A,A02,083778,Greenfeld; Be'Eri,5,0,36,31
1657267016594,MATH 103A,A03,093561,Greenfeld; Be'Eri,4,0,36,32
1657267016594,MATH 103A,B01,083779,Greenfeld; Be'Eri,6,0,36,30
1657267016594,MATH 103A,B02,083780,Greenfeld; Be'Eri,3,0,36,33
1657267016594,MATH 103A,B03,093562,Greenfeld; Be'Eri,3,0,36,33
1657267022646,MATH 105,A01,085443,Carter; Anne Toulson,15,0,35,20
1657267022646,MATH 105,A02,093477,Carter; Anne Toulson,20,0,35,15
1657267028672,MATH 109,A01,083213,Ganzberger; Geoffrey Michael,2,0,34,32
1657267028672,MATH 109,A02,083214,Ganzberger; Geoffrey Michael,4,0,34,30
1657267028672,MATH 109,A03,093478,Ganzberger; Geoffrey Michael,2,0,34,32
1657267028672,MATH 109,B01,083215,Ganzberger; Geoffrey Michael,1,0,32,31
1657267028672,MATH 109,B02,083216,Ganzberger; Geoffrey Michael,1,0,32,31
1657267028672,MATH 109,B03,093479,Ganzberger; Geoffrey Michael,8,0,32,24
1657267034699,MATH 142A,A01,083219,Chow; Bennett,7,0,32,25
1657267034699,MATH 142A,A02,083220,Chow; Bennett,10,0,32,22
1657267034699,MATH 142A,A03,093480,Chow; Bennett,7,0,32,25
1657267034699,MATH 142A,B03,093481,Chow; Bennett,8,0,32,24
1657267034699,MATH 142A,B04,093558,Chow; Bennett,12,0,32,20
1657267034699,MATH 142A,B05,093559,Chow; Bennett,6,0,32,26
1657267040734,MATH 193A,A01,083224,Rotar; Vladimir,7,0,34,27
1657267040734,MATH 193A,A02,083225,Rotar; Vladimir,6,0,34,28
1657267040734,MATH 193A,A03,083781,Rotar; Vladimir,2,0,34,32
1657267040734,MATH 193A,A04,083782,Rotar; Vladimir,8,0,34,26
1657267040734,MATH 193A,A05,093482,Rotar; Vladimir,6,0,34,28
1657267046765,MATH 197,001,091859,McAuley; Julian John,9999,0,9999,0
1657267046765,MATH 197,002,095566,Kedlaya; Kiran S.,9997,0,9999,2
1657267046765,MATH 197,003,095567,Xiao; Ming,9999,0,9999,0
1657267046765,MATH 197,004,095571,Perols; Johan Lars,9998,0,9999,1
1657267053831,COGS 9,A01,083615,Shannon; Kyle Michael,8,0,75,67
1657267059860,COGS 11,A01,083617,Boyle; Mary E. T.,22,0,48,26
1657267065885,COGS 13,A01,083071,Bastos; Amalia Pinkusfeld,9,0,71,62
1657267071914,COGS 14A,A01,092681,Semenuks; Arturs,2,1,100,98
1657267077939,COGS 14B,A01,083073,Cheng; Tzu-Han,6,0,63,57
1657267083964,COGS 17,A01,092677,Semenuks; Arturs,5,0,81,76
1657267089991,COGS 100,A01,083619,Allen; Michael Gordon,16,0,70,54
1657267096021,COGS 101A,A01,083621,Davis; Joshua Daniel,9,0,68,59
1657267102052,COGS 101B,A01,091572,Allen; Michael Gordon,11,0,65,54
1657267108089,COGS 101C,A01,083625,Delgado; Tania,17,0,35,18
1657267114213,COGS 107A,A01,083627,Boyle; Mary E. T.,13,0,60,47
1657267120244,COGS 118A,A01,083075,Gupta; Anjum,18,0,76,58
1657267126275,CSE 3,A50,083646,Miranda; Gregory Joseph,24,0,50,26
1657267132305,CSE 8A,A50,083650,Miranda; Gregory Joseph,17,1,56,39
1657267138329,CSE 11,A01,083080,Cao; Yingjun,5,15,40,35
1657267144355,CSE 12,A01,083652,Krause-Levy; Sophia Louisa,26,1,120,94
1657267150379,CSE 15L,A01,083654,Morris; Justin Loren,9,0,50,41
1657267150379,CSE 15L,A02,083655,Morris; Justin Loren,9,0,50,41
1657267156415,CSE 20,A01,083657,Tran; Khoa Dang,38,0,80,42
1657267162440,CSE 21,A01,095574,Bach; Quang Tran,22,0,48,26
1657267168479,CSE 30,A01,083084,Eldon; John,4,0,80,76
1657267168479,CSE 30,B01,095061,Bhaskar; Nishant,8,0,50,42
1657267174509,CSE 100,A01,083659,Cao; Yingjun,4,4,70,66
1657267180533,CSE 134B,A01,083661,Powell; Thomas Allan,21,0,100,79
1657267186571,CSE 140,A01,083663,Gungor; Onat,13,0,85,72
1657267192595,CSE 140L,A01,083088,Eldon; John,19,0,100,81
1657267198618,CSE 175,A01,083665,Kumar; Rakesh,3,0,25,22
1657267204644,CSE 190,A00,092507,Dubnov; Shlomo,7,0,20,13
1657267210676,ECE 45,A01,083139,Congero; Spencer William,5,0,75,70
1657267216701,ECE 65,A50,083695,Saad; Andrew S,12,0,30,18
1657267216701,ECE 65,A51,095125,Saad; Andrew S,25,0,26,1
1657267222734,ECE 109,A01,091882,Touri; Behrouz,19,0,70,51
1657267228773,ECE 180,A00,083140,Abi Samra; Nicholas Camill,1,0,30,29
1657267228773,ECE 180,B00,083141,Abi Samra; Nicholas Camill,0,0,30,30
1657267234815,MATH 10A,A01,083735,Patchell; Gregory David,2,0,30,28
1657267234815,MATH 10A,A02,083736,Patchell; Gregory David,20,0,30,10
1657267234815,MATH 10A,A03,083737,Patchell; Gregory David,16,0,30,14
1657267240848,MATH 10B,A01,083207,Lim; Seonhee,7,0,34,27
1657267240848,MATH 10B,A02,083208,Lim; Seonhee,9,0,35,26
1657267240848,MATH 10B,A03,093472,Lim; Seonhee,5,0,34,29
1657267240848,MATH 10B,B01,083739,Sinha; Shubham,11,0,30,19
1657267246875,MATH 18,A01,083743,Cinel; Cameron Alexander,6,0,30,24
1657267246875,MATH 18,A02,083744,Cinel; Cameron Alexander,17,0,30,13
1657267246875,MATH 18,A03,083745,Cinel; Cameron Alexander,8,0,30,22
1657267246875,MATH 18,B01,083748,Rideout; David Porter,4,0,37,33
1657267246875,MATH 18,B02,083749,Rideout; David Porter,4,0,36,32
1657267246875,MATH 18,B03,083750,Rideout; David Porter,2,0,37,35
1657267246875,MATH 18,B04,083751,Rideout; David Porter,6,0,36,30
1657267246875,MATH 18,B05,093473,Rideout; David Porter,5,0,36,31
1657267246875,MATH 18,B06,093474,Rideout; David Porter,5,0,36,31
1657267252905,MATH 20A,A01,083754,Zheng; Zequn,14,0,40,26
1657267258938,MATH 20B,A01,083756,Briones; Jor-el Thomas Caparas,3,0,36,33
1657267258938,MATH 20B,A02,083757,Briones; Jor-el Thomas Caparas,1,0,36,35
1657267258938,MATH 20B,A03,093475,Briones; Jor-el Thomas Caparas,2,0,36,34
1657267264976,MATH 20C,A01,083760,Briones; Jor-el Thomas Caparas,1,0,35,34
1657267264976,MATH 20C,A02,083761,Briones; Jor-el Thomas Caparas,8,0,35,27
1657267264976,MATH 20C,A03,093476,Briones; Jor-el Thomas Caparas,0,1,36,36
1657267264976,MATH 20C,B01,083762,Bach; Quang Tran,1,0,30,29
1657267271000,MATH 20D,A01,083765,Tran; Brian Kha,4,0,30,26
1657267271000,MATH 20D,A02,083766,Tran; Brian Kha,5,0,30,25
1657267271000,MATH 20D,A03,083767,Tran; Brian Kha,4,0,30,26
1657267277032,MATH 20E,A01,083771,Ganguly; Soumya,7,0,32,25
1657267277032,MATH 20E,A02,083772,Ganguly; Soumya,7,0,32,25
1657267277032,MATH 20E,B01,083773,Ciotti; Benjamin,19,0,35,16
1657267277032,MATH 20E,B02,083774,Ciotti; Benjamin,17,0,35,18
1657267283070,MATH 103A,A01,083777,Greenfeld; Be'Eri,3,0,36,33
1657267283070,MATH 103A,A02,083778,Greenfeld; Be'Eri,5,0,36,31
1657267283070,MATH 103A,A03,093561,Greenfeld; Be'Eri,4,0,36,32
1657267283070,MATH 103A,B01,083779,Greenfeld; Be'Eri,6,0,36,30
1657267283070,MATH 103A,B02,083780,Greenfeld; Be'Eri,3,0,36,33
1657267283070,MATH 103A,B03,093562,Greenfeld; Be'Eri,3,0,36,33
1657267289100,MATH 105,A01,085443,Carter; Anne Toulson,15,0,35,20
1657267289100,MATH 105,A02,093477,Carter; Anne Toulson,20,0,35,15
1657267295131,MATH 109,A01,083213,Ganzberger; Geoffrey Michael,2,0,34,32
1657267295131,MATH 109,A02,083214,Ganzberger; Geoffrey Michael,4,0,34,30
1657267295131,MATH 109,A03,093478,Ganzberger; Geoffrey Michael,2,0,34,32
1657267295131,MATH 109,B01,083215,Ganzberger; Geoffrey Michael,1,0,32,31
1657267295131,MATH 109,B02,083216,Ganzberger; Geoffrey Michael,1,0,32,31
1657267295131,MATH 109,B03,093479,Ganzberger; Geoffrey Michael,8,0,32,24
1657267301163,MATH 142A,A01,083219,Chow; Bennett,7,0,32,25
1657267301163,MATH 142A,A02,083220,Chow; Bennett,10,0,32,22
1657267301163,MATH 142A,A03,093480,Chow; Bennett,7,0,32,25
1657267301163,MATH 142A,B03,093481,Chow; Bennett,8,0,32,24
1657267301163,MATH 142A,B04,093558,Chow; Bennett,12,0,32,20
1657267301163,MATH 142A,B05,093559,Chow; Bennett,6,0,32,26
1657267307192,MATH 193A,A01,083224,Rotar; Vladimir,7,0,34,27
1657267307192,MATH 193A,A02,083225,Rotar; Vladimir,6,0,34,28
1657267307192,MATH 193A,A03,083781,Rotar; Vladimir,2,0,34,32
1657267307192,MATH 193A,A04,083782,Rotar; Vladimir,8,0,34,26
1657267307192,MATH 193A,A05,093482,Rotar; Vladimir,6,0,34,28
1657267313233,MATH 197,001,091859,McAuley; Julian John,9999,0,9999,0
1657267313233,MATH 197,002,095566,Kedlaya; Kiran S.,9997,0,9999,2
1657267313233,MATH 197,003,095567,Xiao; Ming,9999,0,9999,0
1657267313233,MATH 197,004,095571,Perols; Johan Lars,9998,0,9999,1
1657267320304,COGS 9,A01,083615,Shannon; Kyle Michael,8,0,75,67
1657267326327,COGS 11,A01,083617,Boyle; Mary E. T.,22,0,48,26
1657267332353,COGS 13,A01,083071,Bastos; Amalia Pinkusfeld,9,0,71,62
1657267338384,COGS 14A,A01,092681,Semenuks; Arturs,2,1,100,98
1657267344412,COGS 14B,A01,083073,Cheng; Tzu-Han,6,0,63,57
1657267350438,COGS 17,A01,092677,Semenuks; Arturs,5,0,81,76
1657267356468,COGS 100,A01,083619,Allen; Michael Gordon,16,0,70,54
1657267362493,COGS 101A,A01,083621,Davis; Joshua Daniel,9,0,68,59
1657267368517,COGS 101B,A01,091572,Allen; Michael Gordon,11,0,65,54
1657267374552,COGS 101C,A01,083625,Delgado; Tania,17,0,35,18
1657267380576,COGS 107A,A01,083627,Boyle; Mary E. T.,13,0,60,47
1657267386606,COGS 118A,A01,083075,Gupta; Anjum,18,0,76,58
1657267392635,CSE 3,A50,083646,Miranda; Gregory Joseph,24,0,50,26
1657267398658,CSE 8A,A50,083650,Miranda; Gregory Joseph,17,1,56,39
1657267404684,CSE 11,A01,083080,Cao; Yingjun,5,15,40,35
1657267410718,CSE 12,A01,083652,Krause-Levy; Sophia Louisa,26,1,120,94
1657267416748,CSE 15L,A01,083654,Morris; Justin Loren,9,0,50,41
1657267416748,CSE 15L,A02,083655,Morris; Justin Loren,9,0,50,41
1657267422777,CSE 20,A01,083657,Tran; Khoa Dang,38,0,80,42
1657267428806,CSE 21,A01,095574,Bach; Quang Tran,22,0,48,26
1657267434840,CSE 30,A01,083084,Eldon; John,4,0,80,76
1657267434840,CSE 30,B01,095061,Bhaskar; Nishant,8,0,50,42
1657267440863,CSE 100,A01,083659,Cao; Yingjun,4,4,70,66
1657267446896,CSE 134B,A01,083661,Powell; Thomas Allan,21,0,100,79
1657267452918,CSE 140,A01,083663,Gungor; Onat,13,0,85,72
1657267458959,CSE 140L,A01,083088,Eldon; John,19,0,100,81
1657267464984,CSE 175,A01,083665,Kumar; Rakesh,3,0,25,22
1657267471009,CSE 190,A00,092507,Dubnov; Shlomo,7,0,20,13
1657267477039,ECE 45,A01,083139,Congero; Spencer William,5,0,75,70
1657267483071,ECE 65,A50,083695,Saad; Andrew S,12,0,30,18
1657267483071,ECE 65,A51,095125,Saad; Andrew S,25,0,26,1
1657267489102,ECE 109,A01,091882,Touri; Behrouz,19,0,70,51
1657267495129,ECE 180,A00,083140,Abi Samra; Nicholas Camill,1,0,30,29
1657267495129,ECE 180,B00,083141,Abi Samra; Nicholas Camill,0,0,30,30
1657267501155,MATH 10A,A01,083735,Patchell; Gregory David,2,0,30,28
1657267501155,MATH 10A,A02,083736,Patchell; Gregory David,20,0,30,10
1657267501155,MATH 10A,A03,083737,Patchell; Gregory David,16,0,30,14
1657267507192,MATH 10B,A01,083207,Lim; Seonhee,7,0,34,27
1657267507192,MATH 10B,A02,083208,Lim; Seonhee,9,0,35,26
1657267507192,MATH 10B,A03,093472,Lim; Seonhee,5,0,34,29
1657267507192,MATH 10B,B01,083739,Sinha; Shubham,11,0,30,19
1657267513221,MATH 18,A01,083743,Cinel; Cameron Alexander,6,0,30,24
1657267513221,MATH 18,A02,083744,Cinel; Cameron Alexander,17,0,30,13
1657267513221,MATH 18,A03,083745,Cinel; Cameron Alexander,8,0,30,22
1657267513221,MATH 18,B01,083748,Rideout; David Porter,4,0,37,33
1657267513221,MATH 18,B02,083749,Rideout; David Porter,4,0,36,32
1657267513221,MATH 18,B03,083750,Rideout; David Porter,2,0,37,35
1657267513221,MATH 18,B04,083751,Rideout; David Porter,6,0,36,30
1657267513221,MATH 18,B05,093473,Rideout; David Porter,5,0,36,31
1657267513221,MATH 18,B06,093474,Rideout; David Porter,5,0,36,31
1657267519250,MATH 20A,A01,083754,Zheng; Zequn,14,0,40,26
1657267525280,MATH 20B,A01,083756,Briones; Jor-el Thomas Caparas,3,0,36,33
1657267525280,MATH 20B,A02,083757,Briones; Jor-el Thomas Caparas,1,0,36,35
1657267525280,MATH 20B,A03,093475,Briones; Jor-el Thomas Caparas,2,0,36,34
1657267531310,MATH 20C,A01,083760,Briones; Jor-el Thomas Caparas,1,0,35,34
1657267531310,MATH 20C,A02,083761,Briones; Jor-el Thomas Caparas,8,0,35,27
1657267531310,MATH 20C,A03,093476,Briones; Jor-el Thomas Caparas,0,1,36,36
1657267531310,MATH 20C,B01,083762,Bach; Quang Tran,1,0,30,29
1657267537352,MATH 20D,A01,083765,Tran; Brian Kha,4,0,30,26
1657267537352,MATH 20D,A02,083766,Tran; Brian Kha,5,0,30,25
1657267537352,MATH 20D,A03,083767,Tran; Brian Kha,4,0,30,26
1657267543378,MATH 20E,A01,083771,Ganguly; Soumya,7,0,32,25
1657267543378,MATH 20E,A02,083772,Ganguly; Soumya,7,0,32,25
1657267543378,MATH 20E,B01,083773,Ciotti; Benjamin,19,0,35,16
1657267543378,MATH 20E,B02,083774,Ciotti; Benjamin,17,0,35,18
1657267549412,MATH 103A,A01,083777,Greenfeld; Be'Eri,3,0,36,33
1657267549412,MATH 103A,A02,083778,Greenfeld; Be'Eri,5,0,36,31
1657267549412,MATH 103A,A03,093561,Greenfeld; Be'Eri,4,0,36,32
1657267549412,MATH 103A,B01,083779,Greenfeld; Be'Eri,6,0,36,30
1657267549412,MATH 103A,B02,083780,Greenfeld; Be'Eri,3,0,36,33
1657267549412,MATH 103A,B03,093562,Greenfeld; Be'Eri,3,0,36,33
1657267555438,MATH 105,A01,085443,Carter; Anne Toulson,15,0,35,20
1657267555438,MATH 105,A02,093477,Carter; Anne Toulson,20,0,35,15
1657267561468,MATH 109,A01,083213,Ganzberger; Geoffrey Michael,2,0,34,32
1657267561468,MATH 109,A02,083214,Ganzberger; Geoffrey Michael,4,0,34,30
1657267561468,MATH 109,A03,093478,Ganzberger; Geoffrey Michael,2,0,34,32
1657267561468,MATH 109,B01,083215,Ganzberger; Geoffrey Michael,1,0,32,31
1657267561468,MATH 109,B02,083216,Ganzberger; Geoffrey Michael,1,0,32,31
1657267561468,MATH 109,B03,093479,Ganzberger; Geoffrey Michael,8,0,32,24
1657267567494,MATH 142A,A01,083219,Chow; Bennett,7,0,32,25
1657267567494,MATH 142A,A02,083220,Chow; Bennett,10,0,32,22
1657267567494,MATH 142A,A03,093480,Chow; Bennett,7,0,32,25
1657267567494,MATH 142A,B03,093481,Chow; Bennett,8,0,32,24
1657267567494,MATH 142A,B04,093558,Chow; Bennett,12,0,32,20
1657267567494,MATH 142A,B05,093559,Chow; Bennett,6,0,32,26
1657267573522,MATH 193A,A01,083224,Rotar; Vladimir,7,0,34,27
1657267573522,MATH 193A,A02,083225,Rotar; Vladimir,6,0,34,28
1657267573522,MATH 193A,A03,083781,Rotar; Vladimir,2,0,34,32
1657267573522,MATH 193A,A04,083782,Rotar; Vladimir,8,0,34,26
1657267573522,MATH 193A,A05,093482,Rotar; Vladimir,6,0,34,28
1657267579546,MATH 197,001,091859,McAuley; Julian John,9999,0,9999,0
1657267579546,MATH 197,002,095566,Kedlaya; Kiran S.,9997,0,9999,2
1657267579546,MATH 197,003,095567,Xiao; Ming,9999,0,9999,0
1657267579546,MATH 197,004,095571,Perols; Johan Lars,9998,0,9999,1
1657267586615,COGS 9,A01,083615,Shannon; Kyle Michael,8,0,75,67
1657267592642,COGS 11,A01,083617,Boyle; Mary E. T.,22,0,48,26
1657267598667,COGS 13,A01,083071,Bastos; Amalia Pinkusfeld,9,0,71,62
1657267604690,COGS 14A,A01,092681,Semenuks; Arturs,2,1,100,98
1657267610718,COGS 14B,A01,083073,Cheng; Tzu-Han,6,0,63,57
1657267616743,COGS 17,A01,092677,Semenuks; Arturs,5,0,81,76
1657267622768,COGS 100,A01,083619,Allen; Michael Gordon,16,0,70,54
1657267628798,COGS 101A,A01,083621,Davis; Joshua Daniel,9,0,68,59
1657267634827,COGS 101B,A01,091572,Allen; Michael Gordon,11,0,65,54
1657267640852,COGS 101C,A01,083625,Delgado; Tania,17,0,35,18
1657267646877,COGS 107A,A01,083627,Boyle; Mary E. T.,13,0,60,47
1657267652905,COGS 118A,A01,083075,Gupta; Anjum,18,0,76,58
1657267658930,CSE 3,A50,083646,Miranda; Gregory Joseph,24,0,50,26
1657267664954,CSE 8A,A50,083650,Miranda; Gregory Joseph,17,1,56,39
1657267670979,CSE 11,A01,083080,Cao; Yingjun,5,15,40,35
1657267677032,CSE 12,A01,083652,Krause-Levy; Sophia Louisa,26,1,120,94
1657267683055,CSE 15L,A01,083654,Morris; Justin Loren,9,0,50,41
1657267683055,CSE 15L,A02,083655,Morris; Justin Loren,9,0,50,41
1657267689078,CSE 20,A01,083657,Tran; Khoa Dang,38,0,80,42
1657267695108,CSE 21,A01,095574,Bach; Quang Tran,22,0,48,26
1657267701137,CSE 30,A01,083084,Eldon; John,4,0,80,76
1657267701137,CSE 30,B01,095061,Bhaskar; Nishant,8,0,50,42
1657267707163,CSE 100,A01,083659,Cao; Yingjun,4,4,70,66
1657267713259,CSE 134B,A01,083661,Powell; Thomas Allan,21,0,100,79
1657267719281,CSE 140,A01,083663,Gungor; Onat,13,0,85,72
1657267725308,CSE 140L,A01,083088,Eldon; John,19,0,100,81
1657267731333,CSE 175,A01,083665,Kumar; Rakesh,3,0,25,22
1657267737357,CSE 190,A00,092507,Dubnov; Shlomo,7,0,20,13
1657267743392,ECE 45,A01,083139,Congero; Spencer William,5,0,75,70
1657267749415,ECE 65,A50,083695,Saad; Andrew S,12,0,30,18
1657267749415,ECE 65,A51,095125,Saad; Andrew S,25,0,26,1
1657267755447,ECE 109,A01,091882,Touri; Behrouz,19,0,70,51
1657267761470,ECE 180,A00,083140,Abi Samra; Nicholas Camill,1,0,30,29
1657267761470,ECE 180,B00,083141,Abi Samra; Nicholas Camill,0,0,30,30
1657267767496,MATH 10A,A01,083735,Patchell; Gregory David,2,0,30,28
1657267767496,MATH 10A,A02,083736,Patchell; Gregory David,20,0,30,10
1657267767496,MATH 10A,A03,083737,Patchell; Gregory David,16,0,30,14
1657267773523,MATH 10B,A01,083207,Lim; Seonhee,7,0,34,27
1657267773523,MATH 10B,A02,083208,Lim; Seonhee,9,0,35,26
1657267773523,MATH 10B,A03,093472,Lim; Seonhee,5,0,34,29
1657267773523,MATH 10B,B01,083739,Sinha; Shubham,11,0,30,19
1657267779558,MATH 18,A01,083743,Cinel; Cameron Alexander,6,0,30,24
1657267779558,MATH 18,A02,083744,Cinel; Cameron Alexander,17,0,30,13
1657267779558,MATH 18,A03,083745,Cinel; Cameron Alexander,8,0,30,22
1657267779558,MATH 18,B01,083748,Rideout; David Porter,4,0,37,33
1657267779558,MATH 18,B02,083749,Rideout; David Porter,4,0,36,32
1657267779558,MATH 18,B03,083750,Rideout; David Porter,2,0,37,35
1657267779558,MATH 18,B04,083751,Rideout; David Porter,6,0,36,30
1657267779558,MATH 18,B05,093473,Rideout; David Porter,5,0,36,31
1657267779558,MATH 18,B06,093474,Rideout; David Porter,5,0,36,31
1657267785592,MATH 20A,A01,083754,Zheng; Zequn,14,0,40,26
1657267791619,MATH 20B,A01,083756,Briones; Jor-el Thomas Caparas,3,0,36,33
1657267791619,MATH 20B,A02,083757,Briones; Jor-el Thomas Caparas,1,0,36,35
1657267791619,MATH 20B,A03,093475,Briones; Jor-el Thomas Caparas,2,0,36,34
1657267797644,MATH 20C,A01,083760,Briones; Jor-el Thomas Caparas,1,0,35,34
1657267797644,MATH 20C,A02,083761,Briones; Jor-el Thomas Caparas,8,0,35,27
1657267797644,MATH 20C,A03,093476,Briones; Jor-el Thomas Caparas,0,1,36,36
1657267797644,MATH 20C,B01,083762,Bach; Quang Tran,1,0,30,29
1657267803672,MATH 20D,A01,083765,Tran; Brian Kha,4,0,30,26
1657267803672,MATH 20D,A02,083766,Tran; Brian Kha,5,0,30,25
1657267803672,MATH 20D,A03,083767,Tran; Brian Kha,4,0,30,26
1657267809713,MATH 20E,A01,083771,Ganguly; Soumya,7,0,32,25
1657267809713,MATH 20E,A02,083772,Ganguly; Soumya,7,0,32,25
1657267809713,MATH 20E,B01,083773,Ciotti; Benjamin,19,0,35,16
1657267809713,MATH 20E,B02,083774,Ciotti; Benjamin,17,0,35,18
1657267815751,MATH 103A,A01,083777,Greenfeld; Be'Eri,3,0,36,33
1657267815751,MATH 103A,A02,083778,Greenfeld; Be'Eri,5,0,36,31
1657267815751,MATH 103A,A03,093561,Greenfeld; Be'Eri,4,0,36,32
1657267815751,MATH 103A,B01,083779,Greenfeld; Be'Eri,6,0,36,30
1657267815751,MATH 103A,B02,083780,Greenfeld; Be'Eri,3,0,36,33
1657267815751,MATH 103A,B03,093562,Greenfeld; Be'Eri,3,0,36,33
1657267821778,MATH 105,A01,085443,Carter; Anne Toulson,15,0,35,20
1657267821778,MATH 105,A02,093477,Carter; Anne Toulson,20,0,35,15
1657267827803,MATH 109,A01,083213,Ganzberger; Geoffrey Michael,2,0,34,32
1657267827803,MATH 109,A02,083214,Ganzberger; Geoffrey Michael,4,0,34,30
1657267827803,MATH 109,A03,093478,Ganzberger; Geoffrey Michael,2,0,34,32
1657267827803,MATH 109,B01,083215,Ganzberger; Geoffrey Michael,1,0,32,31
1657267827803,MATH 109,B02,083216,Ganzberger; Geoffrey Michael,1,0,32,31
1657267827803,MATH 109,B03,093479,Ganzberger; Geoffrey Michael,8,0,32,24
1657267833831,MATH 142A,A01,083219,Chow; Bennett,7,0,32,25
1657267833831,MATH 142A,A02,083220,Chow; Bennett,10,0,32,22
1657267833831,MATH 142A,A03,093480,Chow; Bennett,7,0,32,25
1657267833831,MATH 142A,B03,093481,Chow; Bennett,8,0,32,24
1657267833831,MATH 142A,B04,093558,Chow; Bennett,12,0,32,20
1657267833831,MATH 142A,B05,093559,Chow; Bennett,6,0,32,26
1657267839873,MATH 193A,A01,083224,Rotar; Vladimir,7,0,34,27
1657267839873,MATH 193A,A02,083225,Rotar; Vladimir,6,0,34,28
1657267839873,MATH 193A,A03,083781,Rotar; Vladimir,2,0,34,32
1657267839873,MATH 193A,A04,083782,Rotar; Vladimir,8,0,34,26
1657267839873,MATH 193A,A05,093482,Rotar; Vladimir,6,0,34,28
1657267845904,MATH 197,001,091859,McAuley; Julian John,9999,0,9999,0
1657267845904,MATH 197,002,095566,Kedlaya; Kiran S.,9997,0,9999,2
1657267845904,MATH 197,003,095567,Xiao; Ming,9999,0,9999,0
1657267845904,MATH 197,004,095571,Perols; Johan Lars,9998,0,9999,1
1657267852986,COGS 9,A01,083615,Shannon; Kyle Michael,8,0,75,67
1657267859009,COGS 11,A01,083617,Boyle; Mary E. T.,22,0,48,26
1657267865033,COGS 13,A01,083071,Bastos; Amalia Pinkusfeld,9,0,71,62
1657267871059,COGS 14A,A01,092681,Semenuks; Arturs,2,1,100,98
1657267877087,COGS 14B,A01,083073,Cheng; Tzu-Han,6,0,63,57
1657267883113,COGS 17,A01,092677,Semenuks; Arturs,5,0,81,76
1657267889138,COGS 100,A01,083619,Allen; Michael Gordon,16,0,70,54
1657267895165,COGS 101A,A01,083621,Davis; Joshua Daniel,9,0,68,59
1657267901198,COGS 101B,A01,091572,Allen; Michael Gordon,11,0,65,54
1657267907223,COGS 101C,A01,083625,Delgado; Tania,17,0,35,18
1657267913263,COGS 107A,A01,083627,Boyle; Mary E. T.,13,0,60,47
1657267919299,COGS 118A,A01,083075,Gupta; Anjum,18,0,76,58
1657267925337,CSE 3,A50,083646,Miranda; Gregory Joseph,24,0,50,26
1657267931359,CSE 8A,A50,083650,Miranda; Gregory Joseph,17,1,56,39
1657267937384,CSE 11,A01,083080,Cao; Yingjun,5,15,40,35
1657267943419,CSE 12,A01,083652,Krause-Levy; Sophia Louisa,26,1,120,94
1657267949445,CSE 15L,A01,083654,Morris; Justin Loren,9,0,50,41
1657267949445,CSE 15L,A02,083655,Morris; Justin Loren,9,0,50,41
1657267955472,CSE 20,A01,083657,Tran; Khoa Dang,38,0,80,42
1657267961502,CSE 21,A01,095574,Bach; Quang Tran,22,0,48,26
1657267967530,CSE 30,A01,083084,Eldon; John,4,0,80,76
1657267967530,CSE 30,B01,095061,Bhaskar; Nishant,8,0,50,42
1657267973569,CSE 100,A01,083659,Cao; Yingjun,4,4,70,66
1657267979594,CSE 134B,A01,083661,Powell; Thomas Allan,21,0,100,79
1657267985620,CSE 140,A01,083663,Gungor; Onat,13,0,85,72
1657267991646,CSE 140L,A01,083088,Eldon; John,19,0,100,81
1657267997673,CSE 175,A01,083665,Kumar; Rakesh,3,0,25,22
1657268003697,CSE 190,A00,092507,Dubnov; Shlomo,7,0,20,13
1657268009723,ECE 45,A01,083139,Congero; Spencer William,5,0,75,70
1657268015750,ECE 65,A50,083695,Saad; Andrew S,12,0,30,18
1657268015750,ECE 65,A51,095125,Saad; Andrew S,25,0,26,1
1657268021775,ECE 109,A01,091882,Touri; Behrouz,19,0,70,51
1657268027800,ECE 180,A00,083140,Abi Samra; Nicholas Camill,1,0,30,29
1657268027800,ECE 180,B00,083141,Abi Samra; Nicholas Camill,0,0,30,30
1657268033826,MATH 10A,A01,083735,Patchell; Gregory David,2,0,30,28
1657268033826,MATH 10A,A02,083736,Patchell; Gregory David,20,0,30,10
1657268033826,MATH 10A,A03,083737,Patchell; Gregory David,16,0,30,14
1657268039872,MATH 10B,A01,083207,Lim; Seonhee,7,0,34,27
1657268039872,MATH 10B,A02,083208,Lim; Seonhee,9,0,35,26
1657268039872,MATH 10B,A03,093472,Lim; Seonhee,5,0,34,29
1657268039872,MATH 10B,B01,083739,Sinha; Shubham,11,0,30,19
1657268045904,MATH 18,A01,083743,Cinel; Cameron Alexander,6,0,30,24
1657268045904,MATH 18,A02,083744,Cinel; Cameron Alexander,17,0,30,13
1657268045904,MATH 18,A03,083745,Cinel; Cameron Alexander,8,0,30,22
1657268045904,MATH 18,B01,083748,Rideout; David Porter,4,0,37,33
1657268045904,MATH 18,B02,083749,Rideout; David Porter,4,0,36,32
1657268045904,MATH 18,B03,083750,Rideout; David Porter,2,0,37,35
1657268045904,MATH 18,B04,083751,Rideout; David Porter,6,0,36,30
1657268045904,MATH 18,B05,093473,Rideout; David Porter,5,0,36,31
1657268045904,MATH 18,B06,093474,Rideout; David Porter,5,0,36,31
1657268051939,MATH 20A,A01,083754,Zheng; Zequn,14,0,40,26
1657268057964,MATH 20B,A01,083756,Briones; Jor-el Thomas Caparas,3,0,36,33
1657268057964,MATH 20B,A02,083757,Briones; Jor-el Thomas Caparas,1,0,36,35
1657268057964,MATH 20B,A03,093475,Briones; Jor-el Thomas Caparas,2,0,36,34
1657268063996,MATH 20C,A01,083760,Briones; Jor-el Thomas Caparas,1,0,35,34
1657268063996,MATH 20C,A02,083761,Briones; Jor-el Thomas Caparas,8,0,35,27
1657268063996,MATH 20C,A03,093476,Briones; Jor-el Thomas Caparas,0,1,36,36
1657268063996,MATH 20C,B01,083762,Bach; Quang Tran,1,0,30,29
1657268070021,MATH 20D,A01,083765,Tran; Brian Kha,5,0,30,25
1657268070021,MATH 20D,A02,083766,Tran; Brian Kha,5,0,30,25
1657268070021,MATH 20D,A03,083767,Tran; Brian Kha,4,0,30,26
1657268076067,MATH 20E,A01,083771,Ganguly; Soumya,7,0,32,25
1657268076067,MATH 20E,A02,083772,Ganguly; Soumya,7,0,32,25
1657268076067,MATH 20E,B01,083773,Ciotti; Benjamin,19,0,35,16
1657268076067,MATH 20E,B02,083774,Ciotti; Benjamin,17,0,35,18
1657268082094,MATH 103A,A01,083777,Greenfeld; Be'Eri,3,0,36,33
1657268082094,MATH 103A,A02,083778,Greenfeld; Be'Eri,5,0,36,31
1657268082094,MATH 103A,A03,093561,Greenfeld; Be'Eri,4,0,36,32
1657268082094,MATH 103A,B01,083779,Greenfeld; Be'Eri,6,0,36,30
1657268082094,MATH 103A,B02,083780,Greenfeld; Be'Eri,3,0,36,33
1657268082094,MATH 103A,B03,093562,Greenfeld; Be'Eri,3,0,36,33
1657268088118,MATH 105,A01,085443,Carter; Anne Toulson,15,0,35,20
1657268088118,MATH 105,A02,093477,Carter; Anne Toulson,20,0,35,15
1657268094154,MATH 109,A01,083213,Ganzberger; Geoffrey Michael,2,0,34,32
1657268094154,MATH 109,A02,083214,Ganzberger; Geoffrey Michael,4,0,34,30
1657268094154,MATH 109,A03,093478,Ganzberger; Geoffrey Michael,2,0,34,32
1657268094154,MATH 109,B01,083215,Ganzberger; Geoffrey Michael,1,0,32,31
1657268094154,MATH 109,B02,083216,Ganzberger; Geoffrey Michael,1,0,32,31
1657268094154,MATH 109,B03,093479,Ganzberger; Geoffrey Michael,8,0,32,24
1657268100179,MATH 142A,A01,083219,Chow; Bennett,7,0,32,25
1657268100179,MATH 142A,A02,083220,Chow; Bennett,10,0,32,22
1657268100179,MATH 142A,A03,093480,Chow; Bennett,7,0,32,25
1657268100179,MATH 142A,B03,093481,Chow; Bennett,8,0,32,24
1657268100179,MATH 142A,B04,093558,Chow; Bennett,12,0,32,20
1657268100179,MATH 142A,B05,093559,Chow; Bennett,6,0,32,26
1657268106219,MATH 193A,A01,083224,Rotar; Vladimir,7,0,34,27
1657268106219,MATH 193A,A02,083225,Rotar; Vladimir,6,0,34,28
1657268106219,MATH 193A,A03,083781,Rotar; Vladimir,2,0,34,32
1657268106219,MATH 193A,A04,083782,Rotar; Vladimir,8,0,34,26
1657268106219,MATH 193A,A05,093482,Rotar; Vladimir,6,0,34,28
1657268112243,MATH 197,001,091859,McAuley; Julian John,9999,0,9999,0
1657268112243,MATH 197,002,095566,Kedlaya; Kiran S.,9997,0,9999,2
1657268112243,MATH 197,003,095567,Xiao; Ming,9999,0,9999,0
1657268112243,MATH 197,004,095571,Perols; Johan Lars,9998,0,9999,1
1657268119307,COGS 9,A01,083615,Shannon; Kyle Michael,8,0,75,67
1657268125337,COGS 11,A01,083617,Boyle; Mary E. T.,22,0,48,26
1657268131361,COGS 13,A01,083071,Bastos; Amalia Pinkusfeld,9,0,71,62
1657268137387,COGS 14A,A01,092681,Semenuks; Arturs,2,1,100,98
1657268143426,COGS 14B,A01,083073,Cheng; Tzu-Han,6,0,63,57
1657268149452,COGS 17,A01,092677,Semenuks; Arturs,5,0,81,76
1657268155484,COGS 100,A01,083619,Allen; Michael Gordon,16,0,70,54
1657268161509,COGS 101A,A01,083621,Davis; Joshua Daniel,9,0,68,59
1657268167534,COGS 101B,A01,091572,Allen; Michael Gordon,11,0,65,54
1657268173572,COGS 101C,A01,083625,Delgado; Tania,17,0,35,18
1657268179600,COGS 107A,A01,083627,Boyle; Mary E. T.,13,0,60,47
1657268185627,COGS 118A,A01,083075,Gupta; Anjum,18,0,76,58
1657268191662,CSE 3,A50,083646,Miranda; Gregory Joseph,24,0,50,26
1657268197699,CSE 8A,A50,083650,Miranda; Gregory Joseph,17,1,56,39
1657268203721,CSE 11,A01,083080,Cao; Yingjun,5,15,40,35
1657268209745,CSE 12,A01,083652,Krause-Levy; Sophia Louisa,26,1,120,94
1657268215774,CSE 15L,A01,083654,Morris; Justin Loren,9,0,50,41
1657268215774,CSE 15L,A02,083655,Morris; Justin Loren,9,0,50,41
1657268221798,CSE 20,A01,083657,Tran; Khoa Dang,38,0,80,42
1657268227824,CSE 21,A01,095574,Bach; Quang Tran,22,0,48,26
1657268233849,CSE 30,A01,083084,Eldon; John,4,0,80,76
1657268233849,CSE 30,B01,095061,Bhaskar; Nishant,8,0,50,42
1657268239873,CSE 100,A01,083659,Cao; Yingjun,4,4,70,66
1657268245898,CSE 134B,A01,083661,Powell; Thomas Allan,21,0,100,79
1657268251922,CSE 140,A01,083663,Gungor; Onat,13,0,85,72
1657268257949,CSE 140L,A01,083088,Eldon; John,19,0,100,81
1657268263973,CSE 175,A01,083665,Kumar; Rakesh,3,0,25,22
1657268270012,CSE 190,A00,092507,Dubnov; Shlomo,7,0,20,13
1657268276039,ECE 45,A01,083139,Congero; Spencer William,5,0,75,70
1657268282082,ECE 65,A50,083695,Saad; Andrew S,12,0,30,18
1657268282082,ECE 65,A51,095125,Saad; Andrew S,25,0,26,1
1657268288109,ECE 109,A01,091882,Touri; Behrouz,19,0,70,51
1657268294139,ECE 180,A00,083140,Abi Samra; Nicholas Camill,1,0,30,29
1657268294139,ECE 180,B00,083141,Abi Samra; Nicholas Camill,0,0,30,30
1657268300174,MATH 10A,A01,083735,Patchell; Gregory David,2,0,30,28
1657268300174,MATH 10A,A02,083736,Patchell; Gregory David,20,0,30,10
1657268300174,MATH 10A,A03,083737,Patchell; Gregory David,16,0,30,14
1657268306200,MATH 10B,A01,083207,Lim; Seonhee,7,0,34,27
1657268306200,MATH 10B,A02,083208,Lim; Seonhee,9,0,35,26
1657268306200,MATH 10B,A03,093472,Lim; Seonhee,5,0,34,29
1657268306200,MATH 10B,B01,083739,Sinha; Shubham,11,0,30,19
1657268312312,MATH 18,A01,083743,Cinel; Cameron Alexander,6,0,30,24
1657268312312,MATH 18,A02,083744,Cinel; Cameron Alexander,17,0,30,13
1657268312312,MATH 18,A03,083745,Cinel; Cameron Alexander,8,0,30,22
1657268312312,MATH 18,B01,083748,Rideout; David Porter,4,0,37,33
1657268312312,MATH 18,B02,083749,Rideout; David Porter,4,0,36,32
1657268312312,MATH 18,B03,083750,Rideout; David Porter,2,0,37,35
1657268312312,MATH 18,B04,083751,Rideout; David Porter,6,0,36,30
1657268312312,MATH 18,B05,093473,Rideout; David Porter,5,0,36,31
1657268312312,MATH 18,B06,093474,Rideout; David Porter,5,0,36,31
1657268318337,MATH 20A,A01,083754,Zheng; Zequn,14,0,40,26
1657268324373,MATH 20B,A01,083756,Briones; Jor-el Thomas Caparas,3,0,36,33
1657268324373,MATH 20B,A02,083757,Briones; Jor-el Thomas Caparas,1,0,36,35
1657268324373,MATH 20B,A03,093475,Briones; Jor-el Thomas Caparas,2,0,36,34
1657268330409,MATH 20C,A01,083760,Briones; Jor-el Thomas Caparas,1,0,35,34
1657268330409,MATH 20C,A02,083761,Briones; Jor-el Thomas Caparas,8,0,35,27
1657268330409,MATH 20C,A03,093476,Briones; Jor-el Thomas Caparas,0,1,36,36
1657268330409,MATH 20C,B01,083762,Bach; Quang Tran,1,0,30,29
1657268336435,MATH 20D,A01,083765,Tran; Brian Kha,5,0,30,25
1657268336435,MATH 20D,A02,083766,Tran; Brian Kha,5,0,30,25
1657268336435,MATH 20D,A03,083767,Tran; Brian Kha,4,0,30,26
1657268342460,MATH 20E,A01,083771,Ganguly; Soumya,7,0,32,25
1657268342460,MATH 20E,A02,083772,Ganguly; Soumya,7,0,32,25
1657268342460,MATH 20E,B01,083773,Ciotti; Benjamin,19,0,35,16
1657268342460,MATH 20E,B02,083774,Ciotti; Benjamin,17,0,35,18
1657268348494,MATH 103A,A01,083777,Greenfeld; Be'Eri,3,0,36,33
1657268348494,MATH 103A,A02,083778,Greenfeld; Be'Eri,5,0,36,31
1657268348494,MATH 103A,A03,093561,Greenfeld; Be'Eri,4,0,36,32
1657268348494,MATH 103A,B01,083779,Greenfeld; Be'Eri,6,0,36,30
1657268348494,MATH 103A,B02,083780,Greenfeld; Be'Eri,3,0,36,33
1657268348494,MATH 103A,B03,093562,Greenfeld; Be'Eri,3,0,36,33
1657268354516,MATH 105,A01,085443,Carter; Anne Toulson,15,0,35,20
1657268354516,MATH 105,A02,093477,Carter; Anne Toulson,20,0,35,15
1657268360542,MATH 109,A01,083213,Ganzberger; Geoffrey Michael,2,0,34,32
1657268360542,MATH 109,A02,083214,Ganzberger; Geoffrey Michael,4,0,34,30
1657268360542,MATH 109,A03,093478,Ganzberger; Geoffrey Michael,2,0,34,32
1657268360542,MATH 109,B01,083215,Ganzberger; Geoffrey Michael,1,0,32,31
1657268360542,MATH 109,B02,083216,Ganzberger; Geoffrey Michael,1,0,32,31
1657268360542,MATH 109,B03,093479,Ganzberger; Geoffrey Michael,8,0,32,24
1657268366567,MATH 142A,A01,083219,Chow; Bennett,7,0,32,25
1657268366567,MATH 142A,A02,083220,Chow; Bennett,10,0,32,22
1657268366567,MATH 142A,A03,093480,Chow; Bennett,7,0,32,25
1657268366567,MATH 142A,B03,093481,Chow; Bennett,8,0,32,24
1657268366567,MATH 142A,B04,093558,Chow; Bennett,12,0,32,20
1657268366567,MATH 142A,B05,093559,Chow; Bennett,6,0,32,26
1657268372597,MATH 193A,A01,083224,Rotar; Vladimir,7,0,34,27
1657268372597,MATH 193A,A02,083225,Rotar; Vladimir,6,0,34,28
1657268372597,MATH 193A,A03,083781,Rotar; Vladimir,2,0,34,32
1657268372597,MATH 193A,A04,083782,Rotar; Vladimir,8,0,34,26
1657268372597,MATH 193A,A05,093482,Rotar; Vladimir,6,0,34,28
1657268378623,MATH 197,001,091859,McAuley; Julian John,9999,0,9999,0
1657268378623,MATH 197,002,095566,Kedlaya; Kiran S.,9997,0,9999,2
1657268378623,MATH 197,003,095567,Xiao; Ming,9999,0,9999,0
1657268378623,MATH 197,004,095571,Perols; Johan Lars,9998,0,9999,1
1657268385704,COGS 9,A01,083615,Shannon; Kyle Michael,8,0,75,67
1657268391729,COGS 11,A01,083617,Boyle; Mary E. T.,22,0,48,26
1657268397754,COGS 13,A01,083071,Bastos; Amalia Pinkusfeld,9,0,71,62
1657268403778,COGS 14A,A01,092681,Semenuks; Arturs,2,1,100,98
1657268409806,COGS 14B,A01,083073,Cheng; Tzu-Han,6,0,63,57
1657268415841,COGS 17,A01,092677,Semenuks; Arturs,5,0,81,76
1657268421880,COGS 100,A01,083619,Allen; Michael Gordon,16,0,70,54
1657268427904,COGS 101A,A01,083621,Davis; Joshua Daniel,9,0,68,59
1657268433932,COGS 101B,A01,091572,Allen; Michael Gordon,11,0,65,54
1657268439957,COGS 101C,A01,083625,Delgado; Tania,17,0,35,18
1657268445987,COGS 107A,A01,083627,Boyle; Mary E. T.,13,0,60,47
1657268452012,COGS 118A,A01,083075,Gupta; Anjum,18,0,76,58
1657268458037,CSE 3,A50,083646,Miranda; Gregory Joseph,24,0,50,26
1657268464067,CSE 8A,A50,083650,Miranda; Gregory Joseph,17,1,56,39
1657268470093,CSE 11,A01,083080,Cao; Yingjun,5,15,40,35
1657268476131,CSE 12,A01,083652,Krause-Levy; Sophia Louisa,26,1,120,94
1657268482156,CSE 15L,A01,083654,Morris; Justin Loren,9,0,50,41
1657268482156,CSE 15L,A02,083655,Morris; Justin Loren,9,0,50,41
1657268488182,CSE 20,A01,083657,Tran; Khoa Dang,38,0,80,42
1657268494207,CSE 21,A01,095574,Bach; Quang Tran,22,0,48,26
1657268500238,CSE 30,A01,083084,Eldon; John,4,0,80,76
1657268500238,CSE 30,B01,095061,Bhaskar; Nishant,8,0,50,42
1657268506265,CSE 100,A01,083659,Cao; Yingjun,4,4,70,66
1657268512290,CSE 134B,A01,083661,Powell; Thomas Allan,21,0,100,79
1657268518323,CSE 140,A01,083663,Gungor; Onat,13,0,85,72
1657268524349,CSE 140L,A01,083088,Eldon; John,19,0,100,81
1657268530375,CSE 175,A01,083665,Kumar; Rakesh,3,0,25,22
1657268536407,CSE 190,A00,092507,Dubnov; Shlomo,7,0,20,13
1657268542432,ECE 45,A01,083139,Congero; Spencer William,5,0,75,70
1657268548467,ECE 65,A50,083695,Saad; Andrew S,12,0,30,18
1657268548467,ECE 65,A51,095125,Saad; Andrew S,25,0,26,1
1657268554493,ECE 109,A01,091882,Touri; Behrouz,19,0,70,51
1657268560520,ECE 180,A00,083140,Abi Samra; Nicholas Camill,1,0,30,29
1657268560520,ECE 180,B00,083141,Abi Samra; Nicholas Camill,0,0,30,30
1657268566549,MATH 10A,A01,083735,Patchell; Gregory David,2,0,30,28
1657268566549,MATH 10A,A02,083736,Patchell; Gregory David,20,0,30,10
1657268566549,MATH 10A,A03,083737,Patchell; Gregory David,16,0,30,14
1657268572587,MATH 10B,A01,083207,Lim; Seonhee,7,0,34,27
1657268572587,MATH 10B,A02,083208,Lim; Seonhee,9,0,35,26
1657268572587,MATH 10B,A03,093472,Lim; Seonhee,5,0,34,29
1657268572587,MATH 10B,B01,083739,Sinha; Shubham,11,0,30,19
1657268578618,MATH 18,A01,083743,Cinel; Cameron Alexander,6,0,30,24
1657268578618,MATH 18,A02,083744,Cinel; Cameron Alexander,17,0,30,13
1657268578618,MATH 18,A03,083745,Cinel; Cameron Alexander,8,0,30,22
1657268578618,MATH 18,B01,083748,Rideout; David Porter,4,0,37,33
1657268578618,MATH 18,B02,083749,Rideout; David Porter,4,0,36,32
1657268578618,MATH 18,B03,083750,Rideout; David Porter,2,0,37,35
1657268578618,MATH 18,B04,083751,Rideout; David Porter,6,0,36,30
1657268578618,MATH 18,B05,093473,Rideout; David Porter,5,0,36,31
1657268578618,MATH 18,B06,093474,Rideout; David Porter,5,0,36,31
1657268584647,MATH 20A,A01,083754,Zheng; Zequn,14,0,40,26
1657268590673,MATH 20B,A01,083756,Briones; Jor-el Thomas Caparas,3,0,36,33
1657268590673,MATH 20B,A02,083757,Briones; Jor-el Thomas Caparas,1,0,36,35
1657268590673,MATH 20B,A03,093475,Briones; Jor-el Thomas Caparas,2,0,36,34
1657268596699,MATH 20C,A01,083760,Briones; Jor-el Thomas Caparas,1,0,35,34
1657268596699,MATH 20C,A02,083761,Briones; Jor-el Thomas Caparas,8,0,35,27
1657268596699,MATH 20C,A03,093476,Briones; Jor-el Thomas Caparas,0,1,36,36
1657268596699,MATH 20C,B01,083762,Bach; Quang Tran,1,0,30,29
1657268602732,MATH 20D,A01,083765,Tran; Brian Kha,5,0,30,25
1657268602732,MATH 20D,A02,083766,Tran; Brian Kha,5,0,30,25
1657268602732,MATH 20D,A03,083767,Tran; Brian Kha,4,0,30,26
1657268608759,MATH 20E,A01,083771,Ganguly; Soumya,7,0,32,25
1657268608759,MATH 20E,A02,083772,Ganguly; Soumya,7,0,32,25
1657268608759,MATH 20E,B01,083773,Ciotti; Benjamin,19,0,35,16
1657268608759,MATH 20E,B02,083774,Ciotti; Benjamin,17,0,35,18
1657268614788,MATH 103A,A01,083777,Greenfeld; Be'Eri,3,0,36,33
1657268614788,MATH 103A,A02,083778,Greenfeld; Be'Eri,5,0,36,31
1657268614788,MATH 103A,A03,093561,Greenfeld; Be'Eri,4,0,36,32
1657268614788,MATH 103A,B01,083779,Greenfeld; Be'Eri,6,0,36,30
1657268614788,MATH 103A,B02,083780,Greenfeld; Be'Eri,3,0,36,33
1657268614788,MATH 103A,B03,093562,Greenfeld; Be'Eri,3,0,36,33
1657268620814,MATH 105,A01,085443,Carter; Anne Toulson,15,0,35,20
1657268620814,MATH 105,A02,093477,Carter; Anne Toulson,20,0,35,15
1657268626849,MATH 109,A01,083213,Ganzberger; Geoffrey Michael,2,0,34,32
1657268626849,MATH 109,A02,083214,Ganzberger; Geoffrey Michael,4,0,34,30
1657268626849,MATH 109,A03,093478,Ganzberger; Geoffrey Michael,2,0,34,32
1657268626849,MATH 109,B01,083215,Ganzberger; Geoffrey Michael,1,0,32,31
1657268626849,MATH 109,B02,083216,Ganzberger; Geoffrey Michael,1,0,32,31
1657268626849,MATH 109,B03,093479,Ganzberger; Geoffrey Michael,8,0,32,24
1657268632883,MATH 142A,A01,083219,Chow; Bennett,7,0,32,25
1657268632883,MATH 142A,A02,083220,Chow; Bennett,10,0,32,22
1657268632883,MATH 142A,A03,093480,Chow; Bennett,7,0,32,25
1657268632883,MATH 142A,B03,093481,Chow; Bennett,8,0,32,24
1657268632883,MATH 142A,B04,093558,Chow; Bennett,12,0,32,20
1657268632883,MATH 142A,B05,093559,Chow; Bennett,6,0,32,26
1657268638909,MATH 193A,A01,083224,Rotar; Vladimir,7,0,34,27
1657268638909,MATH 193A,A02,083225,Rotar; Vladimir,6,0,34,28
1657268638909,MATH 193A,A03,083781,Rotar; Vladimir,2,0,34,32
1657268638909,MATH 193A,A04,083782,Rotar; Vladimir,8,0,34,26
1657268638909,MATH 193A,A05,093482,Rotar; Vladimir,6,0,34,28
1657268644932,MATH 197,001,091859,McAuley; Julian John,9999,0,9999,0
1657268644932,MATH 197,002,095566,Kedlaya; Kiran S.,9997,0,9999,2
1657268644932,MATH 197,003,095567,Xiao; Ming,9999,0,9999,0
1657268644932,MATH 197,004,095571,Perols; Johan Lars,9998,0,9999,1
1657268652023,COGS 9,A01,083615,Shannon; Kyle Michael,8,0,75,67
1657268658054,COGS 11,A01,083617,Boyle; Mary E. T.,22,0,48,26
1657268664085,COGS 13,A01,083071,Bastos; Amalia Pinkusfeld,9,0,71,62
1657268670111,COGS 14A,A01,092681,Semenuks; Arturs,2,1,100,98
1657268676134,COGS 14B,A01,083073,Cheng; Tzu-Han,6,0,63,57
1657268682159,COGS 17,A01,092677,Semenuks; Arturs,5,0,81,76
1657268688185,COGS 100,A01,083619,Allen; Michael Gordon,16,0,70,54
1657268694218,COGS 101A,A01,083621,Davis; Joshua Daniel,9,0,68,59
1657268700243,COGS 101B,A01,091572,Allen; Michael Gordon,11,0,65,54
1657268706268,COGS 101C,A01,083625,Delgado; Tania,17,0,35,18
1657268712294,COGS 107A,A01,083627,Boyle; Mary E. T.,13,0,60,47
1657268718330,COGS 118A,A01,083075,Gupta; Anjum,18,0,76,58
1657268724369,CSE 3,A50,083646,Miranda; Gregory Joseph,24,0,50,26
1657268730394,CSE 8A,A50,083650,Miranda; Gregory Joseph,17,1,56,39
1657268736417,CSE 11,A01,083080,Cao; Yingjun,5,15,40,35
1657268742444,CSE 12,A01,083652,Krause-Levy; Sophia Louisa,26,1,120,94
1657268748470,CSE 15L,A01,083654,Morris; Justin Loren,9,0,50,41
1657268748470,CSE 15L,A02,083655,Morris; Justin Loren,9,0,50,41
1657268754498,CSE 20,A01,083657,Tran; Khoa Dang,38,0,80,42
1657268760536,CSE 21,A01,095574,Bach; Quang Tran,22,0,48,26
1657268766572,CSE 30,A01,083084,Eldon; John,4,0,80,76
1657268766572,CSE 30,B01,095061,Bhaskar; Nishant,8,0,50,42
1657268772596,CSE 100,A01,083659,Cao; Yingjun,4,4,70,66
1657268778633,CSE 134B,A01,083661,Powell; Thomas Allan,21,0,100,79
1657268784658,CSE 140,A01,083663,Gungor; Onat,13,0,85,72
1657268790685,CSE 140L,A01,083088,Eldon; John,19,0,100,81
1657268796717,CSE 175,A01,083665,Kumar; Rakesh,3,0,25,22
1657268802748,CSE 190,A00,092507,Dubnov; Shlomo,7,0,20,13
1657268808776,ECE 45,A01,083139,Congero; Spencer William,5,0,75,70
1657268814804,ECE 65,A50,083695,Saad; Andrew S,12,0,30,18
1657268814804,ECE 65,A51,095125,Saad; Andrew S,25,0,26,1
1657268820842,ECE 109,A01,091882,Touri; Behrouz,19,0,70,51
1657268826867,ECE 180,A00,083140,Abi Samra; Nicholas Camill,1,0,30,29
1657268826867,ECE 180,B00,083141,Abi Samra; Nicholas Camill,0,0,30,30
1657268832892,MATH 10A,A01,083735,Patchell; Gregory David,2,0,30,28
1657268832892,MATH 10A,A02,083736,Patchell; Gregory David,20,0,30,10
1657268832892,MATH 10A,A03,083737,Patchell; Gregory David,16,0,30,14
1657268838920,MATH 10B,A01,083207,Lim; Seonhee,7,0,34,27
1657268838920,MATH 10B,A02,083208,Lim; Seonhee,9,0,35,26
1657268838920,MATH 10B,A03,093472,Lim; Seonhee,5,0,34,29
1657268838920,MATH 10B,B01,083739,Sinha; Shubham,11,0,30,19
1657268844950,MATH 18,A01,083743,Cinel; Cameron Alexander,6,0,30,24
1657268844950,MATH 18,A02,083744,Cinel; Cameron Alexander,17,0,30,13
1657268844950,MATH 18,A03,083745,Cinel; Cameron Alexander,8,0,30,22
1657268844950,MATH 18,B01,083748,Rideout; David Porter,4,0,37,33
1657268844950,MATH 18,B02,083749,Rideout; David Porter,4,0,36,32
1657268844950,MATH 18,B03,083750,Rideout; David Porter,2,0,37,35
1657268844950,MATH 18,B04,083751,Rideout; David Porter,6,0,36,30
1657268844950,MATH 18,B05,093473,Rideout; David Porter,5,0,36,31
1657268844950,MATH 18,B06,093474,Rideout; David Porter,5,0,36,31
1657268850989,MATH 20A,A01,083754,Zheng; Zequn,14,0,40,26
1657268857025,MATH 20B,A01,083756,Briones; Jor-el Thomas Caparas,3,0,36,33
1657268857025,MATH 20B,A02,083757,Briones; Jor-el Thomas Caparas,1,0,36,35
1657268857025,MATH 20B,A03,093475,Briones; Jor-el Thomas Caparas,2,0,36,34
1657268863060,MATH 20C,A01,083760,Briones; Jor-el Thomas Caparas,1,0,35,34
1657268863060,MATH 20C,A02,083761,Briones; Jor-el Thomas Caparas,8,0,35,27
1657268863060,MATH 20C,A03,093476,Briones; Jor-el Thomas Caparas,0,1,36,36
1657268863060,MATH 20C,B01,083762,Bach; Quang Tran,1,0,30,29
1657268869085,MATH 20D,A01,083765,Tran; Brian Kha,5,0,30,25
1657268869085,MATH 20D,A02,083766,Tran; Brian Kha,5,0,30,25
1657268869085,MATH 20D,A03,083767,Tran; Brian Kha,4,0,30,26
1657268875111,MATH 20E,A01,083771,Ganguly; Soumya,7,0,32,25
1657268875111,MATH 20E,A02,083772,Ganguly; Soumya,7,0,32,25
1657268875111,MATH 20E,B01,083773,Ciotti; Benjamin,19,0,35,16
1657268875111,MATH 20E,B02,083774,Ciotti; Benjamin,17,0,35,18
1657268881142,MATH 103A,A01,083777,Greenfeld; Be'Eri,3,0,36,33
1657268881142,MATH 103A,A02,083778,Greenfeld; Be'Eri,5,0,36,31
1657268881142,MATH 103A,A03,093561,Greenfeld; Be'Eri,4,0,36,32
1657268881142,MATH 103A,B01,083779,Greenfeld; Be'Eri,6,0,36,30
1657268881142,MATH 103A,B02,083780,Greenfeld; Be'Eri,3,0,36,33
1657268881142,MATH 103A,B03,093562,Greenfeld; Be'Eri,3,0,36,33
1657268887167,MATH 105,A01,085443,Carter; Anne Toulson,15,0,35,20
1657268887167,MATH 105,A02,093477,Carter; Anne Toulson,20,0,35,15
1657268893198,MATH 109,A01,083213,Ganzberger; Geoffrey Michael,2,0,34,32
1657268893198,MATH 109,A02,083214,Ganzberger; Geoffrey Michael,4,0,34,30
1657268893198,MATH 109,A03,093478,Ganzberger; Geoffrey Michael,2,0,34,32
1657268893198,MATH 109,B01,083215,Ganzberger; Geoffrey Michael,1,0,32,31
1657268893198,MATH 109,B02,083216,Ganzberger; Geoffrey Michael,1,0,32,31
1657268893198,MATH 109,B03,093479,Ganzberger; Geoffrey Michael,8,0,32,24
1657268899232,MATH 142A,A01,083219,Chow; Bennett,7,0,32,25
1657268899232,MATH 142A,A02,083220,Chow; Bennett,10,0,32,22
1657268899232,MATH 142A,A03,093480,Chow; Bennett,7,0,32,25
1657268899232,MATH 142A,B03,093481,Chow; Bennett,8,0,32,24
1657268899232,MATH 142A,B04,093558,Chow; Bennett,12,0,32,20
1657268899232,MATH 142A,B05,093559,Chow; Bennett,6,0,32,26
1657268905258,MATH 193A,A01,083224,Rotar; Vladimir,7,0,34,27
1657268905258,MATH 193A,A02,083225,Rotar; Vladimir,6,0,34,28
1657268905258,MATH 193A,A03,083781,Rotar; Vladimir,2,0,34,32
1657268905258,MATH 193A,A04,083782,Rotar; Vladimir,8,0,34,26
1657268905258,MATH 193A,A05,093482,Rotar; Vladimir,6,0,34,28
1657268911361,MATH 197,001,091859,McAuley; Julian John,9999,0,9999,0
1657268911361,MATH 197,002,095566,Kedlaya; Kiran S.,9997,0,9999,2
1657268911361,MATH 197,003,095567,Xiao; Ming,9999,0,9999,0
1657268911361,MATH 197,004,095571,Perols; Johan Lars,9998,0,9999,1
1657268918427,COGS 9,A01,083615,Shannon; Kyle Michael,8,0,75,67
1657268924453,COGS 11,A01,083617,Boyle; Mary E. T.,22,0,48,26
1657268930484,COGS 13,A01,083071,Bastos; Amalia Pinkusfeld,9,0,71,62
1657268936508,COGS 14A,A01,092681,Semenuks; Arturs,2,1,100,98
1657268942537,COGS 14B,A01,083073,Cheng; Tzu-Han,6,0,63,57
1657268948565,COGS 17,A01,092677,Semenuks; Arturs,5,0,81,76
1657268954592,COGS 100,A01,083619,Allen; Michael Gordon,16,0,70,54
1657268960623,COGS 101A,A01,083621,Davis; Joshua Daniel,9,0,68,59
1657268966652,COGS 101B,A01,091572,Allen; Michael Gordon,11,0,65,54
1657268972676,COGS 101C,A01,083625,Delgado; Tania,17,0,35,18
1657268978701,COGS 107A,A01,083627,Boyle; Mary E. T.,13,0,60,47
1657268984730,COGS 118A,A01,083075,Gupta; Anjum,18,0,76,58
1657268990757,CSE 3,A50,083646,Miranda; Gregory Joseph,24,0,50,26
1657268996781,CSE 8A,A50,083650,Miranda; Gregory Joseph,17,1,56,39
1657269002811,CSE 11,A01,083080,Cao; Yingjun,5,15,40,35
1657269008836,CSE 12,A01,083652,Krause-Levy; Sophia Louisa,26,1,120,94
1657269014862,CSE 15L,A01,083654,Morris; Justin Loren,9,0,50,41
1657269014862,CSE 15L,A02,083655,Morris; Justin Loren,9,0,50,41
1657269020886,CSE 20,A01,083657,Tran; Khoa Dang,38,0,80,42
1657269026916,CSE 21,A01,095574,Bach; Quang Tran,22,0,48,26
1657269032944,CSE 30,A01,083084,Eldon; John,4,0,80,76
1657269032944,CSE 30,B01,095061,Bhaskar; Nishant,8,0,50,42
1657269038974,CSE 100,A01,083659,Cao; Yingjun,4,4,70,66
1657269044999,CSE 134B,A01,083661,Powell; Thomas Allan,21,0,100,79
1657269051024,CSE 140,A01,083663,Gungor; Onat,13,0,85,72
1657269057052,CSE 140L,A01,083088,Eldon; John,19,0,100,81
1657269063077,CSE 175,A01,083665,Kumar; Rakesh,3,0,25,22
1657269069110,CSE 190,A00,092507,Dubnov; Shlomo,7,0,20,13
1657269075159,ECE 45,A01,083139,Congero; Spencer William,5,0,75,70
1657269081187,ECE 65,A50,083695,Saad; Andrew S,12,0,30,18
1657269081187,ECE 65,A51,095125,Saad; Andrew S,25,0,26,1
1657269087212,ECE 109,A01,091882,Touri; Behrouz,19,0,70,51
1657269093242,ECE 180,A00,083140,Abi Samra; Nicholas Camill,1,0,30,29
1657269093242,ECE 180,B00,083141,Abi Samra; Nicholas Camill,0,0,30,30
1657269099276,MATH 10A,A01,083735,Patchell; Gregory David,2,0,30,28
1657269099276,MATH 10A,A02,083736,Patchell; Gregory David,20,0,30,10
1657269099276,MATH 10A,A03,083737,Patchell; Gregory David,16,0,30,14
1657269105304,MATH 10B,A01,083207,Lim; Seonhee,7,0,34,27
1657269105304,MATH 10B,A02,083208,Lim; Seonhee,9,0,35,26
1657269105304,MATH 10B,A03,093472,Lim; Seonhee,5,0,34,29
1657269105304,MATH 10B,B01,083739,Sinha; Shubham,11,0,30,19
1657269111333,MATH 18,A01,083743,Cinel; Cameron Alexander,6,0,30,24
1657269111333,MATH 18,A02,083744,Cinel; Cameron Alexander,17,0,30,13
1657269111333,MATH 18,A03,083745,Cinel; Cameron Alexander,8,0,30,22
1657269111333,MATH 18,B01,083748,Rideout; David Porter,4,0,37,33
1657269111333,MATH 18,B02,083749,Rideout; David Porter,4,0,36,32
1657269111333,MATH 18,B03,083750,Rideout; David Porter,2,0,37,35
1657269111333,MATH 18,B04,083751,Rideout; David Porter,6,0,36,30
1657269111333,MATH 18,B05,093473,Rideout; David Porter,5,0,36,31
1657269111333,MATH 18,B06,093474,Rideout; David Porter,5,0,36,31
1657269117358,MATH 20A,A01,083754,Zheng; Zequn,14,0,40,26
1657269123386,MATH 20B,A01,083756,Briones; Jor-el Thomas Caparas,3,0,36,33
1657269123386,MATH 20B,A02,083757,Briones; Jor-el Thomas Caparas,1,0,36,35
1657269123386,MATH 20B,A03,093475,Briones; Jor-el Thomas Caparas,2,0,36,34
1657269129421,MATH 20C,A01,083760,Briones; Jor-el Thomas Caparas,1,0,35,34
1657269129421,MATH 20C,A02,083761,Briones; Jor-el Thomas Caparas,8,0,35,27
1657269129421,MATH 20C,A03,093476,Briones; Jor-el Thomas Caparas,0,1,36,36
1657269129421,MATH 20C,B01,083762,Bach; Quang Tran,1,0,30,29
1657269135461,MATH 20D,A01,083765,Tran; Brian Kha,5,0,30,25
1657269135461,MATH 20D,A02,083766,Tran; Brian Kha,5,0,30,25
1657269135461,MATH 20D,A03,083767,Tran; Brian Kha,4,0,30,26
1657269141495,MATH 20E,A01,083771,Ganguly; Soumya,7,0,32,25
1657269141495,MATH 20E,A02,083772,Ganguly; Soumya,7,0,32,25
1657269141495,MATH 20E,B01,083773,Ciotti; Benjamin,19,0,35,16
1657269141495,MATH 20E,B02,083774,Ciotti; Benjamin,17,0,35,18
1657269147538,MATH 103A,A01,083777,Greenfeld; Be'Eri,3,0,36,33
1657269147538,MATH 103A,A02,083778,Greenfeld; Be'Eri,5,0,36,31
1657269147538,MATH 103A,A03,093561,Greenfeld; Be'Eri,4,0,36,32
1657269147538,MATH 103A,B01,083779,Greenfeld; Be'Eri,6,0,36,30
1657269147538,MATH 103A,B02,083780,Greenfeld; Be'Eri,3,0,36,33
1657269147538,MATH 103A,B03,093562,Greenfeld; Be'Eri,3,0,36,33
1657269153565,MATH 105,A01,085443,Carter; Anne Toulson,15,0,35,20
1657269153565,MATH 105,A02,093477,Carter; Anne Toulson,20,0,35,15
1657269159598,MATH 109,A01,083213,Ganzberger; Geoffrey Michael,2,0,34,32
1657269159598,MATH 109,A02,083214,Ganzberger; Geoffrey Michael,4,0,34,30
1657269159598,MATH 109,A03,093478,Ganzberger; Geoffrey Michael,2,0,34,32
1657269159598,MATH 109,B01,083215,Ganzberger; Geoffrey Michael,1,0,32,31
1657269159598,MATH 109,B02,083216,Ganzberger; Geoffrey Michael,1,0,32,31
1657269159598,MATH 109,B03,093479,Ganzberger; Geoffrey Michael,8,0,32,24
1657269165629,MATH 142A,A01,083219,Chow; Bennett,7,0,32,25
1657269165629,MATH 142A,A02,083220,Chow; Bennett,10,0,32,22
1657269165629,MATH 142A,A03,093480,Chow; Bennett,7,0,32,25
1657269165629,MATH 142A,B03,093481,Chow; Bennett,8,0,32,24
1657269165629,MATH 142A,B04,093558,Chow; Bennett,12,0,32,20
1657269165629,MATH 142A,B05,093559,Chow; Bennett,6,0,32,26
1657269171657,MATH 193A,A01,083224,Rotar; Vladimir,7,0,34,27
1657269171657,MATH 193A,A02,083225,Rotar; Vladimir,6,0,34,28
1657269171657,MATH 193A,A03,083781,Rotar; Vladimir,2,0,34,32
1657269171657,MATH 193A,A04,083782,Rotar; Vladimir,8,0,34,26
1657269171657,MATH 193A,A05,093482,Rotar; Vladimir,6,0,34,28
1657269177684,MATH 197,001,091859,McAuley; Julian John,9999,0,9999,0
1657269177684,MATH 197,002,095566,Kedlaya; Kiran S.,9997,0,9999,2
1657269177684,MATH 197,003,095567,Xiao; Ming,9999,0,9999,0
1657269177684,MATH 197,004,095571,Perols; Johan Lars,9998,0,9999,1
1657269184771,COGS 9,A01,083615,Shannon; Kyle Michael,8,0,75,67
1657269190796,COGS 11,A01,083617,Boyle; Mary E. T.,22,0,48,26
1657269196828,COGS 13,A01,083071,Bastos; Amalia Pinkusfeld,9,0,71,62
1657269202852,COGS 14A,A01,092681,Semenuks; Arturs,2,1,100,98
1657269208876,COGS 14B,A01,083073,Cheng; Tzu-Han,6,0,63,57
1657269214911,COGS 17,A01,092677,Semenuks; Arturs,5,0,81,76
1657269220940,COGS 100,A01,083619,Allen; Michael Gordon,16,0,70,54
1657269226969,COGS 101A,A01,083621,Davis; Joshua Daniel,9,0,68,59
1657269232996,COGS 101B,A01,091572,Allen; Michael Gordon,11,0,65,54
1657269239028,COGS 101C,A01,083625,Delgado; Tania,17,0,35,18
1657269245053,COGS 107A,A01,083627,Boyle; Mary E. T.,13,0,60,47
1657269251081,COGS 118A,A01,083075,Gupta; Anjum,18,0,76,58
1657269257109,CSE 3,A50,083646,Miranda; Gregory Joseph,24,0,50,26
1657269263139,CSE 8A,A50,083650,Miranda; Gregory Joseph,17,1,56,39
1657269269167,CSE 11,A01,083080,Cao; Yingjun,5,15,40,35
1657269275192,CSE 12,A01,083652,Krause-Levy; Sophia Louisa,26,1,120,94
1657269281217,CSE 15L,A01,083654,Morris; Justin Loren,9,0,50,41
1657269281217,CSE 15L,A02,083655,Morris; Justin Loren,9,0,50,41
1657269287241,CSE 20,A01,083657,Tran; Khoa Dang,38,0,80,42
1657269293270,CSE 21,A01,095574,Bach; Quang Tran,22,0,48,26
1657269299316,CSE 30,A01,083084,Eldon; John,4,0,80,76
1657269299316,CSE 30,B01,095061,Bhaskar; Nishant,8,0,50,42
1657269305343,CSE 100,A01,083659,Cao; Yingjun,4,4,70,66
1657269311371,CSE 134B,A01,083661,Powell; Thomas Allan,21,0,100,79
1657269317394,CSE 140,A01,083663,Gungor; Onat,13,0,85,72
1657269323428,CSE 140L,A01,083088,Eldon; John,19,0,100,81
1657269329457,CSE 175,A01,083665,Kumar; Rakesh,3,0,25,22
1657269335485,CSE 190,A00,092507,Dubnov; Shlomo,7,0,20,13
1657269341510,ECE 45,A01,083139,Congero; Spencer William,5,0,75,70
1657269347545,ECE 65,A50,083695,Saad; Andrew S,12,0,30,18
1657269347545,ECE 65,A51,095125,Saad; Andrew S,25,0,26,1
1657269353572,ECE 109,A01,091882,Touri; Behrouz,19,0,70,51
1657269359596,ECE 180,A00,083140,Abi Samra; Nicholas Camill,1,0,30,29
1657269359596,ECE 180,B00,083141,Abi Samra; Nicholas Camill,0,0,30,30
1657269365622,MATH 10A,A01,083735,Patchell; Gregory David,2,0,30,28
1657269365622,MATH 10A,A02,083736,Patchell; Gregory David,20,0,30,10
1657269365622,MATH 10A,A03,083737,Patchell; Gregory David,16,0,30,14
1657269371657,MATH 10B,A01,083207,Lim; Seonhee,7,0,34,27
1657269371657,MATH 10B,A02,083208,Lim; Seonhee,9,0,35,26
1657269371657,MATH 10B,A03,093472,Lim; Seonhee,5,0,34,29
1657269371657,MATH 10B,B01,083739,Sinha; Shubham,11,0,30,19
1657269377685,MATH 18,A01,083743,Cinel; Cameron Alexander,6,0,30,24
1657269377685,MATH 18,A02,083744,Cinel; Cameron Alexander,17,0,30,13
1657269377685,MATH 18,A03,083745,Cinel; Cameron Alexander,8,0,30,22
1657269377685,MATH 18,B01,083748,Rideout; David Porter,4,0,37,33
1657269377685,MATH 18,B02,083749,Rideout; David Porter,4,0,36,32
1657269377685,MATH 18,B03,083750,Rideout; David Porter,2,0,37,35
1657269377685,MATH 18,B04,083751,Rideout; David Porter,6,0,36,30
1657269377685,MATH 18,B05,093473,Rideout; David Porter,5,0,36,31
1657269377685,MATH 18,B06,093474,Rideout; David Porter,5,0,36,31
1657269383710,MATH 20A,A01,083754,Zheng; Zequn,14,0,40,26
1657269389737,MATH 20B,A01,083756,Briones; Jor-el Thomas Caparas,3,0,36,33
1657269389737,MATH 20B,A02,083757,Briones; Jor-el Thomas Caparas,1,0,36,35
1657269389737,MATH 20B,A03,093475,Briones; Jor-el Thomas Caparas,2,0,36,34
1657269395765,MATH 20C,A01,083760,Briones; Jor-el Thomas Caparas,1,0,35,34
1657269395765,MATH 20C,A02,083761,Briones; Jor-el Thomas Caparas,8,0,35,27
1657269395765,MATH 20C,A03,093476,Briones; Jor-el Thomas Caparas,0,1,36,36
1657269395765,MATH 20C,B01,083762,Bach; Quang Tran,1,0,30,29
1657269401791,MATH 20D,A01,083765,Tran; Brian Kha,5,0,30,25
1657269401791,MATH 20D,A02,083766,Tran; Brian Kha,5,0,30,25
1657269401791,MATH 20D,A03,083767,Tran; Brian Kha,4,0,30,26
1657269407818,MATH 20E,A01,083771,Ganguly; Soumya,7,0,32,25
1657269407818,MATH 20E,A02,083772,Ganguly; Soumya,7,0,32,25
1657269407818,MATH 20E,B01,083773,Ciotti; Benjamin,19,0,35,16
1657269407818,MATH 20E,B02,083774,Ciotti; Benjamin,17,0,35,18
1657269413845,MATH 103A,A01,083777,Greenfeld; Be'Eri,3,0,36,33
1657269413845,MATH 103A,A02,083778,Greenfeld; Be'Eri,5,0,36,31
1657269413845,MATH 103A,A03,093561,Greenfeld; Be'Eri,4,0,36,32
1657269413845,MATH 103A,B01,083779,Greenfeld; Be'Eri,6,0,36,30
1657269413845,MATH 103A,B02,083780,Greenfeld; Be'Eri,3,0,36,33
1657269413845,MATH 103A,B03,093562,Greenfeld; Be'Eri,3,0,36,33
1657269419870,MATH 105,A01,085443,Carter; Anne Toulson,15,0,35,20
1657269419870,MATH 105,A02,093477,Carter; Anne Toulson,20,0,35,15
1657269425898,MATH 109,A01,083213,Ganzberger; Geoffrey Michael,2,0,34,32
1657269425898,MATH 109,A02,083214,Ganzberger; Geoffrey Michael,4,0,34,30
1657269425898,MATH 109,A03,093478,Ganzberger; Geoffrey Michael,2,0,34,32
1657269425898,MATH 109,B01,083215,Ganzberger; Geoffrey Michael,1,0,32,31
1657269425898,MATH 109,B02,083216,Ganzberger; Geoffrey Michael,1,0,32,31
1657269425898,MATH 109,B03,093479,Ganzberger; Geoffrey Michael,8,0,32,24
1657269431927,MATH 142A,A01,083219,Chow; Bennett,7,0,32,25
1657269431927,MATH 142A,A02,083220,Chow; Bennett,10,0,32,22
1657269431927,MATH 142A,A03,093480,Chow; Bennett,7,0,32,25
1657269431927,MATH 142A,B03,093481,Chow; Bennett,8,0,32,24
1657269431927,MATH 142A,B04,093558,Chow; Bennett,12,0,32,20
1657269431927,MATH 142A,B05,093559,Chow; Bennett,6,0,32,26
1657269437953,MATH 193A,A01,083224,Rotar; Vladimir,7,0,34,27
1657269437953,MATH 193A,A02,083225,Rotar; Vladimir,6,0,34,28
1657269437953,MATH 193A,A03,083781,Rotar; Vladimir,2,0,34,32
1657269437953,MATH 193A,A04,083782,Rotar; Vladimir,8,0,34,26
1657269437953,MATH 193A,A05,093482,Rotar; Vladimir,6,0,34,28
1657269443976,MATH 197,001,091859,McAuley; Julian John,9999,0,9999,0
1657269443976,MATH 197,002,095566,Kedlaya; Kiran S.,9997,0,9999,2
1657269443976,MATH 197,003,095567,Xiao; Ming,9999,0,9999,0
1657269443976,MATH 197,004,095571,Perols; Johan Lars,9998,0,9999,1
1657269451040,COGS 9,A01,083615,Shannon; Kyle Michael,8,0,75,67
1657269457062,COGS 11,A01,083617,Boyle; Mary E. T.,22,0,48,26
1657269463086,COGS 13,A01,083071,Bastos; Amalia Pinkusfeld,9,0,71,62
1657269469115,COGS 14A,A01,092681,Semenuks; Arturs,2,1,100,98
1657269475141,COGS 14B,A01,083073,Cheng; Tzu-Han,6,0,63,57
1657269481163,COGS 17,A01,092677,Semenuks; Arturs,5,0,81,76
1657269487185,COGS 100,A01,083619,Allen; Michael Gordon,16,0,70,54
1657269493212,COGS 101A,A01,083621,Davis; Joshua Daniel,9,0,68,59
1657269499238,COGS 101B,A01,091572,Allen; Michael Gordon,11,0,65,54
1657269505336,COGS 101C,A01,083625,Delgado; Tania,17,0,35,18
1657269511359,COGS 107A,A01,083627,Boyle; Mary E. T.,13,0,60,47
1657269517391,COGS 118A,A01,083075,Gupta; Anjum,18,0,76,58
1657269523416,CSE 3,A50,083646,Miranda; Gregory Joseph,24,0,50,26
1657269529439,CSE 8A,A50,083650,Miranda; Gregory Joseph,17,1,56,39
1657269535463,CSE 11,A01,083080,Cao; Yingjun,5,15,40,35
1657269541487,CSE 12,A01,083652,Krause-Levy; Sophia Louisa,26,1,120,94
1657269547510,CSE 15L,A01,083654,Morris; Justin Loren,9,0,50,41
1657269547510,CSE 15L,A02,083655,Morris; Justin Loren,9,0,50,41
1657269553538,CSE 20,A01,083657,Tran; Khoa Dang,38,0,80,42
1657269559568,CSE 21,A01,095574,Bach; Quang Tran,22,0,48,26
1657269565592,CSE 30,A01,083084,Eldon; John,4,0,80,76
1657269565592,CSE 30,B01,095061,Bhaskar; Nishant,8,0,50,42
1657269571618,CSE 100,A01,083659,Cao; Yingjun,4,4,70,66
1657269577643,CSE 134B,A01,083661,Powell; Thomas Allan,21,0,100,79
1657269583670,CSE 140,A01,083663,Gungor; Onat,13,0,85,72
1657269589694,CSE 140L,A01,083088,Eldon; John,19,0,100,81
1657269595716,CSE 175,A01,083665,Kumar; Rakesh,3,0,25,22
1657269601739,CSE 190,A00,092507,Dubnov; Shlomo,7,0,20,13
1657269607762,ECE 45,A01,083139,Congero; Spencer William,5,0,75,70
1657269613784,ECE 65,A50,083695,Saad; Andrew S,12,0,30,18
1657269613784,ECE 65,A51,095125,Saad; Andrew S,25,0,26,1
1657269619810,ECE 109,A01,091882,Touri; Behrouz,19,0,70,51
1657269625833,ECE 180,A00,083140,Abi Samra; Nicholas Camill,1,0,30,29
1657269625833,ECE 180,B00,083141,Abi Samra; Nicholas Camill,0,0,30,30
1657269631858,MATH 10A,A01,083735,Patchell; Gregory David,2,0,30,28
1657269631858,MATH 10A,A02,083736,Patchell; Gregory David,20,0,30,10
1657269631858,MATH 10A,A03,083737,Patchell; Gregory David,16,0,30,14
1657269637888,MATH 10B,A01,083207,Lim; Seonhee,7,0,34,27
1657269637888,MATH 10B,A02,083208,Lim; Seonhee,9,0,35,26
1657269637888,MATH 10B,A03,093472,Lim; Seonhee,5,0,34,29
1657269637888,MATH 10B,B01,083739,Sinha; Shubham,11,0,30,19
1657269643924,MATH 18,A01,083743,Cinel; Cameron Alexander,6,0,30,24
1657269643924,MATH 18,A02,083744,Cinel; Cameron Alexander,17,0,30,13
1657269643924,MATH 18,A03,083745,Cinel; Cameron Alexander,8,0,30,22
1657269643924,MATH 18,B01,083748,Rideout; David Porter,4,0,37,33
1657269643924,MATH 18,B02,083749,Rideout; David Porter,4,0,36,32
1657269643924,MATH 18,B03,083750,Rideout; David Porter,2,0,37,35
1657269643924,MATH 18,B04,083751,Rideout; David Porter,6,0,36,30
1657269643924,MATH 18,B05,093473,Rideout; David Porter,5,0,36,31
1657269643924,MATH 18,B06,093474,Rideout; David Porter,5,0,36,31
1657269649953,MATH 20A,A01,083754,Zheng; Zequn,14,0,40,26
1657269655983,MATH 20B,A01,083756,Briones; Jor-el Thomas Caparas,3,0,36,33
1657269655983,MATH 20B,A02,083757,Briones; Jor-el Thomas Caparas,1,0,36,35
1657269655983,MATH 20B,A03,093475,Briones; Jor-el Thomas Caparas,2,0,36,34
1657269662007,MATH 20C,A01,083760,Briones; Jor-el Thomas Caparas,1,0,35,34
1657269662007,MATH 20C,A02,083761,Briones; Jor-el Thomas Caparas,8,0,35,27
1657269662007,MATH 20C,A03,093476,Briones; Jor-el Thomas Caparas,0,1,36,36
1657269662007,MATH 20C,B01,083762,Bach; Quang Tran,1,0,30,29
1657269668031,MATH 20D,A01,083765,Tran; Brian Kha,5,0,30,25
1657269668031,MATH 20D,A02,083766,Tran; Brian Kha,5,0,30,25
1657269668031,MATH 20D,A03,083767,Tran; Brian Kha,4,0,30,26
1657269674055,MATH 20E,A01,083771,Ganguly; Soumya,7,0,32,25
1657269674055,MATH 20E,A02,083772,Ganguly; Soumya,7,0,32,25
1657269674055,MATH 20E,B01,083773,Ciotti; Benjamin,19,0,35,16
1657269674055,MATH 20E,B02,083774,Ciotti; Benjamin,17,0,35,18
1657269680082,MATH 103A,A01,083777,Greenfeld; Be'Eri,3,0,36,33
1657269680082,MATH 103A,A02,083778,Greenfeld; Be'Eri,5,0,36,31
1657269680082,MATH 103A,A03,093561,Greenfeld; Be'Eri,4,0,36,32
1657269680082,MATH 103A,B01,083779,Greenfeld; Be'Eri,6,0,36,30
1657269680082,MATH 103A,B02,083780,Greenfeld; Be'Eri,3,0,36,33
1657269680082,MATH 103A,B03,093562,Greenfeld; Be'Eri,3,0,36,33
1657269686107,MATH 105,A01,085443,Carter; Anne Toulson,15,0,35,20
1657269686107,MATH 105,A02,093477,Carter; Anne Toulson,20,0,35,15
1657269692139,MATH 109,A01,083213,Ganzberger; Geoffrey Michael,2,0,34,32
1657269692139,MATH 109,A02,083214,Ganzberger; Geoffrey Michael,4,0,34,30
1657269692139,MATH 109,A03,093478,Ganzberger; Geoffrey Michael,2,0,34,32
1657269692139,MATH 109,B01,083215,Ganzberger; Geoffrey Michael,1,0,32,31
1657269692139,MATH 109,B02,083216,Ganzberger; Geoffrey Michael,1,0,32,31
1657269692139,MATH 109,B03,093479,Ganzberger; Geoffrey Michael,8,0,32,24
1657269698175,MATH 142A,A01,083219,Chow; Bennett,7,0,32,25
1657269698175,MATH 142A,A02,083220,Chow; Bennett,10,0,32,22
1657269698175,MATH 142A,A03,093480,Chow; Bennett,7,0,32,25
1657269698175,MATH 142A,B03,093481,Chow; Bennett,8,0,32,24
1657269698175,MATH 142A,B04,093558,Chow; Bennett,12,0,32,20
1657269698175,MATH 142A,B05,093559,Chow; Bennett,6,0,32,26
1657269704208,MATH 193A,A01,083224,Rotar; Vladimir,7,0,34,27
1657269704208,MATH 193A,A02,083225,Rotar; Vladimir,6,0,34,28
1657269704208,MATH 193A,A03,083781,Rotar; Vladimir,2,0,34,32
1657269704208,MATH 193A,A04,083782,Rotar; Vladimir,8,0,34,26
1657269704208,MATH 193A,A05,093482,Rotar; Vladimir,6,0,34,28
1657269710237,MATH 197,001,091859,McAuley; Julian John,9999,0,9999,0
1657269710237,MATH 197,002,095566,Kedlaya; Kiran S.,9997,0,9999,2
1657269710237,MATH 197,003,095567,Xiao; Ming,9999,0,9999,0
1657269710237,MATH 197,004,095571,Perols; Johan Lars,9998,0,9999,1
1657269717314,COGS 9,A01,083615,Shannon; Kyle Michael,8,0,75,67
1657269723338,COGS 11,A01,083617,Boyle; Mary E. T.,22,0,48,26
1657269729364,COGS 13,A01,083071,Bastos; Amalia Pinkusfeld,9,0,71,62
1657269735388,COGS 14A,A01,092681,Semenuks; Arturs,2,1,100,98
1657269741411,COGS 14B,A01,083073,Cheng; Tzu-Han,6,0,63,57
1657269747436,COGS 17,A01,092677,Semenuks; Arturs,5,0,81,76
1657269753469,COGS 100,A01,083619,Allen; Michael Gordon,16,0,70,54
1657269759500,COGS 101A,A01,083621,Davis; Joshua Daniel,9,0,68,59
1657269765524,COGS 101B,A01,091572,Allen; Michael Gordon,11,0,65,54
1657269771549,COGS 101C,A01,083625,Delgado; Tania,17,0,35,18
1657269777575,COGS 107A,A01,083627,Boyle; Mary E. T.,13,0,60,47
1657269783606,COGS 118A,A01,083075,Gupta; Anjum,18,0,76,58
1657269789632,CSE 3,A50,083646,Miranda; Gregory Joseph,24,0,50,26
1657269795656,CSE 8A,A50,083650,Miranda; Gregory Joseph,17,1,56,39
1657269801686,CSE 11,A01,083080,Cao; Yingjun,5,15,40,35
1657269807711,CSE 12,A01,083652,Krause-Levy; Sophia Louisa,26,1,120,94
1657269813747,CSE 15L,A01,083654,Morris; Justin Loren,9,0,50,41
1657269813747,CSE 15L,A02,083655,Morris; Justin Loren,9,0,50,41
1657269819773,CSE 20,A01,083657,Tran; Khoa Dang,38,0,80,42
1657269825805,CSE 21,A01,095574,Bach; Quang Tran,22,0,48,26
1657269831838,CSE 30,A01,083084,Eldon; John,4,0,80,76
1657269831838,CSE 30,B01,095061,Bhaskar; Nishant,8,0,50,42
1657269837864,CSE 100,A01,083659,Cao; Yingjun,4,4,70,66
1657269843895,CSE 134B,A01,083661,Powell; Thomas Allan,21,0,100,79
1657269849926,CSE 140,A01,083663,Gungor; Onat,13,0,85,72
1657269855955,CSE 140L,A01,083088,Eldon; John,19,0,100,81
1657269861985,CSE 175,A01,083665,Kumar; Rakesh,3,0,25,22
1657269868010,CSE 190,A00,092507,Dubnov; Shlomo,7,0,20,13
1657269874044,ECE 45,A01,083139,Congero; Spencer William,5,0,75,70
1657269880076,ECE 65,A50,083695,Saad; Andrew S,12,0,30,18
1657269880076,ECE 65,A51,095125,Saad; Andrew S,25,0,26,1
1657269886103,ECE 109,A01,091882,Touri; Behrouz,19,0,70,51
1657269892129,ECE 180,A00,083140,Abi Samra; Nicholas Camill,1,0,30,29
1657269892129,ECE 180,B00,083141,Abi Samra; Nicholas Camill,0,0,30,30
1657269898157,MATH 10A,A01,083735,Patchell; Gregory David,2,0,30,28
1657269898157,MATH 10A,A02,083736,Patchell; Gregory David,20,0,30,10
1657269898157,MATH 10A,A03,083737,Patchell; Gregory David,16,0,30,14
1657269904195,MATH 10B,A01,083207,Lim; Seonhee,7,0,34,27
1657269904195,MATH 10B,A02,083208,Lim; Seonhee,9,0,35,26
1657269904195,MATH 10B,A03,093472,Lim; Seonhee,5,0,34,29
1657269904195,MATH 10B,B01,083739,Sinha; Shubham,11,0,30,19
1657269910223,MATH 18,A01,083743,Cinel; Cameron Alexander,6,0,30,24
1657269910223,MATH 18,A02,083744,Cinel; Cameron Alexander,17,0,30,13
1657269910223,MATH 18,A03,083745,Cinel; Cameron Alexander,8,0,30,22
1657269910223,MATH 18,B01,083748,Rideout; David Porter,4,0,37,33
1657269910223,MATH 18,B02,083749,Rideout; David Porter,4,0,36,32
1657269910223,MATH 18,B03,083750,Rideout; David Porter,2,0,37,35
1657269910223,MATH 18,B04,083751,Rideout; David Porter,6,0,36,30
1657269910223,MATH 18,B05,093473,Rideout; David Porter,5,0,36,31
1657269910223,MATH 18,B06,093474,Rideout; David Porter,5,0,36,31
1657269916253,MATH 20A,A01,083754,Zheng; Zequn,14,0,40,26
1657269922284,MATH 20B,A01,083756,Briones; Jor-el Thomas Caparas,3,0,36,33
1657269922284,MATH 20B,A02,083757,Briones; Jor-el Thomas Caparas,1,0,36,35
1657269922284,MATH 20B,A03,093475,Briones; Jor-el Thomas Caparas,2,0,36,34
1657269928319,MATH 20C,A01,083760,Briones; Jor-el Thomas Caparas,1,0,35,34
1657269928319,MATH 20C,A02,083761,Briones; Jor-el Thomas Caparas,8,0,35,27
1657269928319,MATH 20C,A03,093476,Briones; Jor-el Thomas Caparas,0,1,36,36
1657269928319,MATH 20C,B01,083762,Bach; Quang Tran,1,0,30,29
1657269934345,MATH 20D,A01,083765,Tran; Brian Kha,5,0,30,25
1657269934345,MATH 20D,A02,083766,Tran; Brian Kha,5,0,30,25
1657269934345,MATH 20D,A03,083767,Tran; Brian Kha,4,0,30,26
1657269940372,MATH 20E,A01,083771,Ganguly; Soumya,7,0,32,25
1657269940372,MATH 20E,A02,083772,Ganguly; Soumya,7,0,32,25
1657269940372,MATH 20E,B01,083773,Ciotti; Benjamin,19,0,35,16
1657269940372,MATH 20E,B02,083774,Ciotti; Benjamin,17,0,35,18
1657269946399,MATH 103A,A01,083777,Greenfeld; Be'Eri,3,0,36,33
1657269946399,MATH 103A,A02,083778,Greenfeld; Be'Eri,5,0,36,31
1657269946399,MATH 103A,A03,093561,Greenfeld; Be'Eri,4,0,36,32
1657269946399,MATH 103A,B01,083779,Greenfeld; Be'Eri,6,0,36,30
1657269946399,MATH 103A,B02,083780,Greenfeld; Be'Eri,3,0,36,33
1657269946399,MATH 103A,B03,093562,Greenfeld; Be'Eri,3,0,36,33
1657269952426,MATH 105,A01,085443,Carter; Anne Toulson,15,0,35,20
1657269952426,MATH 105,A02,093477,Carter; Anne Toulson,20,0,35,15
1657269958452,MATH 109,A01,083213,Ganzberger; Geoffrey Michael,2,0,34,32
1657269958452,MATH 109,A02,083214,Ganzberger; Geoffrey Michael,4,0,34,30
1657269958452,MATH 109,A03,093478,Ganzberger; Geoffrey Michael,2,0,34,32
1657269958452,MATH 109,B01,083215,Ganzberger; Geoffrey Michael,1,0,32,31
1657269958452,MATH 109,B02,083216,Ganzberger; Geoffrey Michael,1,0,32,31
1657269958452,MATH 109,B03,093479,Ganzberger; Geoffrey Michael,8,0,32,24
1657269964490,MATH 142A,A01,083219,Chow; Bennett,7,0,32,25
1657269964490,MATH 142A,A02,083220,Chow; Bennett,10,0,32,22
1657269964490,MATH 142A,A03,093480,Chow; Bennett,7,0,32,25
1657269964490,MATH 142A,B03,093481,Chow; Bennett,8,0,32,24
1657269964490,MATH 142A,B04,093558,Chow; Bennett,12,0,32,20
1657269964490,MATH 142A,B05,093559,Chow; Bennett,6,0,32,26
1657269970522,MATH 193A,A01,083224,Rotar; Vladimir,7,0,34,27
1657269970522,MATH 193A,A02,083225,Rotar; Vladimir,6,0,34,28
1657269970522,MATH 193A,A03,083781,Rotar; Vladimir,2,0,34,32
1657269970522,MATH 193A,A04,083782,Rotar; Vladimir,8,0,34,26
1657269970522,MATH 193A,A05,093482,Rotar; Vladimir,6,0,34,28
1657269976552,MATH 197,001,091859,McAuley; Julian John,9999,0,9999,0
1657269976552,MATH 197,002,095566,Kedlaya; Kiran S.,9997,0,9999,2
1657269976552,MATH 197,003,095567,Xiao; Ming,9999,0,9999,0
1657269976552,MATH 197,004,095571,Perols; Johan Lars,9998,0,9999,1
1657269983624,COGS 9,A01,083615,Shannon; Kyle Michael,8,0,75,67
1657269989649,COGS 11,A01,083617,Boyle; Mary E. T.,22,0,48,26
1657269995675,COGS 13,A01,083071,Bastos; Amalia Pinkusfeld,9,0,71,62
1657270001700,COGS 14A,A01,092681,Semenuks; Arturs,2,1,100,98
1657270007726,COGS 14B,A01,083073,Cheng; Tzu-Han,6,0,63,57
1657270013755,COGS 17,A01,092677,Semenuks; Arturs,5,0,81,76
1657270019796,COGS 100,A01,083619,Allen; Michael Gordon,16,0,70,54
1657270025820,COGS 101A,A01,083621,Davis; Joshua Daniel,9,0,68,59
1657270031844,COGS 101B,A01,091572,Allen; Michael Gordon,11,0,65,54
1657270037869,COGS 101C,A01,083625,Delgado; Tania,17,0,35,18
1657270043898,COGS 107A,A01,083627,Boyle; Mary E. T.,13,0,60,47
1657270049924,COGS 118A,A01,083075,Gupta; Anjum,18,0,76,58
1657270055951,CSE 3,A50,083646,Miranda; Gregory Joseph,24,0,50,26
1657270061981,CSE 8A,A50,083650,Miranda; Gregory Joseph,17,1,56,39
1657270068006,CSE 11,A01,083080,Cao; Yingjun,5,15,40,35
1657270074032,CSE 12,A01,083652,Krause-Levy; Sophia Louisa,26,1,120,94
1657270080061,CSE 15L,A01,083654,Morris; Justin Loren,9,0,50,41
1657270080061,CSE 15L,A02,083655,Morris; Justin Loren,9,0,50,41
1657270086093,CSE 20,A01,083657,Tran; Khoa Dang,38,0,80,42
1657270092123,CSE 21,A01,095574,Bach; Quang Tran,22,0,48,26
1657270098154,CSE 30,A01,083084,Eldon; John,4,0,80,76
1657270098154,CSE 30,B01,095061,Bhaskar; Nishant,8,0,50,42
1657270104249,CSE 100,A01,083659,Cao; Yingjun,4,4,70,66
1657270110273,CSE 134B,A01,083661,Powell; Thomas Allan,21,0,100,79
1657270116302,CSE 140,A01,083663,Gungor; Onat,13,0,85,72
1657270122328,CSE 140L,A01,083088,Eldon; John,19,0,100,81
1657270128357,CSE 175,A01,083665,Kumar; Rakesh,3,0,25,22
1657270134388,CSE 190,A00,092507,Dubnov; Shlomo,7,0,20,13
1657270140426,ECE 45,A01,083139,Congero; Spencer William,5,0,75,70
1657270146460,ECE 65,A50,083695,Saad; Andrew S,12,0,30,18
1657270146460,ECE 65,A51,095125,Saad; Andrew S,25,0,26,1
1657270152485,ECE 109,A01,091882,Touri; Behrouz,19,0,70,51
1657270158511,ECE 180,A00,083140,Abi Samra; Nicholas Camill,1,0,30,29
1657270158511,ECE 180,B00,083141,Abi Samra; Nicholas Camill,0,0,30,30
1657270164538,MATH 10A,A01,083735,Patchell; Gregory David,2,0,30,28
1657270164538,MATH 10A,A02,083736,Patchell; Gregory David,20,0,30,10
1657270164538,MATH 10A,A03,083737,Patchell; Gregory David,16,0,30,14
1657270170567,MATH 10B,A01,083207,Lim; Seonhee,7,0,34,27
1657270170567,MATH 10B,A02,083208,Lim; Seonhee,9,0,35,26
1657270170567,MATH 10B,A03,093472,Lim; Seonhee,5,0,34,29
1657270170567,MATH 10B,B01,083739,Sinha; Shubham,11,0,30,19
1657270176595,MATH 18,A01,083743,Cinel; Cameron Alexander,6,0,30,24
1657270176595,MATH 18,A02,083744,Cinel; Cameron Alexander,17,0,30,13
1657270176595,MATH 18,A03,083745,Cinel; Cameron Alexander,8,0,30,22
1657270176595,MATH 18,B01,083748,Rideout; David Porter,4,0,37,33
1657270176595,MATH 18,B02,083749,Rideout; David Porter,4,0,36,32
1657270176595,MATH 18,B03,083750,Rideout; David Porter,2,0,37,35
1657270176595,MATH 18,B04,083751,Rideout; David Porter,6,0,36,30
1657270176595,MATH 18,B05,093473,Rideout; David Porter,5,0,36,31
1657270176595,MATH 18,B06,093474,Rideout; David Porter,5,0,36,31
1657270182618,MATH 20A,A01,083754,Zheng; Zequn,14,0,40,26
1657270188648,MATH 20B,A01,083756,Briones; Jor-el Thomas Caparas,3,0,36,33
1657270188648,MATH 20B,A02,083757,Briones; Jor-el Thomas Caparas,1,0,36,35
1657270188648,MATH 20B,A03,093475,Briones; Jor-el Thomas Caparas,2,0,36,34
1657270194673,MATH 20C,A01,083760,Briones; Jor-el Thomas Caparas,1,0,35,34
1657270194673,MATH 20C,A02,083761,Briones; Jor-el Thomas Caparas,8,0,35,27
1657270194673,MATH 20C,A03,093476,Briones; Jor-el Thomas Caparas,0,1,36,36
1657270194673,MATH 20C,B01,083762,Bach; Quang Tran,1,0,30,29
1657270200700,MATH 20D,A01,083765,Tran; Brian Kha,5,0,30,25
1657270200700,MATH 20D,A02,083766,Tran; Brian Kha,5,0,30,25
1657270200700,MATH 20D,A03,083767,Tran; Brian Kha,4,0,30,26
1657270206727,MATH 20E,A01,083771,Ganguly; Soumya,7,0,32,25
1657270206727,MATH 20E,A02,083772,Ganguly; Soumya,7,0,32,25
1657270206727,MATH 20E,B01,083773,Ciotti; Benjamin,19,0,35,16
1657270206727,MATH 20E,B02,083774,Ciotti; Benjamin,17,0,35,18
1657270212765,MATH 103A,A01,083777,Greenfeld; Be'Eri,3,0,36,33
1657270212765,MATH 103A,A02,083778,Greenfeld; Be'Eri,5,0,36,31
1657270212765,MATH 103A,A03,093561,Greenfeld; Be'Eri,4,0,36,32
1657270212765,MATH 103A,B01,083779,Greenfeld; Be'Eri,6,0,36,30
1657270212765,MATH 103A,B02,083780,Greenfeld; Be'Eri,3,0,36,33
1657270212765,MATH 103A,B03,093562,Greenfeld; Be'Eri,3,0,36,33
1657270218798,MATH 105,A01,085443,Carter; Anne Toulson,15,0,35,20
1657270218798,MATH 105,A02,093477,Carter; Anne Toulson,20,0,35,15
1657270224827,MATH 109,A01,083213,Ganzberger; Geoffrey Michael,2,0,34,32
1657270224827,MATH 109,A02,083214,Ganzberger; Geoffrey Michael,4,0,34,30
1657270224827,MATH 109,A03,093478,Ganzberger; Geoffrey Michael,2,0,34,32
1657270224827,MATH 109,B01,083215,Ganzberger; Geoffrey Michael,1,0,32,31
1657270224827,MATH 109,B02,083216,Ganzberger; Geoffrey Michael,1,0,32,31
1657270224827,MATH 109,B03,093479,Ganzberger; Geoffrey Michael,8,0,32,24
1657270230855,MATH 142A,A01,083219,Chow; Bennett,7,0,32,25
1657270230855,MATH 142A,A02,083220,Chow; Bennett,10,0,32,22
1657270230855,MATH 142A,A03,093480,Chow; Bennett,7,0,32,25
1657270230855,MATH 142A,B03,093481,Chow; Bennett,8,0,32,24
1657270230855,MATH 142A,B04,093558,Chow; Bennett,12,0,32,20
1657270230855,MATH 142A,B05,093559,Chow; Bennett,6,0,32,26
1657270236879,MATH 193A,A01,083224,Rotar; Vladimir,7,0,34,27
1657270236879,MATH 193A,A02,083225,Rotar; Vladimir,6,0,34,28
1657270236879,MATH 193A,A03,083781,Rotar; Vladimir,2,0,34,32
1657270236879,MATH 193A,A04,083782,Rotar; Vladimir,8,0,34,26
1657270236879,MATH 193A,A05,093482,Rotar; Vladimir,6,0,34,28
1657270242905,MATH 197,001,091859,McAuley; Julian John,9999,0,9999,0
1657270242905,MATH 197,002,095566,Kedlaya; Kiran S.,9997,0,9999,2
1657270242905,MATH 197,003,095567,Xiao; Ming,9999,0,9999,0
1657270242905,MATH 197,004,095571,Perols; Johan Lars,9998,0,9999,1
1657270249998,COGS 9,A01,083615,Shannon; Kyle Michael,8,0,75,67
1657270256024,COGS 11,A01,083617,Boyle; Mary E. T.,22,0,48,26
1657270262051,COGS 13,A01,083071,Bastos; Amalia Pinkusfeld,9,0,71,62
1657270268076,COGS 14A,A01,092681,Semenuks; Arturs,2,1,100,98
1657270274101,COGS 14B,A01,083073,Cheng; Tzu-Han,6,0,63,57
1657270280126,COGS 17,A01,092677,Semenuks; Arturs,5,0,81,76
1657270286158,COGS 100,A01,083619,Allen; Michael Gordon,16,0,70,54
1657270292182,COGS 101A,A01,083621,Davis; Joshua Daniel,9,0,68,59
1657270298208,COGS 101B,A01,091572,Allen; Michael Gordon,11,0,65,54
1657270304233,COGS 101C,A01,083625,Delgado; Tania,17,0,35,18
1657270310258,COGS 107A,A01,083627,Boyle; Mary E. T.,13,0,60,47
1657270316286,COGS 118A,A01,083075,Gupta; Anjum,18,0,76,58
1657270322311,CSE 3,A50,083646,Miranda; Gregory Joseph,24,0,50,26
1657270328334,CSE 8A,A50,083650,Miranda; Gregory Joseph,17,1,56,39
1657270334359,CSE 11,A01,083080,Cao; Yingjun,5,15,40,35
1657270340388,CSE 12,A01,083652,Krause-Levy; Sophia Louisa,26,1,120,94
1657270346417,CSE 15L,A01,083654,Morris; Justin Loren,9,0,50,41
1657270346417,CSE 15L,A02,083655,Morris; Justin Loren,9,0,50,41
1657270352440,CSE 20,A01,083657,Tran; Khoa Dang,38,0,80,42
1657270358464,CSE 21,A01,095574,Bach; Quang Tran,22,0,48,26
1657270364494,CSE 30,A01,083084,Eldon; John,4,0,80,76
1657270364494,CSE 30,B01,095061,Bhaskar; Nishant,8,0,50,42
1657270370521,CSE 100,A01,083659,Cao; Yingjun,4,4,70,66
1657270376543,CSE 134B,A01,083661,Powell; Thomas Allan,21,0,100,79
1657270382566,CSE 140,A01,083663,Gungor; Onat,13,0,85,72
1657270388592,CSE 140L,A01,083088,Eldon; John,19,0,100,81
1657270394617,CSE 175,A01,083665,Kumar; Rakesh,3,0,25,22
1657270400645,CSE 190,A00,092507,Dubnov; Shlomo,7,0,20,13
1657270406678,ECE 45,A01,083139,Congero; Spencer William,5,0,75,70
1657270412707,ECE 65,A50,083695,Saad; Andrew S,12,0,30,18
1657270412707,ECE 65,A51,095125,Saad; Andrew S,25,0,26,1
1657270418736,ECE 109,A01,091882,Touri; Behrouz,19,0,70,51
1657270424760,ECE 180,A00,083140,Abi Samra; Nicholas Camill,1,0,30,29
1657270424760,ECE 180,B00,083141,Abi Samra; Nicholas Camill,0,0,30,30
1657270430792,MATH 10A,A01,083735,Patchell; Gregory David,2,0,30,28
1657270430792,MATH 10A,A02,083736,Patchell; Gregory David,20,0,30,10
1657270430792,MATH 10A,A03,083737,Patchell; Gregory David,16,0,30,14
1657270436825,MATH 10B,A01,083207,Lim; Seonhee,7,0,34,27
1657270436825,MATH 10B,A02,083208,Lim; Seonhee,9,0,35,26
1657270436825,MATH 10B,A03,093472,Lim; Seonhee,5,0,34,29
1657270436825,MATH 10B,B01,083739,Sinha; Shubham,11,0,30,19
1657270442866,MATH 18,A01,083743,Cinel; Cameron Alexander,6,0,30,24
1657270442866,MATH 18,A02,083744,Cinel; Cameron Alexander,17,0,30,13
1657270442866,MATH 18,A03,083745,Cinel; Cameron Alexander,8,0,30,22
1657270442866,MATH 18,B01,083748,Rideout; David Porter,4,0,37,33
1657270442866,MATH 18,B02,083749,Rideout; David Porter,4,0,36,32
1657270442866,MATH 18,B03,083750,Rideout; David Porter,2,0,37,35
1657270442866,MATH 18,B04,083751,Rideout; David Porter,6,0,36,30
1657270442866,MATH 18,B05,093473,Rideout; David Porter,5,0,36,31
1657270442866,MATH 18,B06,093474,Rideout; David Porter,5,0,36,31
1657270448894,MATH 20A,A01,083754,Zheng; Zequn,14,0,40,26
1657270454922,MATH 20B,A01,083756,Briones; Jor-el Thomas Caparas,3,0,36,33
1657270454922,MATH 20B,A02,083757,Briones; Jor-el Thomas Caparas,1,0,36,35
1657270454922,MATH 20B,A03,093475,Briones; Jor-el Thomas Caparas,2,0,36,34
1657270460946,MATH 20C,A01,083760,Briones; Jor-el Thomas Caparas,1,0,35,34
1657270460946,MATH 20C,A02,083761,Briones; Jor-el Thomas Caparas,8,0,35,27
1657270460946,MATH 20C,A03,093476,Briones; Jor-el Thomas Caparas,0,1,36,36
1657270460946,MATH 20C,B01,083762,Bach; Quang Tran,1,0,30,29
1657270466974,MATH 20D,A01,083765,Tran; Brian Kha,5,0,30,25
1657270466974,MATH 20D,A02,083766,Tran; Brian Kha,5,0,30,25
1657270466974,MATH 20D,A03,083767,Tran; Brian Kha,4,0,30,26
1657270473009,MATH 20E,A01,083771,Ganguly; Soumya,7,0,32,25
1657270473009,MATH 20E,A02,083772,Ganguly; Soumya,7,0,32,25
1657270473009,MATH 20E,B01,083773,Ciotti; Benjamin,19,0,35,16
1657270473009,MATH 20E,B02,083774,Ciotti; Benjamin,17,0,35,18
1657270479034,MATH 103A,A01,083777,Greenfeld; Be'Eri,3,0,36,33
1657270479034,MATH 103A,A02,083778,Greenfeld; Be'Eri,5,0,36,31
1657270479034,MATH 103A,A03,093561,Greenfeld; Be'Eri,4,0,36,32
1657270479034,MATH 103A,B01,083779,Greenfeld; Be'Eri,6,0,36,30
1657270479034,MATH 103A,B02,083780,Greenfeld; Be'Eri,3,0,36,33
1657270479034,MATH 103A,B03,093562,Greenfeld; Be'Eri,3,0,36,33
1657270485062,MATH 105,A01,085443,Carter; Anne Toulson,15,0,35,20
1657270485062,MATH 105,A02,093477,Carter; Anne Toulson,20,0,35,15
1657270491087,MATH 109,A01,083213,Ganzberger; Geoffrey Michael,2,0,34,32
1657270491087,MATH 109,A02,083214,Ganzberger; Geoffrey Michael,4,0,34,30
1657270491087,MATH 109,A03,093478,Ganzberger; Geoffrey Michael,2,0,34,32
1657270491087,MATH 109,B01,083215,Ganzberger; Geoffrey Michael,1,0,32,31
1657270491087,MATH 109,B02,083216,Ganzberger; Geoffrey Michael,1,0,32,31
1657270491087,MATH 109,B03,093479,Ganzberger; Geoffrey Michael,8,0,32,24
1657270497117,MATH 142A,A01,083219,Chow; Bennett,7,0,32,25
1657270497117,MATH 142A,A02,083220,Chow; Bennett,10,0,32,22
1657270497117,MATH 142A,A03,093480,Chow; Bennett,7,0,32,25
1657270497117,MATH 142A,B03,093481,Chow; Bennett,8,0,32,24
1657270497117,MATH 142A,B04,093558,Chow; Bennett,12,0,32,20
1657270497117,MATH 142A,B05,093559,Chow; Bennett,6,0,32,26
1657270503148,MATH 193A,A01,083224,Rotar; Vladimir,7,0,34,27
1657270503148,MATH 193A,A02,083225,Rotar; Vladimir,6,0,34,28
1657270503148,MATH 193A,A03,083781,Rotar; Vladimir,2,0,34,32
1657270503148,MATH 193A,A04,083782,Rotar; Vladimir,8,0,34,26
1657270503148,MATH 193A,A05,093482,Rotar; Vladimir,6,0,34,28
1657270509188,MATH 197,001,091859,McAuley; Julian John,9999,0,9999,0
1657270509188,MATH 197,002,095566,Kedlaya; Kiran S.,9997,0,9999,2
1657270509188,MATH 197,003,095567,Xiao; Ming,9999,0,9999,0
1657270509188,MATH 197,004,095571,Perols; Johan Lars,9998,0,9999,1
1657270516253,COGS 9,A01,083615,Shannon; Kyle Michael,8,0,75,67
1657270522275,COGS 11,A01,083617,Boyle; Mary E. T.,22,0,48,26
1657270528302,COGS 13,A01,083071,Bastos; Amalia Pinkusfeld,9,0,71,62
1657270534330,COGS 14A,A01,092681,Semenuks; Arturs,2,1,100,98
1657270540358,COGS 14B,A01,083073,Cheng; Tzu-Han,6,0,63,57
1657270546380,COGS 17,A01,092677,Semenuks; Arturs,5,0,81,76
1657270552402,COGS 100,A01,083619,Allen; Michael Gordon,16,0,70,54
1657270558429,COGS 101A,A01,083621,Davis; Joshua Daniel,9,0,68,59
1657270564458,COGS 101B,A01,091572,Allen; Michael Gordon,11,0,65,54
1657270570482,COGS 101C,A01,083625,Delgado; Tania,17,0,35,18
1657270576513,COGS 107A,A01,083627,Boyle; Mary E. T.,13,0,60,47
1657270582543,COGS 118A,A01,083075,Gupta; Anjum,18,0,76,58
1657270588571,CSE 3,A50,083646,Miranda; Gregory Joseph,24,0,50,26
1657270594595,CSE 8A,A50,083650,Miranda; Gregory Joseph,17,1,56,39
1657270600621,CSE 11,A01,083080,Cao; Yingjun,5,15,40,35
1657270606646,CSE 12,A01,083652,Krause-Levy; Sophia Louisa,26,1,120,94
1657270612675,CSE 15L,A01,083654,Morris; Justin Loren,9,0,50,41
1657270612675,CSE 15L,A02,083655,Morris; Justin Loren,9,0,50,41
1657270618704,CSE 20,A01,083657,Tran; Khoa Dang,38,0,80,42
1657270624727,CSE 21,A01,095574,Bach; Quang Tran,22,0,48,26
1657270630755,CSE 30,A01,083084,Eldon; John,4,0,80,76
1657270630755,CSE 30,B01,095061,Bhaskar; Nishant,8,0,50,42
1657270636784,CSE 100,A01,083659,Cao; Yingjun,4,4,70,66
1657270642806,CSE 134B,A01,083661,Powell; Thomas Allan,21,0,100,79
1657270648829,CSE 140,A01,083663,Gungor; Onat,13,0,85,72
1657270654853,CSE 140L,A01,083088,Eldon; John,19,0,100,81
1657270660882,CSE 175,A01,083665,Kumar; Rakesh,3,0,25,22
1657270666905,CSE 190,A00,092507,Dubnov; Shlomo,7,0,20,13
1657270672929,ECE 45,A01,083139,Congero; Spencer William,5,0,75,70
1657270678955,ECE 65,A50,083695,Saad; Andrew S,12,0,30,18
1657270678955,ECE 65,A51,095125,Saad; Andrew S,25,0,26,1
1657270684982,ECE 109,A01,091882,Touri; Behrouz,19,0,70,51
1657270691006,ECE 180,A00,083140,Abi Samra; Nicholas Camill,1,0,30,29
1657270691006,ECE 180,B00,083141,Abi Samra; Nicholas Camill,0,0,30,30
1657270697046,MATH 10A,A01,083735,Patchell; Gregory David,2,0,30,28
1657270697046,MATH 10A,A02,083736,Patchell; Gregory David,20,0,30,10
1657270697046,MATH 10A,A03,083737,Patchell; Gregory David,16,0,30,14
1657270703162,MATH 10B,A01,083207,Lim; Seonhee,7,0,34,27
1657270703162,MATH 10B,A02,083208,Lim; Seonhee,9,0,35,26
1657270703162,MATH 10B,A03,093472,Lim; Seonhee,5,0,34,29
1657270703162,MATH 10B,B01,083739,Sinha; Shubham,11,0,30,19
1657270709189,MATH 18,A01,083743,Cinel; Cameron Alexander,6,0,30,24
1657270709189,MATH 18,A02,083744,Cinel; Cameron Alexander,17,0,30,13
1657270709189,MATH 18,A03,083745,Cinel; Cameron Alexander,8,0,30,22
1657270709189,MATH 18,B01,083748,Rideout; David Porter,4,0,37,33
1657270709189,MATH 18,B02,083749,Rideout; David Porter,4,0,36,32
1657270709189,MATH 18,B03,083750,Rideout; David Porter,2,0,37,35
1657270709189,MATH 18,B04,083751,Rideout; David Porter,6,0,36,30
1657270709189,MATH 18,B05,093473,Rideout; David Porter,5,0,36,31
1657270709189,MATH 18,B06,093474,Rideout; David Porter,5,0,36,31
1657270715212,MATH 20A,A01,083754,Zheng; Zequn,14,0,40,26
1657270721243,MATH 20B,A01,083756,Briones; Jor-el Thomas Caparas,3,0,36,33
1657270721243,MATH 20B,A02,083757,Briones; Jor-el Thomas Caparas,1,0,36,35
1657270721243,MATH 20B,A03,093475,Briones; Jor-el Thomas Caparas,2,0,36,34
1657270727274,MATH 20C,A01,083760,Briones; Jor-el Thomas Caparas,1,0,35,34
1657270727274,MATH 20C,A02,083761,Briones; Jor-el Thomas Caparas,8,0,35,27
1657270727274,MATH 20C,A03,093476,Briones; Jor-el Thomas Caparas,0,1,36,36
1657270727274,MATH 20C,B01,083762,Bach; Quang Tran,1,0,30,29
1657270733310,MATH 20D,A01,083765,Tran; Brian Kha,5,0,30,25
1657270733310,MATH 20D,A02,083766,Tran; Brian Kha,5,0,30,25
1657270733310,MATH 20D,A03,083767,Tran; Brian Kha,4,0,30,26
1657270739345,MATH 20E,A01,083771,Ganguly; Soumya,7,0,32,25
1657270739345,MATH 20E,A02,083772,Ganguly; Soumya,7,0,32,25
1657270739345,MATH 20E,B01,083773,Ciotti; Benjamin,19,0,35,16
1657270739345,MATH 20E,B02,083774,Ciotti; Benjamin,17,0,35,18
1657270745370,MATH 103A,A01,083777,Greenfeld; Be'Eri,3,0,36,33
1657270745370,MATH 103A,A02,083778,Greenfeld; Be'Eri,5,0,36,31
1657270745370,MATH 103A,A03,093561,Greenfeld; Be'Eri,4,0,36,32
1657270745370,MATH 103A,B01,083779,Greenfeld; Be'Eri,6,0,36,30
1657270745370,MATH 103A,B02,083780,Greenfeld; Be'Eri,3,0,36,33
1657270745370,MATH 103A,B03,093562,Greenfeld; Be'Eri,3,0,36,33
1657270751394,MATH 105,A01,085443,Carter; Anne Toulson,15,0,35,20
1657270751394,MATH 105,A02,093477,Carter; Anne Toulson,20,0,35,15
1657270757420,MATH 109,A01,083213,Ganzberger; Geoffrey Michael,2,0,34,32
1657270757420,MATH 109,A02,083214,Ganzberger; Geoffrey Michael,4,0,34,30
1657270757420,MATH 109,A03,093478,Ganzberger; Geoffrey Michael,2,0,34,32
1657270757420,MATH 109,B01,083215,Ganzberger; Geoffrey Michael,1,0,32,31
1657270757420,MATH 109,B02,083216,Ganzberger; Geoffrey Michael,1,0,32,31
1657270757420,MATH 109,B03,093479,Ganzberger; Geoffrey Michael,8,0,32,24
1657270763452,MATH 142A,A01,083219,Chow; Bennett,7,0,32,25
1657270763452,MATH 142A,A02,083220,Chow; Bennett,10,0,32,22
1657270763452,MATH 142A,A03,093480,Chow; Bennett,7,0,32,25
1657270763452,MATH 142A,B03,093481,Chow; Bennett,8,0,32,24
1657270763452,MATH 142A,B04,093558,Chow; Bennett,12,0,32,20
1657270763452,MATH 142A,B05,093559,Chow; Bennett,6,0,32,26
1657270769477,MATH 193A,A01,083224,Rotar; Vladimir,7,0,34,27
1657270769477,MATH 193A,A02,083225,Rotar; Vladimir,6,0,34,28
1657270769477,MATH 193A,A03,083781,Rotar; Vladimir,2,0,34,32
1657270769477,MATH 193A,A04,083782,Rotar; Vladimir,8,0,34,26
1657270769477,MATH 193A,A05,093482,Rotar; Vladimir,6,0,34,28
1657270775500,MATH 197,001,091859,McAuley; Julian John,9999,0,9999,0
1657270775500,MATH 197,002,095566,Kedlaya; Kiran S.,9997,0,9999,2
1657270775500,MATH 197,003,095567,Xiao; Ming,9999,0,9999,0
1657270775500,MATH 197,004,095571,Perols; Johan Lars,9998,0,9999,1
1657270782578,COGS 9,A01,083615,Shannon; Kyle Michael,8,0,75,67
1657270788606,COGS 11,A01,083617,Boyle; Mary E. T.,22,0,48,26
1657270794630,COGS 13,A01,083071,Bastos; Amalia Pinkusfeld,9,0,71,62
1657270800657,COGS 14A,A01,092681,Semenuks; Arturs,2,1,100,98
1657270806686,COGS 14B,A01,083073,Cheng; Tzu-Han,6,0,63,57
1657270812711,COGS 17,A01,092677,Semenuks; Arturs,5,0,81,76
1657270818738,COGS 100,A01,083619,Allen; Michael Gordon,16,0,70,54
1657270824768,COGS 101A,A01,083621,Davis; Joshua Daniel,9,0,68,59
1657270830792,COGS 101B,A01,091572,Allen; Michael Gordon,11,0,65,54
1657270836817,COGS 101C,A01,083625,Delgado; Tania,17,0,35,18
1657270842842,COGS 107A,A01,083627,Boyle; Mary E. T.,13,0,60,47
1657270848865,COGS 118A,A01,083075,Gupta; Anjum,18,0,76,58
1657270854892,CSE 3,A50,083646,Miranda; Gregory Joseph,24,0,50,26
1657270860916,CSE 8A,A50,083650,Miranda; Gregory Joseph,17,1,56,39
1657270866946,CSE 11,A01,083080,Cao; Yingjun,5,15,40,35
1657270872974,CSE 12,A01,083652,Krause-Levy; Sophia Louisa,26,1,120,94
1657270878998,CSE 15L,A01,083654,Morris; Justin Loren,9,0,50,41
1657270878998,CSE 15L,A02,083655,Morris; Justin Loren,9,0,50,41
1657270885020,CSE 20,A01,083657,Tran; Khoa Dang,38,0,80,42
1657270891050,CSE 21,A01,095574,Bach; Quang Tran,22,0,48,26
1657270897084,CSE 30,A01,083084,Eldon; John,4,0,80,76
1657270897084,CSE 30,B01,095061,Bhaskar; Nishant,8,0,50,42
1657270903114,CSE 100,A01,083659,Cao; Yingjun,4,4,70,66
1657270909139,CSE 134B,A01,083661,Powell; Thomas Allan,21,0,100,79
1657270915162,CSE 140,A01,083663,Gungor; Onat,13,0,85,72
1657270921192,CSE 140L,A01,083088,Eldon; John,19,0,100,81
1657270927225,CSE 175,A01,083665,Kumar; Rakesh,3,0,25,22
1657270933257,CSE 190,A00,092507,Dubnov; Shlomo,7,0,20,13
1657270939293,ECE 45,A01,083139,Congero; Spencer William,5,0,75,70
1657270945318,ECE 65,A50,083695,Saad; Andrew S,12,0,30,18
1657270945318,ECE 65,A51,095125,Saad; Andrew S,25,0,26,1
1657270951343,ECE 109,A01,091882,Touri; Behrouz,19,0,70,51
1657270957366,ECE 180,A00,083140,Abi Samra; Nicholas Camill,1,0,30,29
1657270957366,ECE 180,B00,083141,Abi Samra; Nicholas Camill,0,0,30,30
1657270963392,MATH 10A,A01,083735,Patchell; Gregory David,2,0,30,28
1657270963392,MATH 10A,A02,083736,Patchell; Gregory David,20,0,30,10
1657270963392,MATH 10A,A03,083737,Patchell; Gregory David,16,0,30,14
1657270969425,MATH 10B,A01,083207,Lim; Seonhee,7,0,34,27
1657270969425,MATH 10B,A02,083208,Lim; Seonhee,9,0,35,26
1657270969425,MATH 10B,A03,093472,Lim; Seonhee,5,0,34,29
1657270969425,MATH 10B,B01,083739,Sinha; Shubham,11,0,30,19
1657270975450,MATH 18,A01,083743,Cinel; Cameron Alexander,6,0,30,24
1657270975450,MATH 18,A02,083744,Cinel; Cameron Alexander,17,0,30,13
1657270975450,MATH 18,A03,083745,Cinel; Cameron Alexander,8,0,30,22
1657270975450,MATH 18,B01,083748,Rideout; David Porter,4,0,37,33
1657270975450,MATH 18,B02,083749,Rideout; David Porter,4,0,36,32
1657270975450,MATH 18,B03,083750,Rideout; David Porter,2,0,37,35
1657270975450,MATH 18,B04,083751,Rideout; David Porter,6,0,36,30
1657270975450,MATH 18,B05,093473,Rideout; David Porter,5,0,36,31
1657270975450,MATH 18,B06,093474,Rideout; David Porter,5,0,36,31
1657270981476,MATH 20A,A01,083754,Zheng; Zequn,14,0,40,26
1657270987502,MATH 20B,A01,083756,Briones; Jor-el Thomas Caparas,3,0,36,33
1657270987502,MATH 20B,A02,083757,Briones; Jor-el Thomas Caparas,1,0,36,35
1657270987502,MATH 20B,A03,093475,Briones; Jor-el Thomas Caparas,2,0,36,34
1657270993528,MATH 20C,A01,083760,Briones; Jor-el Thomas Caparas,1,0,35,34
1657270993528,MATH 20C,A02,083761,Briones; Jor-el Thomas Caparas,8,0,35,27
1657270993528,MATH 20C,A03,093476,Briones; Jor-el Thomas Caparas,0,1,36,36
1657270993528,MATH 20C,B01,083762,Bach; Quang Tran,1,0,30,29
1657270999554,MATH 20D,A01,083765,Tran; Brian Kha,5,0,30,25
1657270999554,MATH 20D,A02,083766,Tran; Brian Kha,5,0,30,25
1657270999554,MATH 20D,A03,083767,Tran; Brian Kha,4,0,30,26
1657271005580,MATH 20E,A01,083771,Ganguly; Soumya,7,0,32,25
1657271005580,MATH 20E,A02,083772,Ganguly; Soumya,7,0,32,25
1657271005580,MATH 20E,B01,083773,Ciotti; Benjamin,19,0,35,16
1657271005580,MATH 20E,B02,083774,Ciotti; Benjamin,17,0,35,18
1657271011606,MATH 103A,A01,083777,Greenfeld; Be'Eri,3,0,36,33
1657271011606,MATH 103A,A02,083778,Greenfeld; Be'Eri,5,0,36,31
1657271011606,MATH 103A,A03,093561,Greenfeld; Be'Eri,4,0,36,32
1657271011606,MATH 103A,B01,083779,Greenfeld; Be'Eri,6,0,36,30
1657271011606,MATH 103A,B02,083780,Greenfeld; Be'Eri,3,0,36,33
1657271011606,MATH 103A,B03,093562,Greenfeld; Be'Eri,3,0,36,33
1657271017631,MATH 105,A01,085443,Carter; Anne Toulson,15,0,35,20
1657271017631,MATH 105,A02,093477,Carter; Anne Toulson,20,0,35,15
1657271023667,MATH 109,A01,083213,Ganzberger; Geoffrey Michael,2,0,34,32
1657271023667,MATH 109,A02,083214,Ganzberger; Geoffrey Michael,4,0,34,30
1657271023667,MATH 109,A03,093478,Ganzberger; Geoffrey Michael,2,0,34,32
1657271023667,MATH 109,B01,083215,Ganzberger; Geoffrey Michael,1,0,32,31
1657271023667,MATH 109,B02,083216,Ganzberger; Geoffrey Michael,1,0,32,31
1657271023667,MATH 109,B03,093479,Ganzberger; Geoffrey Michael,8,0,32,24
1657271029697,MATH 142A,A01,083219,Chow; Bennett,7,0,32,25
1657271029697,MATH 142A,A02,083220,Chow; Bennett,10,0,32,22
1657271029697,MATH 142A,A03,093480,Chow; Bennett,7,0,32,25
1657271029697,MATH 142A,B03,093481,Chow; Bennett,8,0,32,24
1657271029697,MATH 142A,B04,093558,Chow; Bennett,12,0,32,20
1657271029697,MATH 142A,B05,093559,Chow; Bennett,6,0,32,26
1657271035720,MATH 193A,A01,083224,Rotar; Vladimir,7,0,34,27
1657271035720,MATH 193A,A02,083225,Rotar; Vladimir,6,0,34,28
1657271035720,MATH 193A,A03,083781,Rotar; Vladimir,2,0,34,32
1657271035720,MATH 193A,A04,083782,Rotar; Vladimir,8,0,34,26
1657271035720,MATH 193A,A05,093482,Rotar; Vladimir,6,0,34,28
1657271041745,MATH 197,001,091859,McAuley; Julian John,9999,0,9999,0
1657271041745,MATH 197,002,095566,Kedlaya; Kiran S.,9997,0,9999,2
1657271041745,MATH 197,003,095567,Xiao; Ming,9999,0,9999,0
1657271041745,MATH 197,004,095571,Perols; Johan Lars,9998,0,9999,1
1657271048811,COGS 9,A01,083615,Shannon; Kyle Michael,8,0,75,67
1657271054838,COGS 11,A01,083617,Boyle; Mary E. T.,22,0,48,26
1657271060866,COGS 13,A01,083071,Bastos; Amalia Pinkusfeld,9,0,71,62
1657271066890,COGS 14A,A01,092681,Semenuks; Arturs,2,1,100,98
1657271072914,COGS 14B,A01,083073,Cheng; Tzu-Han,6,0,63,57
1657271078943,COGS 17,A01,092677,Semenuks; Arturs,5,0,81,76
1657271084973,COGS 100,A01,083619,Allen; Michael Gordon,16,0,70,54
1657271090997,COGS 101A,A01,083621,Davis; Joshua Daniel,9,0,68,59
1657271097021,COGS 101B,A01,091572,Allen; Michael Gordon,11,0,65,54
1657271103044,COGS 101C,A01,083625,Delgado; Tania,17,0,35,18
1657271109068,COGS 107A,A01,083627,Boyle; Mary E. T.,13,0,60,47
1657271115093,COGS 118A,A01,083075,Gupta; Anjum,18,0,76,58
1657271121119,CSE 3,A50,083646,Miranda; Gregory Joseph,24,0,50,26
1657271127142,CSE 8A,A50,083650,Miranda; Gregory Joseph,17,1,56,39
1657271133171,CSE 11,A01,083080,Cao; Yingjun,5,15,40,35
1657271139196,CSE 12,A01,083652,Krause-Levy; Sophia Louisa,26,1,120,94
1657271145220,CSE 15L,A01,083654,Morris; Justin Loren,9,0,50,41
1657271145220,CSE 15L,A02,083655,Morris; Justin Loren,9,0,50,41
1657271151244,CSE 20,A01,083657,Tran; Khoa Dang,38,0,80,42
1657271157273,CSE 21,A01,095574,Bach; Quang Tran,22,0,48,26
1657271163305,CSE 30,A01,083084,Eldon; John,4,0,80,76
1657271163305,CSE 30,B01,095061,Bhaskar; Nishant,8,0,50,42
1657271169330,CSE 100,A01,083659,Cao; Yingjun,4,4,70,66
1657271175354,CSE 134B,A01,083661,Powell; Thomas Allan,21,0,100,79
1657271181379,CSE 140,A01,083663,Gungor; Onat,13,0,85,72
1657271187402,CSE 140L,A01,083088,Eldon; John,19,0,100,81
1657271193427,CSE 175,A01,083665,Kumar; Rakesh,3,0,25,22
1657271199453,CSE 190,A00,092507,Dubnov; Shlomo,7,0,20,13
1657271205478,ECE 45,A01,083139,Congero; Spencer William,5,0,75,70
1657271211509,ECE 65,A50,083695,Saad; Andrew S,12,0,30,18
1657271211509,ECE 65,A51,095125,Saad; Andrew S,25,0,26,1
1657271217533,ECE 109,A01,091882,Touri; Behrouz,19,0,70,51
1657271223562,ECE 180,A00,083140,Abi Samra; Nicholas Camill,1,0,30,29
1657271223562,ECE 180,B00,083141,Abi Samra; Nicholas Camill,0,0,30,30
1657271229589,MATH 10A,A01,083735,Patchell; Gregory David,2,0,30,28
1657271229589,MATH 10A,A02,083736,Patchell; Gregory David,20,0,30,10
1657271229589,MATH 10A,A03,083737,Patchell; Gregory David,16,0,30,14
1657271235616,MATH 10B,A01,083207,Lim; Seonhee,7,0,34,27
1657271235616,MATH 10B,A02,083208,Lim; Seonhee,9,0,35,26
1657271235616,MATH 10B,A03,093472,Lim; Seonhee,5,0,34,29
1657271235616,MATH 10B,B01,083739,Sinha; Shubham,11,0,30,19
1657271241641,MATH 18,A01,083743,Cinel; Cameron Alexander,6,0,30,24
1657271241641,MATH 18,A02,083744,Cinel; Cameron Alexander,17,0,30,13
1657271241641,MATH 18,A03,083745,Cinel; Cameron Alexander,8,0,30,22
1657271241641,MATH 18,B01,083748,Rideout; David Porter,4,0,37,33
1657271241641,MATH 18,B02,083749,Rideout; David Porter,4,0,36,32
1657271241641,MATH 18,B03,083750,Rideout; David Porter,2,0,37,35
1657271241641,MATH 18,B04,083751,Rideout; David Porter,6,0,36,30
1657271241641,MATH 18,B05,093473,Rideout; David Porter,5,0,36,31
1657271241641,MATH 18,B06,093474,Rideout; David Porter,5,0,36,31
1657271247669,MATH 20A,A01,083754,Zheng; Zequn,14,0,40,26
1657271253693,MATH 20B,A01,083756,Briones; Jor-el Thomas Caparas,3,0,36,33
1657271253693,MATH 20B,A02,083757,Briones; Jor-el Thomas Caparas,1,0,36,35
1657271253693,MATH 20B,A03,093475,Briones; Jor-el Thomas Caparas,2,0,36,34
1657271259718,MATH 20C,A01,083760,Briones; Jor-el Thomas Caparas,1,0,35,34
1657271259718,MATH 20C,A02,083761,Briones; Jor-el Thomas Caparas,8,0,35,27
1657271259718,MATH 20C,A03,093476,Briones; Jor-el Thomas Caparas,0,1,36,36
1657271259718,MATH 20C,B01,083762,Bach; Quang Tran,1,0,30,29
1657271265743,MATH 20D,A01,083765,Tran; Brian Kha,5,0,30,25
1657271265743,MATH 20D,A02,083766,Tran; Brian Kha,5,0,30,25
1657271265743,MATH 20D,A03,083767,Tran; Brian Kha,4,0,30,26
1657271271768,MATH 20E,A01,083771,Ganguly; Soumya,7,0,32,25
1657271271768,MATH 20E,A02,083772,Ganguly; Soumya,7,0,32,25
1657271271768,MATH 20E,B01,083773,Ciotti; Benjamin,19,0,35,16
1657271271768,MATH 20E,B02,083774,Ciotti; Benjamin,17,0,35,18
1657271277798,MATH 103A,A01,083777,Greenfeld; Be'Eri,3,0,36,33
1657271277798,MATH 103A,A02,083778,Greenfeld; Be'Eri,5,0,36,31
1657271277798,MATH 103A,A03,093561,Greenfeld; Be'Eri,4,0,36,32
1657271277798,MATH 103A,B01,083779,Greenfeld; Be'Eri,6,0,36,30
1657271277798,MATH 103A,B02,083780,Greenfeld; Be'Eri,3,0,36,33
1657271277798,MATH 103A,B03,093562,Greenfeld; Be'Eri,3,0,36,33
1657271283823,MATH 105,A01,085443,Carter; Anne Toulson,15,0,35,20
1657271283823,MATH 105,A02,093477,Carter; Anne Toulson,20,0,35,15
1657271289846,MATH 109,A01,083213,Ganzberger; Geoffrey Michael,2,0,34,32
1657271289846,MATH 109,A02,083214,Ganzberger; Geoffrey Michael,4,0,34,30
1657271289846,MATH 109,A03,093478,Ganzberger; Geoffrey Michael,2,0,34,32
1657271289846,MATH 109,B01,083215,Ganzberger; Geoffrey Michael,1,0,32,31
1657271289846,MATH 109,B02,083216,Ganzberger; Geoffrey Michael,1,0,32,31
1657271289846,MATH 109,B03,093479,Ganzberger; Geoffrey Michael,8,0,32,24
1657271295874,MATH 142A,A01,083219,Chow; Bennett,7,0,32,25
1657271295874,MATH 142A,A02,083220,Chow; Bennett,10,0,32,22
1657271295874,MATH 142A,A03,093480,Chow; Bennett,7,0,32,25
1657271295874,MATH 142A,B03,093481,Chow; Bennett,8,0,32,24
1657271295874,MATH 142A,B04,093558,Chow; Bennett,12,0,32,20
1657271295874,MATH 142A,B05,093559,Chow; Bennett,6,0,32,26
1657271301970,MATH 193A,A01,083224,Rotar; Vladimir,7,0,34,27
1657271301970,MATH 193A,A02,083225,Rotar; Vladimir,6,0,34,28
1657271301970,MATH 193A,A03,083781,Rotar; Vladimir,2,0,34,32
1657271301970,MATH 193A,A04,083782,Rotar; Vladimir,8,0,34,26
1657271301970,MATH 193A,A05,093482,Rotar; Vladimir,6,0,34,28
1657271307993,MATH 197,001,091859,McAuley; Julian John,9999,0,9999,0
1657271307993,MATH 197,002,095566,Kedlaya; Kiran S.,9997,0,9999,2
1657271307993,MATH 197,003,095567,Xiao; Ming,9999,0,9999,0
1657271307993,MATH 197,004,095571,Perols; Johan Lars,9998,0,9999,1
1657271315057,COGS 9,A01,083615,Shannon; Kyle Michael,8,0,75,67
1657271321082,COGS 11,A01,083617,Boyle; Mary E. T.,22,0,48,26
1657271327112,COGS 13,A01,083071,Bastos; Amalia Pinkusfeld,9,0,71,62
1657271333141,COGS 14A,A01,092681,Semenuks; Arturs,2,1,100,98
1657271339169,COGS 14B,A01,083073,Cheng; Tzu-Han,6,0,63,57
1657271345198,COGS 17,A01,092677,Semenuks; Arturs,5,0,81,76
1657271351222,COGS 100,A01,083619,Allen; Michael Gordon,16,0,70,54
1657271357251,COGS 101A,A01,083621,Davis; Joshua Daniel,9,0,68,59
1657271363274,COGS 101B,A01,091572,Allen; Michael Gordon,11,0,65,54
1657271369300,COGS 101C,A01,083625,Delgado; Tania,17,0,35,18
1657271375324,COGS 107A,A01,083627,Boyle; Mary E. T.,13,0,60,47
1657271381353,COGS 118A,A01,083075,Gupta; Anjum,18,0,76,58
1657271387381,CSE 3,A50,083646,Miranda; Gregory Joseph,24,0,50,26
1657271393409,CSE 8A,A50,083650,Miranda; Gregory Joseph,17,1,56,39
1657271399437,CSE 11,A01,083080,Cao; Yingjun,5,15,40,35
1657271405473,CSE 12,A01,083652,Krause-Levy; Sophia Louisa,26,1,120,94
1657271411495,CSE 15L,A01,083654,Morris; Justin Loren,9,0,50,41
1657271411495,CSE 15L,A02,083655,Morris; Justin Loren,9,0,50,41
1657271417523,CSE 20,A01,083657,Tran; Khoa Dang,38,0,80,42
1657271423547,CSE 21,A01,095574,Bach; Quang Tran,22,0,48,26
1657271429571,CSE 30,A01,083084,Eldon; John,4,0,80,76
1657271429571,CSE 30,B01,095061,Bhaskar; Nishant,8,0,50,42
1657271435594,CSE 100,A01,083659,Cao; Yingjun,4,4,70,66
1657271441616,CSE 134B,A01,083661,Powell; Thomas Allan,21,0,100,79
1657271447641,CSE 140,A01,083663,Gungor; Onat,13,0,85,72
1657271453671,CSE 140L,A01,083088,Eldon; John,19,0,100,81
1657271459698,CSE 175,A01,083665,Kumar; Rakesh,3,0,25,22
1657271465724,CSE 190,A00,092507,Dubnov; Shlomo,7,0,20,13
1657271471749,ECE 45,A01,083139,Congero; Spencer William,5,0,75,70
1657271477780,ECE 65,A50,083695,Saad; Andrew S,12,0,30,18
1657271477780,ECE 65,A51,095125,Saad; Andrew S,25,0,26,1
1657271483803,ECE 109,A01,091882,Touri; Behrouz,19,0,70,51
1657271489831,ECE 180,A00,083140,Abi Samra; Nicholas Camill,1,0,30,29
1657271489831,ECE 180,B00,083141,Abi Samra; Nicholas Camill,0,0,30,30
1657271495855,MATH 10A,A01,083735,Patchell; Gregory David,2,0,30,28
1657271495855,MATH 10A,A02,083736,Patchell; Gregory David,20,0,30,10
1657271495855,MATH 10A,A03,083737,Patchell; Gregory David,16,0,30,14
1657271501880,MATH 10B,A01,083207,Lim; Seonhee,7,0,34,27
1657271501880,MATH 10B,A02,083208,Lim; Seonhee,9,0,35,26
1657271501880,MATH 10B,A03,093472,Lim; Seonhee,5,0,34,29
1657271501880,MATH 10B,B01,083739,Sinha; Shubham,11,0,30,19
1657271507915,MATH 18,A01,083743,Cinel; Cameron Alexander,6,0,30,24
1657271507915,MATH 18,A02,083744,Cinel; Cameron Alexander,17,0,30,13
1657271507915,MATH 18,A03,083745,Cinel; Cameron Alexander,8,0,30,22
1657271507915,MATH 18,B01,083748,Rideout; David Porter,4,0,37,33
1657271507915,MATH 18,B02,083749,Rideout; David Porter,4,0,36,32
1657271507915,MATH 18,B03,083750,Rideout; David Porter,2,0,37,35
1657271507915,MATH 18,B04,083751,Rideout; David Porter,6,0,36,30
1657271507915,MATH 18,B05,093473,Rideout; David Porter,5,0,36,31
1657271507915,MATH 18,B06,093474,Rideout; David Porter,5,0,36,31
1657271513947,MATH 20A,A01,083754,Zheng; Zequn,14,0,40,26
1657271519975,MATH 20B,A01,083756,Briones; Jor-el Thomas Caparas,3,0,36,33
1657271519975,MATH 20B,A02,083757,Briones; Jor-el Thomas Caparas,1,0,36,35
1657271519975,MATH 20B,A03,093475,Briones; Jor-el Thomas Caparas,2,0,36,34
1657271526000,MATH 20C,A01,083760,Briones; Jor-el Thomas Caparas,1,0,35,34
1657271526000,MATH 20C,A02,083761,Briones; Jor-el Thomas Caparas,8,0,35,27
1657271526000,MATH 20C,A03,093476,Briones; Jor-el Thomas Caparas,0,1,36,36
1657271526000,MATH 20C,B01,083762,Bach; Quang Tran,1,0,30,29
1657271532028,MATH 20D,A01,083765,Tran; Brian Kha,5,0,30,25
1657271532028,MATH 20D,A02,083766,Tran; Brian Kha,5,0,30,25
1657271532028,MATH 20D,A03,083767,Tran; Brian Kha,4,0,30,26
1657271538059,MATH 20E,A01,083771,Ganguly; Soumya,7,0,32,25
1657271538059,MATH 20E,A02,083772,Ganguly; Soumya,7,0,32,25
1657271538059,MATH 20E,B01,083773,Ciotti; Benjamin,19,0,35,16
1657271538059,MATH 20E,B02,083774,Ciotti; Benjamin,17,0,35,18
1657271544086,MATH 103A,A01,083777,Greenfeld; Be'Eri,3,0,36,33
1657271544086,MATH 103A,A02,083778,Greenfeld; Be'Eri,5,0,36,31
1657271544086,MATH 103A,A03,093561,Greenfeld; Be'Eri,4,0,36,32
1657271544086,MATH 103A,B01,083779,Greenfeld; Be'Eri,6,0,36,30
1657271544086,MATH 103A,B02,083780,Greenfeld; Be'Eri,3,0,36,33
1657271544086,MATH 103A,B03,093562,Greenfeld; Be'Eri,3,0,36,33
1657271550113,MATH 105,A01,085443,Carter; Anne Toulson,15,0,35,20
1657271550113,MATH 105,A02,093477,Carter; Anne Toulson,20,0,35,15
1657271556149,MATH 109,A01,083213,Ganzberger; Geoffrey Michael,2,0,34,32
1657271556149,MATH 109,A02,083214,Ganzberger; Geoffrey Michael,4,0,34,30
1657271556149,MATH 109,A03,093478,Ganzberger; Geoffrey Michael,2,0,34,32
1657271556149,MATH 109,B01,083215,Ganzberger; Geoffrey Michael,1,0,32,31
1657271556149,MATH 109,B02,083216,Ganzberger; Geoffrey Michael,1,0,32,31
1657271556149,MATH 109,B03,093479,Ganzberger; Geoffrey Michael,8,0,32,24
1657271562177,MATH 142A,A01,083219,Chow; Bennett,7,0,32,25
1657271562177,MATH 142A,A02,083220,Chow; Bennett,10,0,32,22
1657271562177,MATH 142A,A03,093480,Chow; Bennett,7,0,32,25
1657271562177,MATH 142A,B03,093481,Chow; Bennett,8,0,32,24
1657271562177,MATH 142A,B04,093558,Chow; Bennett,12,0,32,20
1657271562177,MATH 142A,B05,093559,Chow; Bennett,6,0,32,26
1657271568203,MATH 193A,A01,083224,Rotar; Vladimir,7,0,34,27
1657271568203,MATH 193A,A02,083225,Rotar; Vladimir,6,0,34,28
1657271568203,MATH 193A,A03,083781,Rotar; Vladimir,2,0,34,32
1657271568203,MATH 193A,A04,083782,Rotar; Vladimir,8,0,34,26
1657271568203,MATH 193A,A05,093482,Rotar; Vladimir,6,0,34,28
1657271574230,MATH 197,001,091859,McAuley; Julian John,9999,0,9999,0
1657271574230,MATH 197,002,095566,Kedlaya; Kiran S.,9997,0,9999,2
1657271574230,MATH 197,003,095567,Xiao; Ming,9999,0,9999,0
1657271574230,MATH 197,004,095571,Perols; Johan Lars,9998,0,9999,1
1657271581319,COGS 9,A01,083615,Shannon; Kyle Michael,8,0,75,67
1657271587344,COGS 11,A01,083617,Boyle; Mary E. T.,22,0,48,26
1657271593368,COGS 13,A01,083071,Bastos; Amalia Pinkusfeld,9,0,71,62
1657271599395,COGS 14A,A01,092681,Semenuks; Arturs,2,1,100,98
1657271605421,COGS 14B,A01,083073,Cheng; Tzu-Han,6,0,63,57
1657271611445,COGS 17,A01,092677,Semenuks; Arturs,5,0,81,76
1657271617470,COGS 100,A01,083619,Allen; Michael Gordon,16,0,70,54
1657271623494,COGS 101A,A01,083621,Davis; Joshua Daniel,9,0,68,59
1657271629517,COGS 101B,A01,091572,Allen; Michael Gordon,11,0,65,54
1657271635542,COGS 101C,A01,083625,Delgado; Tania,17,0,35,18
1657271641572,COGS 107A,A01,083627,Boyle; Mary E. T.,13,0,60,47
1657271647611,COGS 118A,A01,083075,Gupta; Anjum,18,0,76,58
1657271653638,CSE 3,A50,083646,Miranda; Gregory Joseph,24,0,50,26
1657271659675,CSE 8A,A50,083650,Miranda; Gregory Joseph,17,1,56,39
1657271665713,CSE 11,A01,083080,Cao; Yingjun,5,15,40,35
1657271671738,CSE 12,A01,083652,Krause-Levy; Sophia Louisa,26,1,120,94
1657271677762,CSE 15L,A01,083654,Morris; Justin Loren,9,0,50,41
1657271677762,CSE 15L,A02,083655,Morris; Justin Loren,9,0,50,41
1657271683792,CSE 20,A01,083657,Tran; Khoa Dang,38,0,80,42
1657271689825,CSE 21,A01,095574,Bach; Quang Tran,22,0,48,26
1657271695855,CSE 30,A01,083084,Eldon; John,4,0,80,76
1657271695855,CSE 30,B01,095061,Bhaskar; Nishant,8,0,50,42
1657271701885,CSE 100,A01,083659,Cao; Yingjun,4,4,70,66
1657271707931,CSE 134B,A01,083661,Powell; Thomas Allan,21,0,100,79
1657271713958,CSE 140,A01,083663,Gungor; Onat,13,0,85,72
1657271719996,CSE 140L,A01,083088,Eldon; John,19,0,100,81
1657271726022,CSE 175,A01,083665,Kumar; Rakesh,3,0,25,22
1657271732049,CSE 190,A00,092507,Dubnov; Shlomo,7,0,20,13
1657271738074,ECE 45,A01,083139,Congero; Spencer William,5,0,75,70
1657271744101,ECE 65,A50,083695,Saad; Andrew S,12,0,30,18
1657271744101,ECE 65,A51,095125,Saad; Andrew S,25,0,26,1
1657271750130,ECE 109,A01,091882,Touri; Behrouz,19,0,70,51
1657271756161,ECE 180,A00,083140,Abi Samra; Nicholas Camill,1,0,30,29
1657271756161,ECE 180,B00,083141,Abi Samra; Nicholas Camill,0,0,30,30
1657271762189,MATH 10A,A01,083735,Patchell; Gregory David,2,0,30,28
1657271762189,MATH 10A,A02,083736,Patchell; Gregory David,20,0,30,10
1657271762189,MATH 10A,A03,083737,Patchell; Gregory David,16,0,30,14
1657271768219,MATH 10B,A01,083207,Lim; Seonhee,7,0,34,27
1657271768219,MATH 10B,A02,083208,Lim; Seonhee,9,0,35,26
1657271768219,MATH 10B,A03,093472,Lim; Seonhee,5,0,34,29
1657271768219,MATH 10B,B01,083739,Sinha; Shubham,11,0,30,19
1657271774249,MATH 18,A01,083743,Cinel; Cameron Alexander,6,0,30,24
1657271774249,MATH 18,A02,083744,Cinel; Cameron Alexander,17,0,30,13
1657271774249,MATH 18,A03,083745,Cinel; Cameron Alexander,8,0,30,22
1657271774249,MATH 18,B01,083748,Rideout; David Porter,4,0,37,33
1657271774249,MATH 18,B02,083749,Rideout; David Porter,4,0,36,32
1657271774249,MATH 18,B03,083750,Rideout; David Porter,2,0,37,35
1657271774249,MATH 18,B04,083751,Rideout; David Porter,6,0,36,30
1657271774249,MATH 18,B05,093473,Rideout; David Porter,5,0,36,31
1657271774249,MATH 18,B06,093474,Rideout; David Porter,5,0,36,31
1657271780273,MATH 20A,A01,083754,Zheng; Zequn,14,0,40,26
1657271786300,MATH 20B,A01,083756,Briones; Jor-el Thomas Caparas,3,0,36,33
1657271786300,MATH 20B,A02,083757,Briones; Jor-el Thomas Caparas,1,0,36,35
1657271786300,MATH 20B,A03,093475,Briones; Jor-el Thomas Caparas,2,0,36,34
1657271792337,MATH 20C,A01,083760,Briones; Jor-el Thomas Caparas,1,0,35,34
1657271792337,MATH 20C,A02,083761,Briones; Jor-el Thomas Caparas,8,0,35,27
1657271792337,MATH 20C,A03,093476,Briones; Jor-el Thomas Caparas,0,1,36,36
1657271792337,MATH 20C,B01,083762,Bach; Quang Tran,1,0,30,29
1657271798368,MATH 20D,A01,083765,Tran; Brian Kha,5,0,30,25
1657271798368,MATH 20D,A02,083766,Tran; Brian Kha,5,0,30,25
1657271798368,MATH 20D,A03,083767,Tran; Brian Kha,4,0,30,26
1657271804402,MATH 20E,A01,083771,Ganguly; Soumya,7,0,32,25
1657271804402,MATH 20E,A02,083772,Ganguly; Soumya,7,0,32,25
1657271804402,MATH 20E,B01,083773,Ciotti; Benjamin,19,0,35,16
1657271804402,MATH 20E,B02,083774,Ciotti; Benjamin,17,0,35,18
1657271810429,MATH 103A,A01,083777,Greenfeld; Be'Eri,3,0,36,33
1657271810429,MATH 103A,A02,083778,Greenfeld; Be'Eri,5,0,36,31
1657271810429,MATH 103A,A03,093561,Greenfeld; Be'Eri,4,0,36,32
1657271810429,MATH 103A,B01,083779,Greenfeld; Be'Eri,6,0,36,30
1657271810429,MATH 103A,B02,083780,Greenfeld; Be'Eri,3,0,36,33
1657271810429,MATH 103A,B03,093562,Greenfeld; Be'Eri,3,0,36,33
1657271816463,MATH 105,A01,085443,Carter; Anne Toulson,15,0,35,20
1657271816463,MATH 105,A02,093477,Carter; Anne Toulson,20,0,35,15
1657271822488,MATH 109,A01,083213,Ganzberger; Geoffrey Michael,2,0,34,32
1657271822488,MATH 109,A02,083214,Ganzberger; Geoffrey Michael,4,0,34,30
1657271822488,MATH 109,A03,093478,Ganzberger; Geoffrey Michael,2,0,34,32
1657271822488,MATH 109,B01,083215,Ganzberger; Geoffrey Michael,1,0,32,31
1657271822488,MATH 109,B02,083216,Ganzberger; Geoffrey Michael,1,0,32,31
1657271822488,MATH 109,B03,093479,Ganzberger; Geoffrey Michael,8,0,32,24
1657271828525,MATH 142A,A01,083219,Chow; Bennett,7,0,32,25
1657271828525,MATH 142A,A02,083220,Chow; Bennett,10,0,32,22
1657271828525,MATH 142A,A03,093480,Chow; Bennett,7,0,32,25
1657271828525,MATH 142A,B03,093481,Chow; Bennett,8,0,32,24
1657271828525,MATH 142A,B04,093558,Chow; Bennett,12,0,32,20
1657271828525,MATH 142A,B05,093559,Chow; Bennett,6,0,32,26
1657271834552,MATH 193A,A01,083224,Rotar; Vladimir,7,0,34,27
1657271834552,MATH 193A,A02,083225,Rotar; Vladimir,6,0,34,28
1657271834552,MATH 193A,A03,083781,Rotar; Vladimir,2,0,34,32
1657271834552,MATH 193A,A04,083782,Rotar; Vladimir,8,0,34,26
1657271834552,MATH 193A,A05,093482,Rotar; Vladimir,6,0,34,28
1657271840577,MATH 197,001,091859,McAuley; Julian John,9999,0,9999,0
1657271840577,MATH 197,002,095566,Kedlaya; Kiran S.,9997,0,9999,2
1657271840577,MATH 197,003,095567,Xiao; Ming,9999,0,9999,0
1657271840577,MATH 197,004,095571,Perols; Johan Lars,9998,0,9999,1
1657271847684,COGS 9,A01,083615,Shannon; Kyle Michael,8,0,75,67
1657271853709,COGS 11,A01,083617,Boyle; Mary E. T.,22,0,48,26
1657271859736,COGS 13,A01,083071,Bastos; Amalia Pinkusfeld,9,0,71,62
1657271865761,COGS 14A,A01,092681,Semenuks; Arturs,2,1,100,98
1657271871788,COGS 14B,A01,083073,Cheng; Tzu-Han,6,0,63,57
1657271877812,COGS 17,A01,092677,Semenuks; Arturs,5,0,81,76
1657271883843,COGS 100,A01,083619,Allen; Michael Gordon,16,0,70,54
1657271889890,COGS 101A,A01,083621,Davis; Joshua Daniel,9,0,68,59
1657271896001,COGS 101B,A01,091572,Allen; Michael Gordon,11,0,65,54
1657271902029,COGS 101C,A01,083625,Delgado; Tania,17,0,35,18
1657271908061,COGS 107A,A01,083627,Boyle; Mary E. T.,13,0,60,47
1657271914090,COGS 118A,A01,083075,Gupta; Anjum,18,0,76,58
1657271920117,CSE 3,A50,083646,Miranda; Gregory Joseph,24,0,50,26
1657271926141,CSE 8A,A50,083650,Miranda; Gregory Joseph,17,1,56,39
1657271932165,CSE 11,A01,083080,Cao; Yingjun,5,15,40,35
1657271938189,CSE 12,A01,083652,Krause-Levy; Sophia Louisa,26,1,120,94
1657271944212,CSE 15L,A01,083654,Morris; Justin Loren,9,0,50,41
1657271944212,CSE 15L,A02,083655,Morris; Justin Loren,9,0,50,41
1657271950238,CSE 20,A01,083657,Tran; Khoa Dang,38,0,80,42
1657271956264,CSE 21,A01,095574,Bach; Quang Tran,22,0,48,26
1657271962291,CSE 30,A01,083084,Eldon; John,4,0,80,76
1657271962291,CSE 30,B01,095061,Bhaskar; Nishant,8,0,50,42
1657271968316,CSE 100,A01,083659,Cao; Yingjun,4,4,70,66
1657271974346,CSE 134B,A01,083661,Powell; Thomas Allan,21,0,100,79
1657271980372,CSE 140,A01,083663,Gungor; Onat,13,0,85,72
1657271986396,CSE 140L,A01,083088,Eldon; John,19,0,100,81
1657271992420,CSE 175,A01,083665,Kumar; Rakesh,3,0,25,22
1657271998455,CSE 190,A00,092507,Dubnov; Shlomo,7,0,20,13
1657272004482,ECE 45,A01,083139,Congero; Spencer William,5,0,75,70
1657272010508,ECE 65,A50,083695,Saad; Andrew S,12,0,30,18
1657272010508,ECE 65,A51,095125,Saad; Andrew S,25,0,26,1
1657272016533,ECE 109,A01,091882,Touri; Behrouz,19,0,70,51
1657272022564,ECE 180,A00,083140,Abi Samra; Nicholas Camill,1,0,30,29
1657272022564,ECE 180,B00,083141,Abi Samra; Nicholas Camill,0,0,30,30
1657272028599,MATH 10A,A01,083735,Patchell; Gregory David,2,0,30,28
1657272028599,MATH 10A,A02,083736,Patchell; Gregory David,20,0,30,10
1657272028599,MATH 10A,A03,083737,Patchell; Gregory David,16,0,30,14
1657272034629,MATH 10B,A01,083207,Lim; Seonhee,7,0,34,27
1657272034629,MATH 10B,A02,083208,Lim; Seonhee,9,0,35,26
1657272034629,MATH 10B,A03,093472,Lim; Seonhee,5,0,34,29
1657272034629,MATH 10B,B01,083739,Sinha; Shubham,11,0,30,19
1657272040677,MATH 18,A01,083743,Cinel; Cameron Alexander,6,0,30,24
1657272040677,MATH 18,A02,083744,Cinel; Cameron Alexander,17,0,30,13
1657272040677,MATH 18,A03,083745,Cinel; Cameron Alexander,8,0,30,22
1657272040677,MATH 18,B01,083748,Rideout; David Porter,4,0,37,33
1657272040677,MATH 18,B02,083749,Rideout; David Porter,4,0,36,32
1657272040677,MATH 18,B03,083750,Rideout; David Porter,2,0,37,35
1657272040677,MATH 18,B04,083751,Rideout; David Porter,6,0,36,30
1657272040677,MATH 18,B05,093473,Rideout; David Porter,5,0,36,31
1657272040677,MATH 18,B06,093474,Rideout; David Porter,5,0,36,31
1657272046705,MATH 20A,A01,083754,Zheng; Zequn,14,0,40,26
1657272052741,MATH 20B,A01,083756,Briones; Jor-el Thomas Caparas,3,0,36,33
1657272052741,MATH 20B,A02,083757,Briones; Jor-el Thomas Caparas,1,0,36,35
1657272052741,MATH 20B,A03,093475,Briones; Jor-el Thomas Caparas,2,0,36,34
1657272058767,MATH 20C,A01,083760,Briones; Jor-el Thomas Caparas,1,0,35,34
1657272058767,MATH 20C,A02,083761,Briones; Jor-el Thomas Caparas,8,0,35,27
1657272058767,MATH 20C,A03,093476,Briones; Jor-el Thomas Caparas,0,1,36,36
1657272058767,MATH 20C,B01,083762,Bach; Quang Tran,1,0,30,29
1657272064794,MATH 20D,A01,083765,Tran; Brian Kha,5,0,30,25
1657272064794,MATH 20D,A02,083766,Tran; Brian Kha,5,0,30,25
1657272064794,MATH 20D,A03,083767,Tran; Brian Kha,4,0,30,26
1657272070820,MATH 20E,A01,083771,Ganguly; Soumya,7,0,32,25
1657272070820,MATH 20E,A02,083772,Ganguly; Soumya,7,0,32,25
1657272070820,MATH 20E,B01,083773,Ciotti; Benjamin,19,0,35,16
1657272070820,MATH 20E,B02,083774,Ciotti; Benjamin,17,0,35,18
1657272076878,MATH 103A,A01,083777,Greenfeld; Be'Eri,3,0,36,33
1657272076878,MATH 103A,A02,083778,Greenfeld; Be'Eri,5,0,36,31
1657272076878,MATH 103A,A03,093561,Greenfeld; Be'Eri,4,0,36,32
1657272076878,MATH 103A,B01,083779,Greenfeld; Be'Eri,6,0,36,30
1657272076878,MATH 103A,B02,083780,Greenfeld; Be'Eri,3,0,36,33
1657272076878,MATH 103A,B03,093562,Greenfeld; Be'Eri,3,0,36,33
1657272083233,MATH 105,A01,085443,Carter; Anne Toulson,15,0,35,20
1657272083233,MATH 105,A02,093477,Carter; Anne Toulson,20,0,35,15
1657272090344,MATH 109,A01,083213,Ganzberger; Geoffrey Michael,2,0,34,32
1657272090344,MATH 109,A02,083214,Ganzberger; Geoffrey Michael,4,0,34,30
1657272090344,MATH 109,A03,093478,Ganzberger; Geoffrey Michael,2,0,34,32
1657272090344,MATH 109,B01,083215,Ganzberger; Geoffrey Michael,1,0,32,31
1657272090344,MATH 109,B02,083216,Ganzberger; Geoffrey Michael,1,0,32,31
1657272090344,MATH 109,B03,093479,Ganzberger; Geoffrey Michael,8,0,32,24
1657272096377,MATH 142A,A01,083219,Chow; Bennett,7,0,32,25
1657272096377,MATH 142A,A02,083220,Chow; Bennett,10,0,32,22
1657272096377,MATH 142A,A03,093480,Chow; Bennett,7,0,32,25
1657272096377,MATH 142A,B03,093481,Chow; Bennett,8,0,32,24
1657272096377,MATH 142A,B04,093558,Chow; Bennett,12,0,32,20
1657272096377,MATH 142A,B05,093559,Chow; Bennett,6,0,32,26
1657272102420,MATH 193A,A01,083224,Rotar; Vladimir,7,0,34,27
1657272102420,MATH 193A,A02,083225,Rotar; Vladimir,6,0,34,28
1657272102420,MATH 193A,A03,083781,Rotar; Vladimir,2,0,34,32
1657272102420,MATH 193A,A04,083782,Rotar; Vladimir,8,0,34,26
1657272102420,MATH 193A,A05,093482,Rotar; Vladimir,6,0,34,28
1657272108455,MATH 197,001,091859,McAuley; Julian John,9999,0,9999,0
1657272108455,MATH 197,002,095566,Kedlaya; Kiran S.,9997,0,9999,2
1657272108455,MATH 197,003,095567,Xiao; Ming,9999,0,9999,0
1657272108455,MATH 197,004,095571,Perols; Johan Lars,9998,0,9999,1
1657272115537,COGS 9,A01,083615,Shannon; Kyle Michael,8,0,75,67
1657272121562,COGS 11,A01,083617,Boyle; Mary E. T.,22,0,48,26
1657272127610,COGS 13,A01,083071,Bastos; Amalia Pinkusfeld,9,0,71,62
1657272133638,COGS 14A,A01,092681,Semenuks; Arturs,2,1,100,98
1657272139672,COGS 14B,A01,083073,Cheng; Tzu-Han,6,0,63,57
1657272145704,COGS 17,A01,092677,Semenuks; Arturs,5,0,81,76
1657272151728,COGS 100,A01,083619,Allen; Michael Gordon,16,0,70,54
1657272157757,COGS 101A,A01,083621,Davis; Joshua Daniel,9,0,68,59
1657272163779,COGS 101B,A01,091572,Allen; Michael Gordon,11,0,65,54
1657272169803,COGS 101C,A01,083625,Delgado; Tania,17,0,35,18
1657272175828,COGS 107A,A01,083627,Boyle; Mary E. T.,13,0,60,47
1657272181853,COGS 118A,A01,083075,Gupta; Anjum,18,0,76,58
1657272187879,CSE 3,A50,083646,Miranda; Gregory Joseph,24,0,50,26
1657272193909,CSE 8A,A50,083650,Miranda; Gregory Joseph,17,1,56,39
1657272199938,CSE 11,A01,083080,Cao; Yingjun,5,15,40,35
1657272205969,CSE 12,A01,083652,Krause-Levy; Sophia Louisa,26,1,120,94
1657272211999,CSE 15L,A01,083654,Morris; Justin Loren,9,0,50,41
1657272211999,CSE 15L,A02,083655,Morris; Justin Loren,9,0,50,41
1657272218023,CSE 20,A01,083657,Tran; Khoa Dang,38,0,80,42
1657272224053,CSE 21,A01,095574,Bach; Quang Tran,22,0,48,26
1657272230084,CSE 30,A01,083084,Eldon; John,4,0,80,76
1657272230084,CSE 30,B01,095061,Bhaskar; Nishant,8,0,50,42
1657272236109,CSE 100,A01,083659,Cao; Yingjun,4,4,70,66
1657272242135,CSE 134B,A01,083661,Powell; Thomas Allan,21,0,100,79
1657272248163,CSE 140,A01,083663,Gungor; Onat,13,0,85,72
1657272254192,CSE 140L,A01,083088,Eldon; John,19,0,100,81
1657272260219,CSE 175,A01,083665,Kumar; Rakesh,3,0,25,22
1657272266251,CSE 190,A00,092507,Dubnov; Shlomo,7,0,20,13
1657272272282,ECE 45,A01,083139,Congero; Spencer William,5,0,75,70
1657272278323,ECE 65,A50,083695,Saad; Andrew S,12,0,30,18
1657272278323,ECE 65,A51,095125,Saad; Andrew S,25,0,26,1
1657272284372,ECE 109,A01,091882,Touri; Behrouz,19,0,70,51
1657272290400,ECE 180,A00,083140,Abi Samra; Nicholas Camill,1,0,30,29
1657272290400,ECE 180,B00,083141,Abi Samra; Nicholas Camill,0,0,30,30
1657272296428,MATH 10A,A01,083735,Patchell; Gregory David,2,0,30,28
1657272296428,MATH 10A,A02,083736,Patchell; Gregory David,20,0,30,10
1657272296428,MATH 10A,A03,083737,Patchell; Gregory David,16,0,30,14
1657272302457,MATH 10B,A01,083207,Lim; Seonhee,7,0,34,27
1657272302457,MATH 10B,A02,083208,Lim; Seonhee,9,0,35,26
1657272302457,MATH 10B,A03,093472,Lim; Seonhee,5,0,34,29
1657272302457,MATH 10B,B01,083739,Sinha; Shubham,11,0,30,19
1657272308488,MATH 18,A01,083743,Cinel; Cameron Alexander,6,0,30,24
1657272308488,MATH 18,A02,083744,Cinel; Cameron Alexander,17,0,30,13
1657272308488,MATH 18,A03,083745,Cinel; Cameron Alexander,8,0,30,22
1657272308488,MATH 18,B01,083748,Rideout; David Porter,4,0,37,33
1657272308488,MATH 18,B02,083749,Rideout; David Porter,4,0,36,32
1657272308488,MATH 18,B03,083750,Rideout; David Porter,2,0,37,35
1657272308488,MATH 18,B04,083751,Rideout; David Porter,6,0,36,30
1657272308488,MATH 18,B05,093473,Rideout; David Porter,5,0,36,31
1657272308488,MATH 18,B06,093474,Rideout; David Porter,5,0,36,31
1657272314515,MATH 20A,A01,083754,Zheng; Zequn,14,0,40,26
1657272320542,MATH 20B,A01,083756,Briones; Jor-el Thomas Caparas,3,0,36,33
1657272320542,MATH 20B,A02,083757,Briones; Jor-el Thomas Caparas,1,0,36,35
1657272320542,MATH 20B,A03,093475,Briones; Jor-el Thomas Caparas,2,0,36,34
1657272326585,MATH 20C,A01,083760,Briones; Jor-el Thomas Caparas,1,0,35,34
1657272326585,MATH 20C,A02,083761,Briones; Jor-el Thomas Caparas,8,0,35,27
1657272326585,MATH 20C,A03,093476,Briones; Jor-el Thomas Caparas,0,1,36,36
1657272326585,MATH 20C,B01,083762,Bach; Quang Tran,1,0,30,29
1657272332612,MATH 20D,A01,083765,Tran; Brian Kha,5,0,30,25
1657272332612,MATH 20D,A02,083766,Tran; Brian Kha,5,0,30,25
1657272332612,MATH 20D,A03,083767,Tran; Brian Kha,4,0,30,26
1657272338641,MATH 20E,A01,083771,Ganguly; Soumya,7,0,32,25
1657272338641,MATH 20E,A02,083772,Ganguly; Soumya,7,0,32,25
1657272338641,MATH 20E,B01,083773,Ciotti; Benjamin,19,0,35,16
1657272338641,MATH 20E,B02,083774,Ciotti; Benjamin,17,0,35,18
1657272344668,MATH 103A,A01,083777,Greenfeld; Be'Eri,3,0,36,33
1657272344668,MATH 103A,A02,083778,Greenfeld; Be'Eri,5,0,36,31
1657272344668,MATH 103A,A03,093561,Greenfeld; Be'Eri,4,0,36,32
1657272344668,MATH 103A,B01,083779,Greenfeld; Be'Eri,6,0,36,30
1657272344668,MATH 103A,B02,083780,Greenfeld; Be'Eri,3,0,36,33
1657272344668,MATH 103A,B03,093562,Greenfeld; Be'Eri,3,0,36,33
1657272350695,MATH 105,A01,085443,Carter; Anne Toulson,15,0,35,20
1657272350695,MATH 105,A02,093477,Carter; Anne Toulson,20,0,35,15
1657272356726,MATH 109,A01,083213,Ganzberger; Geoffrey Michael,2,0,34,32
1657272356726,MATH 109,A02,083214,Ganzberger; Geoffrey Michael,4,0,34,30
1657272356726,MATH 109,A03,093478,Ganzberger; Geoffrey Michael,2,0,34,32
1657272356726,MATH 109,B01,083215,Ganzberger; Geoffrey Michael,1,0,32,31
1657272356726,MATH 109,B02,083216,Ganzberger; Geoffrey Michael,1,0,32,31
1657272356726,MATH 109,B03,093479,Ganzberger; Geoffrey Michael,8,0,32,24
1657272362753,MATH 142A,A01,083219,Chow; Bennett,7,0,32,25
1657272362753,MATH 142A,A02,083220,Chow; Bennett,10,0,32,22
1657272362753,MATH 142A,A03,093480,Chow; Bennett,7,0,32,25
1657272362753,MATH 142A,B03,093481,Chow; Bennett,8,0,32,24
1657272362753,MATH 142A,B04,093558,Chow; Bennett,12,0,32,20
1657272362753,MATH 142A,B05,093559,Chow; Bennett,6,0,32,26
1657272368786,MATH 193A,A01,083224,Rotar; Vladimir,7,0,34,27
1657272368786,MATH 193A,A02,083225,Rotar; Vladimir,6,0,34,28
1657272368786,MATH 193A,A03,083781,Rotar; Vladimir,2,0,34,32
1657272368786,MATH 193A,A04,083782,Rotar; Vladimir,8,0,34,26
1657272368786,MATH 193A,A05,093482,Rotar; Vladimir,6,0,34,28
1657272374814,MATH 197,001,091859,McAuley; Julian John,9999,0,9999,0
1657272374814,MATH 197,002,095566,Kedlaya; Kiran S.,9997,0,9999,2
1657272374814,MATH 197,003,095567,Xiao; Ming,9999,0,9999,0
1657272374814,MATH 197,004,095571,Perols; Johan Lars,9998,0,9999,1
1657272381895,COGS 9,A01,083615,Shannon; Kyle Michael,8,0,75,67
1657272387950,COGS 11,A01,083617,Boyle; Mary E. T.,22,0,48,26
1657272393978,COGS 13,A01,083071,Bastos; Amalia Pinkusfeld,9,0,71,62
1657272400003,COGS 14A,A01,092681,Semenuks; Arturs,2,1,100,98
1657272406039,COGS 14B,A01,083073,Cheng; Tzu-Han,6,0,63,57
1657272412062,COGS 17,A01,092677,Semenuks; Arturs,5,0,81,76
1657272418087,COGS 100,A01,083619,Allen; Michael Gordon,16,0,70,54
1657272424114,COGS 101A,A01,083621,Davis; Joshua Daniel,9,0,68,59
1657272430141,COGS 101B,A01,091572,Allen; Michael Gordon,11,0,65,54
1657272436170,COGS 101C,A01,083625,Delgado; Tania,17,0,35,18
1657272442201,COGS 107A,A01,083627,Boyle; Mary E. T.,13,0,60,47
1657272448228,COGS 118A,A01,083075,Gupta; Anjum,18,0,76,58
1657272454255,CSE 3,A50,083646,Miranda; Gregory Joseph,24,0,50,26
1657272460281,CSE 8A,A50,083650,Miranda; Gregory Joseph,17,1,56,39
1657272466310,CSE 11,A01,083080,Cao; Yingjun,5,15,40,35
1657272472335,CSE 12,A01,083652,Krause-Levy; Sophia Louisa,26,1,120,94
1657272478365,CSE 15L,A01,083654,Morris; Justin Loren,9,0,50,41
1657272478365,CSE 15L,A02,083655,Morris; Justin Loren,9,0,50,41
1657272484389,CSE 20,A01,083657,Tran; Khoa Dang,38,0,80,42
1657272490420,CSE 21,A01,095574,Bach; Quang Tran,22,0,48,26
1657272496540,CSE 30,A01,083084,Eldon; John,4,0,80,76
1657272496540,CSE 30,B01,095061,Bhaskar; Nishant,8,0,50,42
1657272502566,CSE 100,A01,083659,Cao; Yingjun,4,4,70,66
1657272508597,CSE 134B,A01,083661,Powell; Thomas Allan,21,0,100,79
1657272514622,CSE 140,A01,083663,Gungor; Onat,13,0,85,72
1657272520643,CSE 140L,A01,083088,Eldon; John,19,0,100,81
1657272526667,CSE 175,A01,083665,Kumar; Rakesh,3,0,25,22
1657272532691,CSE 190,A00,092507,Dubnov; Shlomo,7,0,20,13
1657272538716,ECE 45,A01,083139,Congero; Spencer William,5,0,75,70
1657272544742,ECE 65,A50,083695,Saad; Andrew S,12,0,30,18
1657272544742,ECE 65,A51,095125,Saad; Andrew S,25,0,26,1
1657272550773,ECE 109,A01,091882,Touri; Behrouz,19,0,70,51
1657272556801,ECE 180,A00,083140,Abi Samra; Nicholas Camill,1,0,30,29
1657272556801,ECE 180,B00,083141,Abi Samra; Nicholas Camill,0,0,30,30
1657272562828,MATH 10A,A01,083735,Patchell; Gregory David,2,0,30,28
1657272562828,MATH 10A,A02,083736,Patchell; Gregory David,20,0,30,10
1657272562828,MATH 10A,A03,083737,Patchell; Gregory David,16,0,30,14
1657272568858,MATH 10B,A01,083207,Lim; Seonhee,7,0,34,27
1657272568858,MATH 10B,A02,083208,Lim; Seonhee,9,0,35,26
1657272568858,MATH 10B,A03,093472,Lim; Seonhee,5,0,34,29
1657272568858,MATH 10B,B01,083739,Sinha; Shubham,11,0,30,19
1657272574888,MATH 18,A01,083743,Cinel; Cameron Alexander,6,0,30,24
1657272574888,MATH 18,A02,083744,Cinel; Cameron Alexander,17,0,30,13
1657272574888,MATH 18,A03,083745,Cinel; Cameron Alexander,8,0,30,22
1657272574888,MATH 18,B01,083748,Rideout; David Porter,4,0,37,33
1657272574888,MATH 18,B02,083749,Rideout; David Porter,4,0,36,32
1657272574888,MATH 18,B03,083750,Rideout; David Porter,2,0,37,35
1657272574888,MATH 18,B04,083751,Rideout; David Porter,6,0,36,30
1657272574888,MATH 18,B05,093473,Rideout; David Porter,5,0,36,31
1657272574888,MATH 18,B06,093474,Rideout; David Porter,5,0,36,31
1657272580928,MATH 20A,A01,083754,Zheng; Zequn,14,0,40,26
1657272586961,MATH 20B,A01,083756,Briones; Jor-el Thomas Caparas,3,0,36,33
1657272586961,MATH 20B,A02,083757,Briones; Jor-el Thomas Caparas,1,0,36,35
1657272586961,MATH 20B,A03,093475,Briones; Jor-el Thomas Caparas,2,0,36,34
1657272592997,MATH 20C,A01,083760,Briones; Jor-el Thomas Caparas,1,0,35,34
1657272592997,MATH 20C,A02,083761,Briones; Jor-el Thomas Caparas,8,0,35,27
1657272592997,MATH 20C,A03,093476,Briones; Jor-el Thomas Caparas,0,1,36,36
1657272592997,MATH 20C,B01,083762,Bach; Quang Tran,1,0,30,29
1657272599023,MATH 20D,A01,083765,Tran; Brian Kha,5,0,30,25
1657272599023,MATH 20D,A02,083766,Tran; Brian Kha,5,0,30,25
1657272599023,MATH 20D,A03,083767,Tran; Brian Kha,4,0,30,26
1657272605055,MATH 20E,A01,083771,Ganguly; Soumya,7,0,32,25
1657272605055,MATH 20E,A02,083772,Ganguly; Soumya,7,0,32,25
1657272605055,MATH 20E,B01,083773,Ciotti; Benjamin,19,0,35,16
1657272605055,MATH 20E,B02,083774,Ciotti; Benjamin,17,0,35,18
1657272611085,MATH 103A,A01,083777,Greenfeld; Be'Eri,3,0,36,33
1657272611085,MATH 103A,A02,083778,Greenfeld; Be'Eri,5,0,36,31
1657272611085,MATH 103A,A03,093561,Greenfeld; Be'Eri,4,0,36,32
1657272611085,MATH 103A,B01,083779,Greenfeld; Be'Eri,6,0,36,30
1657272611085,MATH 103A,B02,083780,Greenfeld; Be'Eri,3,0,36,33
1657272611085,MATH 103A,B03,093562,Greenfeld; Be'Eri,3,0,36,33
1657272617111,MATH 105,A01,085443,Carter; Anne Toulson,15,0,35,20
1657272617111,MATH 105,A02,093477,Carter; Anne Toulson,20,0,35,15
1657272623146,MATH 109,A01,083213,Ganzberger; Geoffrey Michael,2,0,34,32
1657272623146,MATH 109,A02,083214,Ganzberger; Geoffrey Michael,4,0,34,30
1657272623146,MATH 109,A03,093478,Ganzberger; Geoffrey Michael,2,0,34,32
1657272623146,MATH 109,B01,083215,Ganzberger; Geoffrey Michael,1,0,32,31
1657272623146,MATH 109,B02,083216,Ganzberger; Geoffrey Michael,1,0,32,31
1657272623146,MATH 109,B03,093479,Ganzberger; Geoffrey Michael,8,0,32,24
1657272629186,MATH 142A,A01,083219,Chow; Bennett,7,0,32,25
1657272629186,MATH 142A,A02,083220,Chow; Bennett,10,0,32,22
1657272629186,MATH 142A,A03,093480,Chow; Bennett,7,0,32,25
1657272629186,MATH 142A,B03,093481,Chow; Bennett,8,0,32,24
1657272629186,MATH 142A,B04,093558,Chow; Bennett,12,0,32,20
1657272629186,MATH 142A,B05,093559,Chow; Bennett,6,0,32,26
1657272635213,MATH 193A,A01,083224,Rotar; Vladimir,7,0,34,27
1657272635213,MATH 193A,A02,083225,Rotar; Vladimir,6,0,34,28
1657272635213,MATH 193A,A03,083781,Rotar; Vladimir,2,0,34,32
1657272635213,MATH 193A,A04,083782,Rotar; Vladimir,8,0,34,26
1657272635213,MATH 193A,A05,093482,Rotar; Vladimir,6,0,34,28
1657272641242,MATH 197,001,091859,McAuley; Julian John,9999,0,9999,0
1657272641242,MATH 197,002,095566,Kedlaya; Kiran S.,9997,0,9999,2
1657272641242,MATH 197,003,095567,Xiao; Ming,9999,0,9999,0
1657272641242,MATH 197,004,095571,Perols; Johan Lars,9998,0,9999,1
1657272648316,COGS 9,A01,083615,Shannon; Kyle Michael,8,0,75,67
1657272654341,COGS 11,A01,083617,Boyle; Mary E. T.,22,0,48,26
1657272660367,COGS 13,A01,083071,Bastos; Amalia Pinkusfeld,9,0,71,62
1657272666393,COGS 14A,A01,092681,Semenuks; Arturs,2,1,100,98
1657272672417,COGS 14B,A01,083073,Cheng; Tzu-Han,6,0,63,57
1657272678446,COGS 17,A01,092677,Semenuks; Arturs,5,0,81,76
1657272684478,COGS 100,A01,083619,Allen; Michael Gordon,16,0,70,54
1657272690511,COGS 101A,A01,083621,Davis; Joshua Daniel,9,0,68,59
1657272696534,COGS 101B,A01,091572,Allen; Michael Gordon,11,0,65,54
1657272702560,COGS 101C,A01,083625,Delgado; Tania,17,0,35,18
1657272708586,COGS 107A,A01,083627,Boyle; Mary E. T.,13,0,60,47
1657272714617,COGS 118A,A01,083075,Gupta; Anjum,18,0,76,58
1657272720651,CSE 3,A50,083646,Miranda; Gregory Joseph,24,0,50,26
1657272726675,CSE 8A,A50,083650,Miranda; Gregory Joseph,17,1,56,39
1657272732704,CSE 11,A01,083080,Cao; Yingjun,5,15,40,35
1657272738730,CSE 12,A01,083652,Krause-Levy; Sophia Louisa,26,1,120,94
1657272744753,CSE 15L,A01,083654,Morris; Justin Loren,9,0,50,41
1657272744753,CSE 15L,A02,083655,Morris; Justin Loren,9,0,50,41
1657272750778,CSE 20,A01,083657,Tran; Khoa Dang,38,0,80,42
1657272756805,CSE 21,A01,095574,Bach; Quang Tran,22,0,48,26
1657272762839,CSE 30,A01,083084,Eldon; John,4,0,80,76
1657272762839,CSE 30,B01,095061,Bhaskar; Nishant,8,0,50,42
1657272768868,CSE 100,A01,083659,Cao; Yingjun,4,4,70,66
1657272774899,CSE 134B,A01,083661,Powell; Thomas Allan,21,0,100,79
1657272780944,CSE 140,A01,083663,Gungor; Onat,13,0,85,72
1657272786969,CSE 140L,A01,083088,Eldon; John,19,0,100,81
1657272792997,CSE 175,A01,083665,Kumar; Rakesh,3,0,25,22
1657272799029,CSE 190,A00,092507,Dubnov; Shlomo,7,0,20,13
1657272805062,ECE 45,A01,083139,Congero; Spencer William,5,0,75,70
1657272811097,ECE 65,A50,083695,Saad; Andrew S,12,0,30,18
1657272811097,ECE 65,A51,095125,Saad; Andrew S,25,0,26,1
1657272817122,ECE 109,A01,091882,Touri; Behrouz,19,0,70,51
1657272823147,ECE 180,A00,083140,Abi Samra; Nicholas Camill,1,0,30,29
1657272823147,ECE 180,B00,083141,Abi Samra; Nicholas Camill,0,0,30,30
1657272829188,MATH 10A,A01,083735,Patchell; Gregory David,2,0,30,28
1657272829188,MATH 10A,A02,083736,Patchell; Gregory David,20,0,30,10
1657272829188,MATH 10A,A03,083737,Patchell; Gregory David,16,0,30,14
1657272835215,MATH 10B,A01,083207,Lim; Seonhee,7,0,34,27
1657272835215,MATH 10B,A02,083208,Lim; Seonhee,9,0,35,26
1657272835215,MATH 10B,A03,093472,Lim; Seonhee,5,0,34,29
1657272835215,MATH 10B,B01,083739,Sinha; Shubham,11,0,30,19
1657272841256,MATH 18,A01,083743,Cinel; Cameron Alexander,6,0,30,24
1657272841256,MATH 18,A02,083744,Cinel; Cameron Alexander,17,0,30,13
1657272841256,MATH 18,A03,083745,Cinel; Cameron Alexander,8,0,30,22
1657272841256,MATH 18,B01,083748,Rideout; David Porter,4,0,37,33
1657272841256,MATH 18,B02,083749,Rideout; David Porter,4,0,36,32
1657272841256,MATH 18,B03,083750,Rideout; David Porter,2,0,37,35
1657272841256,MATH 18,B04,083751,Rideout; David Porter,6,0,36,30
1657272841256,MATH 18,B05,093473,Rideout; David Porter,5,0,36,31
1657272841256,MATH 18,B06,093474,Rideout; David Porter,5,0,36,31
1657272847282,MATH 20A,A01,083754,Zheng; Zequn,14,0,40,26
1657272853306,MATH 20B,A01,083756,Briones; Jor-el Thomas Caparas,3,0,36,33
1657272853306,MATH 20B,A02,083757,Briones; Jor-el Thomas Caparas,1,0,36,35
1657272853306,MATH 20B,A03,093475,Briones; Jor-el Thomas Caparas,2,0,36,34
1657272859342,MATH 20C,A01,083760,Briones; Jor-el Thomas Caparas,1,0,35,34
1657272859342,MATH 20C,A02,083761,Briones; Jor-el Thomas Caparas,8,0,35,27
1657272859342,MATH 20C,A03,093476,Briones; Jor-el Thomas Caparas,0,1,36,36
1657272859342,MATH 20C,B01,083762,Bach; Quang Tran,1,0,30,29
1657272865375,MATH 20D,A01,083765,Tran; Brian Kha,5,0,30,25
1657272865375,MATH 20D,A02,083766,Tran; Brian Kha,5,0,30,25
1657272865375,MATH 20D,A03,083767,Tran; Brian Kha,4,0,30,26
1657272871403,MATH 20E,A01,083771,Ganguly; Soumya,7,0,32,25
1657272871403,MATH 20E,A02,083772,Ganguly; Soumya,7,0,32,25
1657272871403,MATH 20E,B01,083773,Ciotti; Benjamin,19,0,35,16
1657272871403,MATH 20E,B02,083774,Ciotti; Benjamin,17,0,35,18
1657272877433,MATH 103A,A01,083777,Greenfeld; Be'Eri,3,0,36,33
1657272877433,MATH 103A,A02,083778,Greenfeld; Be'Eri,5,0,36,31
1657272877433,MATH 103A,A03,093561,Greenfeld; Be'Eri,4,0,36,32
1657272877433,MATH 103A,B01,083779,Greenfeld; Be'Eri,6,0,36,30
1657272877433,MATH 103A,B02,083780,Greenfeld; Be'Eri,3,0,36,33
1657272877433,MATH 103A,B03,093562,Greenfeld; Be'Eri,3,0,36,33
1657272883457,MATH 105,A01,085443,Carter; Anne Toulson,15,0,35,20
1657272883457,MATH 105,A02,093477,Carter; Anne Toulson,20,0,35,15
1657272889482,MATH 109,A01,083213,Ganzberger; Geoffrey Michael,2,0,34,32
1657272889482,MATH 109,A02,083214,Ganzberger; Geoffrey Michael,4,0,34,30
1657272889482,MATH 109,A03,093478,Ganzberger; Geoffrey Michael,2,0,34,32
1657272889482,MATH 109,B01,083215,Ganzberger; Geoffrey Michael,1,0,32,31
1657272889482,MATH 109,B02,083216,Ganzberger; Geoffrey Michael,1,0,32,31
1657272889482,MATH 109,B03,093479,Ganzberger; Geoffrey Michael,8,0,32,24
1657272895517,MATH 142A,A01,083219,Chow; Bennett,7,0,32,25
1657272895517,MATH 142A,A02,083220,Chow; Bennett,10,0,32,22
1657272895517,MATH 142A,A03,093480,Chow; Bennett,7,0,32,25
1657272895517,MATH 142A,B03,093481,Chow; Bennett,8,0,32,24
1657272895517,MATH 142A,B04,093558,Chow; Bennett,12,0,32,20
1657272895517,MATH 142A,B05,093559,Chow; Bennett,6,0,32,26
1657272901541,MATH 193A,A01,083224,Rotar; Vladimir,7,0,34,27
1657272901541,MATH 193A,A02,083225,Rotar; Vladimir,6,0,34,28
1657272901541,MATH 193A,A03,083781,Rotar; Vladimir,2,0,34,32
1657272901541,MATH 193A,A04,083782,Rotar; Vladimir,8,0,34,26
1657272901541,MATH 193A,A05,093482,Rotar; Vladimir,6,0,34,28
1657272907571,MATH 197,001,091859,McAuley; Julian John,9999,0,9999,0
1657272907571,MATH 197,002,095566,Kedlaya; Kiran S.,9997,0,9999,2
1657272907571,MATH 197,003,095567,Xiao; Ming,9999,0,9999,0
1657272907571,MATH 197,004,095571,Perols; Johan Lars,9998,0,9999,1
1657272914634,COGS 9,A01,083615,Shannon; Kyle Michael,8,0,75,67
1657272920664,COGS 11,A01,083617,Boyle; Mary E. T.,22,0,48,26
1657272926695,COGS 13,A01,083071,Bastos; Amalia Pinkusfeld,9,0,71,62
1657272932724,COGS 14A,A01,092681,Semenuks; Arturs,2,1,100,98
1657272938750,COGS 14B,A01,083073,Cheng; Tzu-Han,6,0,63,57
1657272944775,COGS 17,A01,092677,Semenuks; Arturs,5,0,81,76
1657272950799,COGS 100,A01,083619,Allen; Michael Gordon,16,0,70,54
1657272956824,COGS 101A,A01,083621,Davis; Joshua Daniel,9,0,68,59
1657272962862,COGS 101B,A01,091572,Allen; Michael Gordon,11,0,65,54
1657272968884,COGS 101C,A01,083625,Delgado; Tania,17,0,35,18
1657272974908,COGS 107A,A01,083627,Boyle; Mary E. T.,13,0,60,47
1657272980933,COGS 118A,A01,083075,Gupta; Anjum,18,0,76,58
1657272986958,CSE 3,A50,083646,Miranda; Gregory Joseph,24,0,50,26
1657272992987,CSE 8A,A50,083650,Miranda; Gregory Joseph,17,1,56,39
1657272999013,CSE 11,A01,083080,Cao; Yingjun,5,15,40,35
1657273005046,CSE 12,A01,083652,Krause-Levy; Sophia Louisa,26,1,120,94
1657273011078,CSE 15L,A01,083654,Morris; Justin Loren,9,0,50,41
1657273011078,CSE 15L,A02,083655,Morris; Justin Loren,9,0,50,41
1657273017103,CSE 20,A01,083657,Tran; Khoa Dang,38,0,80,42
1657273023129,CSE 21,A01,095574,Bach; Quang Tran,22,0,48,26
1657273029157,CSE 30,A01,083084,Eldon; John,4,0,80,76
1657273029157,CSE 30,B01,095061,Bhaskar; Nishant,8,0,50,42
1657273035187,CSE 100,A01,083659,Cao; Yingjun,4,4,70,66
1657273041215,CSE 134B,A01,083661,Powell; Thomas Allan,21,0,100,79
1657273047245,CSE 140,A01,083663,Gungor; Onat,13,0,85,72
1657273053274,CSE 140L,A01,083088,Eldon; John,19,0,100,81
1657273059299,CSE 175,A01,083665,Kumar; Rakesh,3,0,25,22
1657273065323,CSE 190,A00,092507,Dubnov; Shlomo,7,0,20,13
1657273071356,ECE 45,A01,083139,Congero; Spencer William,5,0,75,70
1657273077382,ECE 65,A50,083695,Saad; Andrew S,12,0,30,18
1657273077382,ECE 65,A51,095125,Saad; Andrew S,25,0,26,1
1657273083406,ECE 109,A01,091882,Touri; Behrouz,19,0,70,51
1657273089431,ECE 180,A00,083140,Abi Samra; Nicholas Camill,1,0,30,29
1657273089431,ECE 180,B00,083141,Abi Samra; Nicholas Camill,0,0,30,30
1657273095534,MATH 10A,A01,083735,Patchell; Gregory David,2,0,30,28
1657273095534,MATH 10A,A02,083736,Patchell; Gregory David,20,0,30,10
1657273095534,MATH 10A,A03,083737,Patchell; Gregory David,16,0,30,14
1657273101574,MATH 10B,A01,083207,Lim; Seonhee,7,0,34,27
1657273101574,MATH 10B,A02,083208,Lim; Seonhee,9,0,35,26
1657273101574,MATH 10B,A03,093472,Lim; Seonhee,5,0,34,29
1657273101574,MATH 10B,B01,083739,Sinha; Shubham,11,0,30,19
1657273107604,MATH 18,A01,083743,Cinel; Cameron Alexander,6,0,30,24
1657273107604,MATH 18,A02,083744,Cinel; Cameron Alexander,17,0,30,13
1657273107604,MATH 18,A03,083745,Cinel; Cameron Alexander,8,0,30,22
1657273107604,MATH 18,B01,083748,Rideout; David Porter,4,0,37,33
1657273107604,MATH 18,B02,083749,Rideout; David Porter,4,0,36,32
1657273107604,MATH 18,B03,083750,Rideout; David Porter,2,0,37,35
1657273107604,MATH 18,B04,083751,Rideout; David Porter,6,0,36,30
1657273107604,MATH 18,B05,093473,Rideout; David Porter,5,0,36,31
1657273107604,MATH 18,B06,093474,Rideout; David Porter,5,0,36,31
1657273113632,MATH 20A,A01,083754,Zheng; Zequn,14,0,40,26
1657273119667,MATH 20B,A01,083756,Briones; Jor-el Thomas Caparas,3,0,36,33
1657273119667,MATH 20B,A02,083757,Briones; Jor-el Thomas Caparas,1,0,36,35
1657273119667,MATH 20B,A03,093475,Briones; Jor-el Thomas Caparas,2,0,36,34
1657273125701,MATH 20C,A01,083760,Briones; Jor-el Thomas Caparas,1,0,35,34
1657273125701,MATH 20C,A02,083761,Briones; Jor-el Thomas Caparas,8,0,35,27
1657273125701,MATH 20C,A03,093476,Briones; Jor-el Thomas Caparas,0,1,36,36
1657273125701,MATH 20C,B01,083762,Bach; Quang Tran,1,0,30,29
1657273131726,MATH 20D,A01,083765,Tran; Brian Kha,5,0,30,25
1657273131726,MATH 20D,A02,083766,Tran; Brian Kha,5,0,30,25
1657273131726,MATH 20D,A03,083767,Tran; Brian Kha,4,0,30,26
1657273137752,MATH 20E,A01,083771,Ganguly; Soumya,7,0,32,25
1657273137752,MATH 20E,A02,083772,Ganguly; Soumya,7,0,32,25
1657273137752,MATH 20E,B01,083773,Ciotti; Benjamin,19,0,35,16
1657273137752,MATH 20E,B02,083774,Ciotti; Benjamin,17,0,35,18
1657273143779,MATH 103A,A01,083777,Greenfeld; Be'Eri,3,0,36,33
1657273143779,MATH 103A,A02,083778,Greenfeld; Be'Eri,5,0,36,31
1657273143779,MATH 103A,A03,093561,Greenfeld; Be'Eri,4,0,36,32
1657273143779,MATH 103A,B01,083779,Greenfeld; Be'Eri,6,0,36,30
1657273143779,MATH 103A,B02,083780,Greenfeld; Be'Eri,3,0,36,33
1657273143779,MATH 103A,B03,093562,Greenfeld; Be'Eri,3,0,36,33
1657273149805,MATH 105,A01,085443,Carter; Anne Toulson,15,0,35,20
1657273149805,MATH 105,A02,093477,Carter; Anne Toulson,20,0,35,15
1657273155831,MATH 109,A01,083213,Ganzberger; Geoffrey Michael,2,0,34,32
1657273155831,MATH 109,A02,083214,Ganzberger; Geoffrey Michael,4,0,34,30
1657273155831,MATH 109,A03,093478,Ganzberger; Geoffrey Michael,2,0,34,32
1657273155831,MATH 109,B01,083215,Ganzberger; Geoffrey Michael,1,0,32,31
1657273155831,MATH 109,B02,083216,Ganzberger; Geoffrey Michael,1,0,32,31
1657273155831,MATH 109,B03,093479,Ganzberger; Geoffrey Michael,8,0,32,24
1657273161857,MATH 142A,A01,083219,Chow; Bennett,7,0,32,25
1657273161857,MATH 142A,A02,083220,Chow; Bennett,10,0,32,22
1657273161857,MATH 142A,A03,093480,Chow; Bennett,7,0,32,25
1657273161857,MATH 142A,B03,093481,Chow; Bennett,8,0,32,24
1657273161857,MATH 142A,B04,093558,Chow; Bennett,12,0,32,20
1657273161857,MATH 142A,B05,093559,Chow; Bennett,6,0,32,26
1657273167882,MATH 193A,A01,083224,Rotar; Vladimir,7,0,34,27
1657273167882,MATH 193A,A02,083225,Rotar; Vladimir,6,0,34,28
1657273167882,MATH 193A,A03,083781,Rotar; Vladimir,2,0,34,32
1657273167882,MATH 193A,A04,083782,Rotar; Vladimir,8,0,34,26
1657273167882,MATH 193A,A05,093482,Rotar; Vladimir,6,0,34,28
1657273173907,MATH 197,001,091859,McAuley; Julian John,9999,0,9999,0
1657273173907,MATH 197,002,095566,Kedlaya; Kiran S.,9997,0,9999,2
1657273173907,MATH 197,003,095567,Xiao; Ming,9999,0,9999,0
1657273173907,MATH 197,004,095571,Perols; Johan Lars,9998,0,9999,1
1657273180971,COGS 9,A01,083615,Shannon; Kyle Michael,8,0,75,67
1657273187002,COGS 11,A01,083617,Boyle; Mary E. T.,22,0,48,26
1657273193033,COGS 13,A01,083071,Bastos; Amalia Pinkusfeld,9,0,71,62
1657273199057,COGS 14A,A01,092681,Semenuks; Arturs,2,1,100,98
1657273205081,COGS 14B,A01,083073,Cheng; Tzu-Han,6,0,63,57
1657273211105,COGS 17,A01,092677,Semenuks; Arturs,5,0,81,76
1657273217129,COGS 100,A01,083619,Allen; Michael Gordon,16,0,70,54
1657273223158,COGS 101A,A01,083621,Davis; Joshua Daniel,9,0,68,59
1657273229182,COGS 101B,A01,091572,Allen; Michael Gordon,11,0,65,54
1657273235208,COGS 101C,A01,083625,Delgado; Tania,17,0,35,18
1657273241237,COGS 107A,A01,083627,Boyle; Mary E. T.,13,0,60,47
1657273247272,COGS 118A,A01,083075,Gupta; Anjum,18,0,76,58
1657273253305,CSE 3,A50,083646,Miranda; Gregory Joseph,24,0,50,26
1657273259335,CSE 8A,A50,083650,Miranda; Gregory Joseph,17,1,56,39
1657273265360,CSE 11,A01,083080,Cao; Yingjun,5,15,40,35
1657273271384,CSE 12,A01,083652,Krause-Levy; Sophia Louisa,26,1,120,94
1657273277414,CSE 15L,A01,083654,Morris; Justin Loren,9,0,50,41
1657273277414,CSE 15L,A02,083655,Morris; Justin Loren,9,0,50,41
1657273283440,CSE 20,A01,083657,Tran; Khoa Dang,38,0,80,42
1657273289470,CSE 21,A01,095574,Bach; Quang Tran,22,0,48,26
1657273295496,CSE 30,A01,083084,Eldon; John,4,0,80,76
1657273295496,CSE 30,B01,095061,Bhaskar; Nishant,8,0,50,42
1657273301520,CSE 100,A01,083659,Cao; Yingjun,4,4,70,66
1657273307552,CSE 134B,A01,083661,Powell; Thomas Allan,21,0,100,79
1657273313578,CSE 140,A01,083663,Gungor; Onat,13,0,85,72
1657273319602,CSE 140L,A01,083088,Eldon; John,19,0,100,81
1657273325633,CSE 175,A01,083665,Kumar; Rakesh,3,0,25,22
1657273331660,CSE 190,A00,092507,Dubnov; Shlomo,7,0,20,13
1657273337696,ECE 45,A01,083139,Congero; Spencer William,5,0,75,70
1657273343721,ECE 65,A50,083695,Saad; Andrew S,12,0,30,18
1657273343721,ECE 65,A51,095125,Saad; Andrew S,25,0,26,1
1657273349747,ECE 109,A01,091882,Touri; Behrouz,19,0,70,51
1657273355771,ECE 180,A00,083140,Abi Samra; Nicholas Camill,1,0,30,29
1657273355771,ECE 180,B00,083141,Abi Samra; Nicholas Camill,0,0,30,30
1657273361806,MATH 10A,A01,083735,Patchell; Gregory David,2,0,30,28
1657273361806,MATH 10A,A02,083736,Patchell; Gregory David,20,0,30,10
1657273361806,MATH 10A,A03,083737,Patchell; Gregory David,16,0,30,14
1657273367836,MATH 10B,A01,083207,Lim; Seonhee,7,0,34,27
1657273367836,MATH 10B,A02,083208,Lim; Seonhee,9,0,35,26
1657273367836,MATH 10B,A03,093472,Lim; Seonhee,5,0,34,29
1657273367836,MATH 10B,B01,083739,Sinha; Shubham,11,0,30,19
1657273373876,MATH 18,A01,083743,Cinel; Cameron Alexander,6,0,30,24
1657273373876,MATH 18,A02,083744,Cinel; Cameron Alexander,17,0,30,13
1657273373876,MATH 18,A03,083745,Cinel; Cameron Alexander,8,0,30,22
1657273373876,MATH 18,B01,083748,Rideout; David Porter,4,0,37,33
1657273373876,MATH 18,B02,083749,Rideout; David Porter,4,0,36,32
1657273373876,MATH 18,B03,083750,Rideout; David Porter,2,0,37,35
1657273373876,MATH 18,B04,083751,Rideout; David Porter,6,0,36,30
1657273373876,MATH 18,B05,093473,Rideout; David Porter,5,0,36,31
1657273373876,MATH 18,B06,093474,Rideout; David Porter,5,0,36,31
1657273379901,MATH 20A,A01,083754,Zheng; Zequn,14,0,40,26
1657273385935,MATH 20B,A01,083756,Briones; Jor-el Thomas Caparas,3,0,36,33
1657273385935,MATH 20B,A02,083757,Briones; Jor-el Thomas Caparas,1,0,36,35
1657273385935,MATH 20B,A03,093475,Briones; Jor-el Thomas Caparas,2,0,36,34
1657273391965,MATH 20C,A01,083760,Briones; Jor-el Thomas Caparas,1,0,35,34
1657273391965,MATH 20C,A02,083761,Briones; Jor-el Thomas Caparas,8,0,35,27
1657273391965,MATH 20C,A03,093476,Briones; Jor-el Thomas Caparas,0,1,36,36
1657273391965,MATH 20C,B01,083762,Bach; Quang Tran,1,0,30,29
1657273397993,MATH 20D,A01,083765,Tran; Brian Kha,5,0,30,25
1657273397993,MATH 20D,A02,083766,Tran; Brian Kha,5,0,30,25
1657273397993,MATH 20D,A03,083767,Tran; Brian Kha,4,0,30,26
1657273404025,MATH 20E,A01,083771,Ganguly; Soumya,7,0,32,25
1657273404025,MATH 20E,A02,083772,Ganguly; Soumya,7,0,32,25
1657273404025,MATH 20E,B01,083773,Ciotti; Benjamin,19,0,35,16
1657273404025,MATH 20E,B02,083774,Ciotti; Benjamin,17,0,35,18
1657273410049,MATH 103A,A01,083777,Greenfeld; Be'Eri,3,0,36,33
1657273410049,MATH 103A,A02,083778,Greenfeld; Be'Eri,5,0,36,31
1657273410049,MATH 103A,A03,093561,Greenfeld; Be'Eri,4,0,36,32
1657273410049,MATH 103A,B01,083779,Greenfeld; Be'Eri,6,0,36,30
1657273410049,MATH 103A,B02,083780,Greenfeld; Be'Eri,3,0,36,33
1657273410049,MATH 103A,B03,093562,Greenfeld; Be'Eri,3,0,36,33
1657273416079,MATH 105,A01,085443,Carter; Anne Toulson,15,0,35,20
1657273416079,MATH 105,A02,093477,Carter; Anne Toulson,20,0,35,15
1657273422112,MATH 109,A01,083213,Ganzberger; Geoffrey Michael,2,0,34,32
1657273422112,MATH 109,A02,083214,Ganzberger; Geoffrey Michael,4,0,34,30
1657273422112,MATH 109,A03,093478,Ganzberger; Geoffrey Michael,2,0,34,32
1657273422112,MATH 109,B01,083215,Ganzberger; Geoffrey Michael,1,0,32,31
1657273422112,MATH 109,B02,083216,Ganzberger; Geoffrey Michael,1,0,32,31
1657273422112,MATH 109,B03,093479,Ganzberger; Geoffrey Michael,8,0,32,24
1657273428146,MATH 142A,A01,083219,Chow; Bennett,7,0,32,25
1657273428146,MATH 142A,A02,083220,Chow; Bennett,10,0,32,22
1657273428146,MATH 142A,A03,093480,Chow; Bennett,7,0,32,25
1657273428146,MATH 142A,B03,093481,Chow; Bennett,8,0,32,24
1657273428146,MATH 142A,B04,093558,Chow; Bennett,12,0,32,20
1657273428146,MATH 142A,B05,093559,Chow; Bennett,6,0,32,26
1657273434175,MATH 193A,A01,083224,Rotar; Vladimir,7,0,34,27
1657273434175,MATH 193A,A02,083225,Rotar; Vladimir,6,0,34,28
1657273434175,MATH 193A,A03,083781,Rotar; Vladimir,2,0,34,32
1657273434175,MATH 193A,A04,083782,Rotar; Vladimir,8,0,34,26
1657273434175,MATH 193A,A05,093482,Rotar; Vladimir,6,0,34,28
1657273440204,MATH 197,001,091859,McAuley; Julian John,9999,0,9999,0
1657273440204,MATH 197,002,095566,Kedlaya; Kiran S.,9997,0,9999,2
1657273440204,MATH 197,003,095567,Xiao; Ming,9999,0,9999,0
1657273440204,MATH 197,004,095571,Perols; Johan Lars,9998,0,9999,1
1657273447260,COGS 9,A01,083615,Shannon; Kyle Michael,8,0,75,67
1657273453290,COGS 11,A01,083617,Boyle; Mary E. T.,22,0,48,26
1657273459320,COGS 13,A01,083071,Bastos; Amalia Pinkusfeld,9,0,71,62
1657273465345,COGS 14A,A01,092681,Semenuks; Arturs,2,1,100,98
1657273471369,COGS 14B,A01,083073,Cheng; Tzu-Han,6,0,63,57
1657273477400,COGS 17,A01,092677,Semenuks; Arturs,5,0,81,76
1657273483432,COGS 100,A01,083619,Allen; Michael Gordon,16,0,70,54
1657273489466,COGS 101A,A01,083621,Davis; Joshua Daniel,9,0,68,59
1657273495496,COGS 101B,A01,091572,Allen; Michael Gordon,11,0,65,54
1657273501528,COGS 101C,A01,083625,Delgado; Tania,17,0,35,18
1657273507557,COGS 107A,A01,083627,Boyle; Mary E. T.,13,0,60,47
1657273513587,COGS 118A,A01,083075,Gupta; Anjum,18,0,76,58
1657273519626,CSE 3,A50,083646,Miranda; Gregory Joseph,24,0,50,26
1657273525652,CSE 8A,A50,083650,Miranda; Gregory Joseph,17,1,56,39
1657273531678,CSE 11,A01,083080,Cao; Yingjun,5,15,40,35
1657273537702,CSE 12,A01,083652,Krause-Levy; Sophia Louisa,26,1,120,94
1657273543733,CSE 15L,A01,083654,Morris; Justin Loren,9,0,50,41
1657273543733,CSE 15L,A02,083655,Morris; Justin Loren,9,0,50,41
1657273549758,CSE 20,A01,083657,Tran; Khoa Dang,38,0,80,42
1657273555784,CSE 21,A01,095574,Bach; Quang Tran,22,0,48,26
1657273561811,CSE 30,A01,083084,Eldon; John,4,0,80,76
1657273561811,CSE 30,B01,095061,Bhaskar; Nishant,8,0,50,42
1657273567834,CSE 100,A01,083659,Cao; Yingjun,4,4,70,66
1657273573859,CSE 134B,A01,083661,Powell; Thomas Allan,21,0,100,79
1657273579890,CSE 140,A01,083663,Gungor; Onat,13,0,85,72
1657273585915,CSE 140L,A01,083088,Eldon; John,19,0,100,81
1657273591946,CSE 175,A01,083665,Kumar; Rakesh,3,0,25,22
1657273597972,CSE 190,A00,092507,Dubnov; Shlomo,7,0,20,13
1657273604005,ECE 45,A01,083139,Congero; Spencer William,5,0,75,70
1657273610039,ECE 65,A50,083695,Saad; Andrew S,12,0,30,18
1657273610039,ECE 65,A51,095125,Saad; Andrew S,25,0,26,1
1657273616064,ECE 109,A01,091882,Touri; Behrouz,19,0,70,51
1657273622090,ECE 180,A00,083140,Abi Samra; Nicholas Camill,1,0,30,29
1657273622090,ECE 180,B00,083141,Abi Samra; Nicholas Camill,0,0,30,30
1657273628122,MATH 10A,A01,083735,Patchell; Gregory David,2,0,30,28
1657273628122,MATH 10A,A02,083736,Patchell; Gregory David,20,0,30,10
1657273628122,MATH 10A,A03,083737,Patchell; Gregory David,16,0,30,14
1657273634150,MATH 10B,A01,083207,Lim; Seonhee,7,0,34,27
1657273634150,MATH 10B,A02,083208,Lim; Seonhee,9,0,35,26
1657273634150,MATH 10B,A03,093472,Lim; Seonhee,5,0,34,29
1657273634150,MATH 10B,B01,083739,Sinha; Shubham,11,0,30,19
1657273640187,MATH 18,A01,083743,Cinel; Cameron Alexander,6,0,30,24
1657273640187,MATH 18,A02,083744,Cinel; Cameron Alexander,17,0,30,13
1657273640187,MATH 18,A03,083745,Cinel; Cameron Alexander,8,0,30,22
1657273640187,MATH 18,B01,083748,Rideout; David Porter,4,0,37,33
1657273640187,MATH 18,B02,083749,Rideout; David Porter,4,0,36,32
1657273640187,MATH 18,B03,083750,Rideout; David Porter,2,0,37,35
1657273640187,MATH 18,B04,083751,Rideout; David Porter,6,0,36,30
1657273640187,MATH 18,B05,093473,Rideout; David Porter,5,0,36,31
1657273640187,MATH 18,B06,093474,Rideout; David Porter,5,0,36,31
1657273646212,MATH 20A,A01,083754,Zheng; Zequn,14,0,40,26
1657273652237,MATH 20B,A01,083756,Briones; Jor-el Thomas Caparas,3,0,36,33
1657273652237,MATH 20B,A02,083757,Briones; Jor-el Thomas Caparas,1,0,36,35
1657273652237,MATH 20B,A03,093475,Briones; Jor-el Thomas Caparas,2,0,36,34
1657273658262,MATH 20C,A01,083760,Briones; Jor-el Thomas Caparas,1,0,35,34
1657273658262,MATH 20C,A02,083761,Briones; Jor-el Thomas Caparas,8,0,35,27
1657273658262,MATH 20C,A03,093476,Briones; Jor-el Thomas Caparas,0,1,36,36
1657273658262,MATH 20C,B01,083762,Bach; Quang Tran,1,0,30,29
1657273664286,MATH 20D,A01,083765,Tran; Brian Kha,5,0,30,25
1657273664286,MATH 20D,A02,083766,Tran; Brian Kha,5,0,30,25
1657273664286,MATH 20D,A03,083767,Tran; Brian Kha,4,0,30,26
1657273670312,MATH 20E,A01,083771,Ganguly; Soumya,7,0,32,25
1657273670312,MATH 20E,A02,083772,Ganguly; Soumya,7,0,32,25
1657273670312,MATH 20E,B01,083773,Ciotti; Benjamin,19,0,35,16
1657273670312,MATH 20E,B02,083774,Ciotti; Benjamin,17,0,35,18
1657273676344,MATH 103A,A01,083777,Greenfeld; Be'Eri,3,0,36,33
1657273676344,MATH 103A,A02,083778,Greenfeld; Be'Eri,5,0,36,31
1657273676344,MATH 103A,A03,093561,Greenfeld; Be'Eri,4,0,36,32
1657273676344,MATH 103A,B01,083779,Greenfeld; Be'Eri,6,0,36,30
1657273676344,MATH 103A,B02,083780,Greenfeld; Be'Eri,3,0,36,33
1657273676344,MATH 103A,B03,093562,Greenfeld; Be'Eri,3,0,36,33
1657273682372,MATH 105,A01,085443,Carter; Anne Toulson,15,0,35,20
1657273682372,MATH 105,A02,093477,Carter; Anne Toulson,20,0,35,15
1657273688399,MATH 109,A01,083213,Ganzberger; Geoffrey Michael,2,0,34,32
1657273688399,MATH 109,A02,083214,Ganzberger; Geoffrey Michael,4,0,34,30
1657273688399,MATH 109,A03,093478,Ganzberger; Geoffrey Michael,2,0,34,32
1657273688399,MATH 109,B01,083215,Ganzberger; Geoffrey Michael,1,0,32,31
1657273688399,MATH 109,B02,083216,Ganzberger; Geoffrey Michael,1,0,32,31
1657273688399,MATH 109,B03,093479,Ganzberger; Geoffrey Michael,8,0,32,24
1657273694500,MATH 142A,A01,083219,Chow; Bennett,7,0,32,25
1657273694500,MATH 142A,A02,083220,Chow; Bennett,10,0,32,22
1657273694500,MATH 142A,A03,093480,Chow; Bennett,7,0,32,25
1657273694500,MATH 142A,B03,093481,Chow; Bennett,8,0,32,24
1657273694500,MATH 142A,B04,093558,Chow; Bennett,12,0,32,20
1657273694500,MATH 142A,B05,093559,Chow; Bennett,6,0,32,26
1657273700531,MATH 193A,A01,083224,Rotar; Vladimir,7,0,34,27
1657273700531,MATH 193A,A02,083225,Rotar; Vladimir,6,0,34,28
1657273700531,MATH 193A,A03,083781,Rotar; Vladimir,2,0,34,32
1657273700531,MATH 193A,A04,083782,Rotar; Vladimir,8,0,34,26
1657273700531,MATH 193A,A05,093482,Rotar; Vladimir,6,0,34,28
1657273706558,MATH 197,001,091859,McAuley; Julian John,9999,0,9999,0
1657273706558,MATH 197,002,095566,Kedlaya; Kiran S.,9997,0,9999,2
1657273706558,MATH 197,003,095567,Xiao; Ming,9999,0,9999,0
1657273706558,MATH 197,004,095571,Perols; Johan Lars,9998,0,9999,1
1657273713658,COGS 9,A01,083615,Shannon; Kyle Michael,8,0,75,67
1657273719686,COGS 11,A01,083617,Boyle; Mary E. T.,22,0,48,26
1657273725716,COGS 13,A01,083071,Bastos; Amalia Pinkusfeld,9,0,71,62
1657273731741,COGS 14A,A01,092681,Semenuks; Arturs,2,1,100,98
1657273737771,COGS 14B,A01,083073,Cheng; Tzu-Han,6,0,63,57
1657273743795,COGS 17,A01,092677,Semenuks; Arturs,5,0,81,76
1657273749819,COGS 100,A01,083619,Allen; Michael Gordon,16,0,70,54
1657273755848,COGS 101A,A01,083621,Davis; Joshua Daniel,9,0,68,59
1657273761872,COGS 101B,A01,091572,Allen; Michael Gordon,11,0,65,54
1657273767902,COGS 101C,A01,083625,Delgado; Tania,17,0,35,18
1657273773931,COGS 107A,A01,083627,Boyle; Mary E. T.,13,0,60,47
1657273779955,COGS 118A,A01,083075,Gupta; Anjum,18,0,76,58
1657273785980,CSE 3,A50,083646,Miranda; Gregory Joseph,24,0,50,26
1657273792005,CSE 8A,A50,083650,Miranda; Gregory Joseph,17,1,56,39
1657273798033,CSE 11,A01,083080,Cao; Yingjun,5,15,40,35
1657273804057,CSE 12,A01,083652,Krause-Levy; Sophia Louisa,26,1,120,94
1657273810087,CSE 15L,A01,083654,Morris; Justin Loren,9,0,50,41
1657273810087,CSE 15L,A02,083655,Morris; Justin Loren,9,0,50,41
1657273816111,CSE 20,A01,083657,Tran; Khoa Dang,38,0,80,42
1657273822135,CSE 21,A01,095574,Bach; Quang Tran,22,0,48,26
1657273828168,CSE 30,A01,083084,Eldon; John,4,0,80,76
1657273828168,CSE 30,B01,095061,Bhaskar; Nishant,8,0,50,42
1657273834196,CSE 100,A01,083659,Cao; Yingjun,4,4,70,66
1657273840224,CSE 134B,A01,083661,Powell; Thomas Allan,21,0,100,79
1657273846255,CSE 140,A01,083663,Gungor; Onat,13,0,85,72
1657273852279,CSE 140L,A01,083088,Eldon; John,19,0,100,81
1657273858302,CSE 175,A01,083665,Kumar; Rakesh,3,0,25,22
1657273864333,CSE 190,A00,092507,Dubnov; Shlomo,7,0,20,13
1657273870362,ECE 45,A01,083139,Congero; Spencer William,5,0,75,70
1657273876388,ECE 65,A50,083695,Saad; Andrew S,12,0,30,18
1657273876388,ECE 65,A51,095125,Saad; Andrew S,25,0,26,1
1657273882418,ECE 109,A01,091882,Touri; Behrouz,19,0,70,51
1657273888443,ECE 180,A00,083140,Abi Samra; Nicholas Camill,1,0,30,29
1657273888443,ECE 180,B00,083141,Abi Samra; Nicholas Camill,0,0,30,30
1657273894471,MATH 10A,A01,083735,Patchell; Gregory David,2,0,30,28
1657273894471,MATH 10A,A02,083736,Patchell; Gregory David,20,0,30,10
1657273894471,MATH 10A,A03,083737,Patchell; Gregory David,16,0,30,14
1657273900500,MATH 10B,A01,083207,Lim; Seonhee,7,0,34,27
1657273900500,MATH 10B,A02,083208,Lim; Seonhee,9,0,35,26
1657273900500,MATH 10B,A03,093472,Lim; Seonhee,5,0,34,29
1657273900500,MATH 10B,B01,083739,Sinha; Shubham,11,0,30,19
1657273906538,MATH 18,A01,083743,Cinel; Cameron Alexander,6,0,30,24
1657273906538,MATH 18,A02,083744,Cinel; Cameron Alexander,17,0,30,13
1657273906538,MATH 18,A03,083745,Cinel; Cameron Alexander,8,0,30,22
1657273906538,MATH 18,B01,083748,Rideout; David Porter,4,0,37,33
1657273906538,MATH 18,B02,083749,Rideout; David Porter,4,0,36,32
1657273906538,MATH 18,B03,083750,Rideout; David Porter,2,0,37,35
1657273906538,MATH 18,B04,083751,Rideout; David Porter,6,0,36,30
1657273906538,MATH 18,B05,093473,Rideout; David Porter,5,0,36,31
1657273906538,MATH 18,B06,093474,Rideout; David Porter,5,0,36,31
1657273912569,MATH 20A,A01,083754,Zheng; Zequn,14,0,40,26
1657273918605,MATH 20B,A01,083756,Briones; Jor-el Thomas Caparas,3,0,36,33
1657273918605,MATH 20B,A02,083757,Briones; Jor-el Thomas Caparas,1,0,36,35
1657273918605,MATH 20B,A03,093475,Briones; Jor-el Thomas Caparas,2,0,36,34
1657273924630,MATH 20C,A01,083760,Briones; Jor-el Thomas Caparas,1,0,35,34
1657273924630,MATH 20C,A02,083761,Briones; Jor-el Thomas Caparas,8,0,35,27
1657273924630,MATH 20C,A03,093476,Briones; Jor-el Thomas Caparas,0,1,36,36
1657273924630,MATH 20C,B01,083762,Bach; Quang Tran,1,0,30,29
1657273930657,MATH 20D,A01,083765,Tran; Brian Kha,5,0,30,25
1657273930657,MATH 20D,A02,083766,Tran; Brian Kha,5,0,30,25
1657273930657,MATH 20D,A03,083767,Tran; Brian Kha,4,0,30,26
1657273936683,MATH 20E,A01,083771,Ganguly; Soumya,7,0,32,25
1657273936683,MATH 20E,A02,083772,Ganguly; Soumya,7,0,32,25
1657273936683,MATH 20E,B01,083773,Ciotti; Benjamin,19,0,35,16
1657273936683,MATH 20E,B02,083774,Ciotti; Benjamin,17,0,35,18
1657273942720,MATH 103A,A01,083777,Greenfeld; Be'Eri,3,0,36,33
1657273942720,MATH 103A,A02,083778,Greenfeld; Be'Eri,5,0,36,31
1657273942720,MATH 103A,A03,093561,Greenfeld; Be'Eri,4,0,36,32
1657273942720,MATH 103A,B01,083779,Greenfeld; Be'Eri,6,0,36,30
1657273942720,MATH 103A,B02,083780,Greenfeld; Be'Eri,3,0,36,33
1657273942720,MATH 103A,B03,093562,Greenfeld; Be'Eri,3,0,36,33
1657273948753,MATH 105,A01,085443,Carter; Anne Toulson,15,0,35,20
1657273948753,MATH 105,A02,093477,Carter; Anne Toulson,20,0,35,15
1657273954777,MATH 109,A01,083213,Ganzberger; Geoffrey Michael,2,0,34,32
1657273954777,MATH 109,A02,083214,Ganzberger; Geoffrey Michael,4,0,34,30
1657273954777,MATH 109,A03,093478,Ganzberger; Geoffrey Michael,2,0,34,32
1657273954777,MATH 109,B01,083215,Ganzberger; Geoffrey Michael,1,0,32,31
1657273954777,MATH 109,B02,083216,Ganzberger; Geoffrey Michael,1,0,32,31
1657273954777,MATH 109,B03,093479,Ganzberger; Geoffrey Michael,8,0,32,24
1657273960810,MATH 142A,A01,083219,Chow; Bennett,7,0,32,25
1657273960810,MATH 142A,A02,083220,Chow; Bennett,10,0,32,22
1657273960810,MATH 142A,A03,093480,Chow; Bennett,7,0,32,25
1657273960810,MATH 142A,B03,093481,Chow; Bennett,8,0,32,24
1657273960810,MATH 142A,B04,093558,Chow; Bennett,12,0,32,20
1657273960810,MATH 142A,B05,093559,Chow; Bennett,6,0,32,26
1657273966835,MATH 193A,A01,083224,Rotar; Vladimir,7,0,34,27
1657273966835,MATH 193A,A02,083225,Rotar; Vladimir,6,0,34,28
1657273966835,MATH 193A,A03,083781,Rotar; Vladimir,2,0,34,32
1657273966835,MATH 193A,A04,083782,Rotar; Vladimir,8,0,34,26
1657273966835,MATH 193A,A05,093482,Rotar; Vladimir,6,0,34,28
1657273972866,MATH 197,001,091859,McAuley; Julian John,9999,0,9999,0
1657273972866,MATH 197,002,095566,Kedlaya; Kiran S.,9997,0,9999,2
1657273972866,MATH 197,003,095567,Xiao; Ming,9999,0,9999,0
1657273972866,MATH 197,004,095571,Perols; Johan Lars,9998,0,9999,1
1657273979933,COGS 9,A01,083615,Shannon; Kyle Michael,8,0,75,67
1657273985963,COGS 11,A01,083617,Boyle; Mary E. T.,22,0,48,26
1657273991989,COGS 13,A01,083071,Bastos; Amalia Pinkusfeld,9,0,71,62
1657273998020,COGS 14A,A01,092681,Semenuks; Arturs,2,1,100,98
1657274004049,COGS 14B,A01,083073,Cheng; Tzu-Han,6,0,63,57
1657274010079,COGS 17,A01,092677,Semenuks; Arturs,5,0,81,76
1657274016104,COGS 100,A01,083619,Allen; Michael Gordon,16,0,70,54
1657274022134,COGS 101A,A01,083621,Davis; Joshua Daniel,9,0,68,59
1657274028163,COGS 101B,A01,091572,Allen; Michael Gordon,11,0,65,54
1657274034192,COGS 101C,A01,083625,Delgado; Tania,17,0,35,18
1657274040215,COGS 107A,A01,083627,Boyle; Mary E. T.,13,0,60,47
1657274046242,COGS 118A,A01,083075,Gupta; Anjum,18,0,76,58
1657274052268,CSE 3,A50,083646,Miranda; Gregory Joseph,24,0,50,26
1657274058298,CSE 8A,A50,083650,Miranda; Gregory Joseph,17,1,56,39
1657274064322,CSE 11,A01,083080,Cao; Yingjun,5,15,40,35
1657274070347,CSE 12,A01,083652,Krause-Levy; Sophia Louisa,26,1,120,94
1657274076372,CSE 15L,A01,083654,Morris; Justin Loren,9,0,50,41
1657274076372,CSE 15L,A02,083655,Morris; Justin Loren,9,0,50,41
1657274082397,CSE 20,A01,083657,Tran; Khoa Dang,38,0,80,42
1657274088421,CSE 21,A01,095574,Bach; Quang Tran,22,0,48,26
1657274094450,CSE 30,A01,083084,Eldon; John,4,0,80,76
1657274094450,CSE 30,B01,095061,Bhaskar; Nishant,8,0,50,42
1657274100476,CSE 100,A01,083659,Cao; Yingjun,4,4,70,66
1657274106499,CSE 134B,A01,083661,Powell; Thomas Allan,21,0,100,79
1657274112523,CSE 140,A01,083663,Gungor; Onat,13,0,85,72
1657274118550,CSE 140L,A01,083088,Eldon; John,19,0,100,81
1657274124578,CSE 175,A01,083665,Kumar; Rakesh,3,0,25,22
1657274130606,CSE 190,A00,092507,Dubnov; Shlomo,7,0,20,13
1657274136639,ECE 45,A01,083139,Congero; Spencer William,5,0,75,70
1657274142675,ECE 65,A50,083695,Saad; Andrew S,12,0,30,18
1657274142675,ECE 65,A51,095125,Saad; Andrew S,25,0,26,1
1657274148701,ECE 109,A01,091882,Touri; Behrouz,19,0,70,51
1657274154726,ECE 180,A00,083140,Abi Samra; Nicholas Camill,1,0,30,29
1657274154726,ECE 180,B00,083141,Abi Samra; Nicholas Camill,0,0,30,30
1657274160752,MATH 10A,A01,083735,Patchell; Gregory David,2,0,30,28
1657274160752,MATH 10A,A02,083736,Patchell; Gregory David,20,0,30,10
1657274160752,MATH 10A,A03,083737,Patchell; Gregory David,16,0,30,14
1657274166779,MATH 10B,A01,083207,Lim; Seonhee,7,0,34,27
1657274166779,MATH 10B,A02,083208,Lim; Seonhee,9,0,35,26
1657274166779,MATH 10B,A03,093472,Lim; Seonhee,5,0,34,29
1657274166779,MATH 10B,B01,083739,Sinha; Shubham,11,0,30,19
1657274172807,MATH 18,A01,083743,Cinel; Cameron Alexander,6,0,30,24
1657274172807,MATH 18,A02,083744,Cinel; Cameron Alexander,17,0,30,13
1657274172807,MATH 18,A03,083745,Cinel; Cameron Alexander,8,0,30,22
1657274172807,MATH 18,B01,083748,Rideout; David Porter,4,0,37,33
1657274172807,MATH 18,B02,083749,Rideout; David Porter,4,0,36,32
1657274172807,MATH 18,B03,083750,Rideout; David Porter,2,0,37,35
1657274172807,MATH 18,B04,083751,Rideout; David Porter,6,0,36,30
1657274172807,MATH 18,B05,093473,Rideout; David Porter,5,0,36,31
1657274172807,MATH 18,B06,093474,Rideout; David Porter,5,0,36,31
1657274178832,MATH 20A,A01,083754,Zheng; Zequn,14,0,40,26
1657274184855,MATH 20B,A01,083756,Briones; Jor-el Thomas Caparas,3,0,36,33
1657274184855,MATH 20B,A02,083757,Briones; Jor-el Thomas Caparas,1,0,36,35
1657274184855,MATH 20B,A03,093475,Briones; Jor-el Thomas Caparas,2,0,36,34
1657274190885,MATH 20C,A01,083760,Briones; Jor-el Thomas Caparas,1,0,35,34
1657274190885,MATH 20C,A02,083761,Briones; Jor-el Thomas Caparas,8,0,35,27
1657274190885,MATH 20C,A03,093476,Briones; Jor-el Thomas Caparas,0,1,36,36
1657274190885,MATH 20C,B01,083762,Bach; Quang Tran,1,0,30,29
1657274196916,MATH 20D,A01,083765,Tran; Brian Kha,5,0,30,25
1657274196916,MATH 20D,A02,083766,Tran; Brian Kha,5,0,30,25
1657274196916,MATH 20D,A03,083767,Tran; Brian Kha,4,0,30,26
1657274202953,MATH 20E,A01,083771,Ganguly; Soumya,7,0,32,25
1657274202953,MATH 20E,A02,083772,Ganguly; Soumya,7,0,32,25
1657274202953,MATH 20E,B01,083773,Ciotti; Benjamin,19,0,35,16
1657274202953,MATH 20E,B02,083774,Ciotti; Benjamin,17,0,35,18
1657274208989,MATH 103A,A01,083777,Greenfeld; Be'Eri,3,0,36,33
1657274208989,MATH 103A,A02,083778,Greenfeld; Be'Eri,5,0,36,31
1657274208989,MATH 103A,A03,093561,Greenfeld; Be'Eri,4,0,36,32
1657274208989,MATH 103A,B01,083779,Greenfeld; Be'Eri,6,0,36,30
1657274208989,MATH 103A,B02,083780,Greenfeld; Be'Eri,3,0,36,33
1657274208989,MATH 103A,B03,093562,Greenfeld; Be'Eri,3,0,36,33
1657274215016,MATH 105,A01,085443,Carter; Anne Toulson,15,0,35,20
1657274215016,MATH 105,A02,093477,Carter; Anne Toulson,20,0,35,15
1657274221047,MATH 109,A01,083213,Ganzberger; Geoffrey Michael,2,0,34,32
1657274221047,MATH 109,A02,083214,Ganzberger; Geoffrey Michael,4,0,34,30
1657274221047,MATH 109,A03,093478,Ganzberger; Geoffrey Michael,2,0,34,32
1657274221047,MATH 109,B01,083215,Ganzberger; Geoffrey Michael,1,0,32,31
1657274221047,MATH 109,B02,083216,Ganzberger; Geoffrey Michael,1,0,32,31
1657274221047,MATH 109,B03,093479,Ganzberger; Geoffrey Michael,8,0,32,24
1657274227072,MATH 142A,A01,083219,Chow; Bennett,7,0,32,25
1657274227072,MATH 142A,A02,083220,Chow; Bennett,10,0,32,22
1657274227072,MATH 142A,A03,093480,Chow; Bennett,7,0,32,25
1657274227072,MATH 142A,B03,093481,Chow; Bennett,8,0,32,24
1657274227072,MATH 142A,B04,093558,Chow; Bennett,12,0,32,20
1657274227072,MATH 142A,B05,093559,Chow; Bennett,6,0,32,26
1657274233100,MATH 193A,A01,083224,Rotar; Vladimir,7,0,34,27
1657274233100,MATH 193A,A02,083225,Rotar; Vladimir,6,0,34,28
1657274233100,MATH 193A,A03,083781,Rotar; Vladimir,2,0,34,32
1657274233100,MATH 193A,A04,083782,Rotar; Vladimir,8,0,34,26
1657274233100,MATH 193A,A05,093482,Rotar; Vladimir,6,0,34,28
1657274239129,MATH 197,001,091859,McAuley; Julian John,9999,0,9999,0
1657274239129,MATH 197,002,095566,Kedlaya; Kiran S.,9997,0,9999,2
1657274239129,MATH 197,003,095567,Xiao; Ming,9999,0,9999,0
1657274239129,MATH 197,004,095571,Perols; Johan Lars,9998,0,9999,1
1657274246193,COGS 9,A01,083615,Shannon; Kyle Michael,8,0,75,67
1657274252223,COGS 11,A01,083617,Boyle; Mary E. T.,22,0,48,26
1657274258250,COGS 13,A01,083071,Bastos; Amalia Pinkusfeld,9,0,71,62
1657274264276,COGS 14A,A01,092681,Semenuks; Arturs,2,1,100,98
1657274270305,COGS 14B,A01,083073,Cheng; Tzu-Han,6,0,63,57
1657274276329,COGS 17,A01,092677,Semenuks; Arturs,5,0,81,76
1657274282363,COGS 100,A01,083619,Allen; Michael Gordon,16,0,70,54
1657274288465,COGS 101A,A01,083621,Davis; Joshua Daniel,9,0,68,59
1657274294489,COGS 101B,A01,091572,Allen; Michael Gordon,11,0,65,54
1657274300518,COGS 101C,A01,083625,Delgado; Tania,17,0,35,18
1657274306542,COGS 107A,A01,083627,Boyle; Mary E. T.,13,0,60,47
1657274312570,COGS 118A,A01,083075,Gupta; Anjum,18,0,76,58
1657274318596,CSE 3,A50,083646,Miranda; Gregory Joseph,24,0,50,26
1657274324622,CSE 8A,A50,083650,Miranda; Gregory Joseph,17,1,56,39
1657274330646,CSE 11,A01,083080,Cao; Yingjun,5,15,40,35
1657274336671,CSE 12,A01,083652,Krause-Levy; Sophia Louisa,26,1,120,94
1657274342703,CSE 15L,A01,083654,Morris; Justin Loren,9,0,50,41
1657274342703,CSE 15L,A02,083655,Morris; Justin Loren,9,0,50,41
1657274348729,CSE 20,A01,083657,Tran; Khoa Dang,38,0,80,42
1657274354762,CSE 21,A01,095574,Bach; Quang Tran,22,0,48,26
1657274360791,CSE 30,A01,083084,Eldon; John,4,0,80,76
1657274360791,CSE 30,B01,095061,Bhaskar; Nishant,8,0,50,42
1657274366827,CSE 100,A01,083659,Cao; Yingjun,4,4,70,66
1657274372854,CSE 134B,A01,083661,Powell; Thomas Allan,21,0,100,79
1657274378879,CSE 140,A01,083663,Gungor; Onat,13,0,85,72
1657274384919,CSE 140L,A01,083088,Eldon; John,19,0,100,81
1657274390952,CSE 175,A01,083665,Kumar; Rakesh,3,0,25,22
1657274396979,CSE 190,A00,092507,Dubnov; Shlomo,7,0,20,13
1657274403006,ECE 45,A01,083139,Congero; Spencer William,5,0,75,70
1657274409040,ECE 65,A50,083695,Saad; Andrew S,12,0,30,18
1657274409040,ECE 65,A51,095125,Saad; Andrew S,25,0,26,1
1657274415066,ECE 109,A01,091882,Touri; Behrouz,19,0,70,51
1657274421090,ECE 180,A00,083140,Abi Samra; Nicholas Camill,1,0,30,29
1657274421090,ECE 180,B00,083141,Abi Samra; Nicholas Camill,0,0,30,30
1657274427117,MATH 10A,A01,083735,Patchell; Gregory David,2,0,30,28
1657274427117,MATH 10A,A02,083736,Patchell; Gregory David,20,0,30,10
1657274427117,MATH 10A,A03,083737,Patchell; Gregory David,16,0,30,14
1657274433152,MATH 10B,A01,083207,Lim; Seonhee,7,0,34,27
1657274433152,MATH 10B,A02,083208,Lim; Seonhee,9,0,35,26
1657274433152,MATH 10B,A03,093472,Lim; Seonhee,5,0,34,29
1657274433152,MATH 10B,B01,083739,Sinha; Shubham,11,0,30,19
1657274439182,MATH 18,A01,083743,Cinel; Cameron Alexander,6,0,30,24
1657274439182,MATH 18,A02,083744,Cinel; Cameron Alexander,17,0,30,13
1657274439182,MATH 18,A03,083745,Cinel; Cameron Alexander,8,0,30,22
1657274439182,MATH 18,B01,083748,Rideout; David Porter,4,0,37,33
1657274439182,MATH 18,B02,083749,Rideout; David Porter,4,0,36,32
1657274439182,MATH 18,B03,083750,Rideout; David Porter,2,0,37,35
1657274439182,MATH 18,B04,083751,Rideout; David Porter,6,0,36,30
1657274439182,MATH 18,B05,093473,Rideout; David Porter,5,0,36,31
1657274439182,MATH 18,B06,093474,Rideout; David Porter,5,0,36,31
1657274445206,MATH 20A,A01,083754,Zheng; Zequn,14,0,40,26
1657274451242,MATH 20B,A01,083756,Briones; Jor-el Thomas Caparas,3,0,36,33
1657274451242,MATH 20B,A02,083757,Briones; Jor-el Thomas Caparas,1,0,36,35
1657274451242,MATH 20B,A03,093475,Briones; Jor-el Thomas Caparas,2,0,36,34
1657274457278,MATH 20C,A01,083760,Briones; Jor-el Thomas Caparas,1,0,35,34
1657274457278,MATH 20C,A02,083761,Briones; Jor-el Thomas Caparas,8,0,35,27
1657274457278,MATH 20C,A03,093476,Briones; Jor-el Thomas Caparas,0,1,36,36
1657274457278,MATH 20C,B01,083762,Bach; Quang Tran,1,0,30,29
1657274463303,MATH 20D,A01,083765,Tran; Brian Kha,5,0,30,25
1657274463303,MATH 20D,A02,083766,Tran; Brian Kha,5,0,30,25
1657274463303,MATH 20D,A03,083767,Tran; Brian Kha,4,0,30,26
1657274469332,MATH 20E,A01,083771,Ganguly; Soumya,7,0,32,25
1657274469332,MATH 20E,A02,083772,Ganguly; Soumya,7,0,32,25
1657274469332,MATH 20E,B01,083773,Ciotti; Benjamin,19,0,35,16
1657274469332,MATH 20E,B02,083774,Ciotti; Benjamin,17,0,35,18
1657274475374,MATH 103A,A01,083777,Greenfeld; Be'Eri,3,0,36,33
1657274475374,MATH 103A,A02,083778,Greenfeld; Be'Eri,5,0,36,31
1657274475374,MATH 103A,A03,093561,Greenfeld; Be'Eri,4,0,36,32
1657274475374,MATH 103A,B01,083779,Greenfeld; Be'Eri,6,0,36,30
1657274475374,MATH 103A,B02,083780,Greenfeld; Be'Eri,3,0,36,33
1657274475374,MATH 103A,B03,093562,Greenfeld; Be'Eri,3,0,36,33
1657274481399,MATH 105,A01,085443,Carter; Anne Toulson,15,0,35,20
1657274481399,MATH 105,A02,093477,Carter; Anne Toulson,20,0,35,15
1657274487427,MATH 109,A01,083213,Ganzberger; Geoffrey Michael,2,0,34,32
1657274487427,MATH 109,A02,083214,Ganzberger; Geoffrey Michael,4,0,34,30
1657274487427,MATH 109,A03,093478,Ganzberger; Geoffrey Michael,2,0,34,32
1657274487427,MATH 109,B01,083215,Ganzberger; Geoffrey Michael,1,0,32,31
1657274487427,MATH 109,B02,083216,Ganzberger; Geoffrey Michael,1,0,32,31
1657274487427,MATH 109,B03,093479,Ganzberger; Geoffrey Michael,8,0,32,24
1657274493469,MATH 142A,A01,083219,Chow; Bennett,7,0,32,25
1657274493469,MATH 142A,A02,083220,Chow; Bennett,10,0,32,22
1657274493469,MATH 142A,A03,093480,Chow; Bennett,7,0,32,25
1657274493469,MATH 142A,B03,093481,Chow; Bennett,8,0,32,24
1657274493469,MATH 142A,B04,093558,Chow; Bennett,12,0,32,20
1657274493469,MATH 142A,B05,093559,Chow; Bennett,6,0,32,26
1657274499505,MATH 193A,A01,083224,Rotar; Vladimir,7,0,34,27
1657274499505,MATH 193A,A02,083225,Rotar; Vladimir,6,0,34,28
1657274499505,MATH 193A,A03,083781,Rotar; Vladimir,2,0,34,32
1657274499505,MATH 193A,A04,083782,Rotar; Vladimir,8,0,34,26
1657274499505,MATH 193A,A05,093482,Rotar; Vladimir,6,0,34,28
1657274505537,MATH 197,001,091859,McAuley; Julian John,9999,0,9999,0
1657274505537,MATH 197,002,095566,Kedlaya; Kiran S.,9997,0,9999,2
1657274505537,MATH 197,003,095567,Xiao; Ming,9999,0,9999,0
1657274505537,MATH 197,004,095571,Perols; Johan Lars,9998,0,9999,1
1657274512632,COGS 9,A01,083615,Shannon; Kyle Michael,8,0,75,67
1657274518665,COGS 11,A01,083617,Boyle; Mary E. T.,22,0,48,26
1657274524691,COGS 13,A01,083071,Bastos; Amalia Pinkusfeld,9,0,71,62
1657274530716,COGS 14A,A01,092681,Semenuks; Arturs,2,1,100,98
1657274536747,COGS 14B,A01,083073,Cheng; Tzu-Han,6,0,63,57
1657274542775,COGS 17,A01,092677,Semenuks; Arturs,5,0,81,76
1657274548801,COGS 100,A01,083619,Allen; Michael Gordon,16,0,70,54
1657274554836,COGS 101A,A01,083621,Davis; Joshua Daniel,9,0,68,59
1657274560869,COGS 101B,A01,091572,Allen; Michael Gordon,11,0,65,54
1657274566900,COGS 101C,A01,083625,Delgado; Tania,17,0,35,18
1657274572925,COGS 107A,A01,083627,Boyle; Mary E. T.,13,0,60,47
1657274578958,COGS 118A,A01,083075,Gupta; Anjum,18,0,76,58
1657274584985,CSE 3,A50,083646,Miranda; Gregory Joseph,24,0,50,26
1657274591008,CSE 8A,A50,083650,Miranda; Gregory Joseph,17,1,56,39
1657274597032,CSE 11,A01,083080,Cao; Yingjun,5,15,40,35
1657274603064,CSE 12,A01,083652,Krause-Levy; Sophia Louisa,26,1,120,94
1657274609093,CSE 15L,A01,083654,Morris; Justin Loren,9,0,50,41
1657274609093,CSE 15L,A02,083655,Morris; Justin Loren,9,0,50,41
1657274615117,CSE 20,A01,083657,Tran; Khoa Dang,38,0,80,42
1657274621140,CSE 21,A01,095574,Bach; Quang Tran,22,0,48,26
1657274627167,CSE 30,A01,083084,Eldon; John,4,0,80,76
1657274627167,CSE 30,B01,095061,Bhaskar; Nishant,8,0,50,42
1657274633202,CSE 100,A01,083659,Cao; Yingjun,4,4,70,66
1657274639228,CSE 134B,A01,083661,Powell; Thomas Allan,21,0,100,79
1657274645263,CSE 140,A01,083663,Gungor; Onat,13,0,85,72
1657274651289,CSE 140L,A01,083088,Eldon; John,19,0,100,81
1657274657314,CSE 175,A01,083665,Kumar; Rakesh,3,0,25,22
1657274663340,CSE 190,A00,092507,Dubnov; Shlomo,7,0,20,13
1657274669371,ECE 45,A01,083139,Congero; Spencer William,5,0,75,70
1657274675396,ECE 65,A50,083695,Saad; Andrew S,12,0,30,18
1657274675396,ECE 65,A51,095125,Saad; Andrew S,25,0,26,1
1657274681426,ECE 109,A01,091882,Touri; Behrouz,19,0,70,51
1657274687455,ECE 180,A00,083140,Abi Samra; Nicholas Camill,1,0,30,29
1657274687455,ECE 180,B00,083141,Abi Samra; Nicholas Camill,0,0,30,30
1657274693489,MATH 10A,A01,083735,Patchell; Gregory David,2,0,30,28
1657274693489,MATH 10A,A02,083736,Patchell; Gregory David,20,0,30,10
1657274693489,MATH 10A,A03,083737,Patchell; Gregory David,16,0,30,14
1657274699523,MATH 10B,A01,083207,Lim; Seonhee,7,0,34,27
1657274699523,MATH 10B,A02,083208,Lim; Seonhee,9,0,35,26
1657274699523,MATH 10B,A03,093472,Lim; Seonhee,5,0,34,29
1657274699523,MATH 10B,B01,083739,Sinha; Shubham,11,0,30,19
1657274705559,MATH 18,A01,083743,Cinel; Cameron Alexander,6,0,30,24
1657274705559,MATH 18,A02,083744,Cinel; Cameron Alexander,17,0,30,13
1657274705559,MATH 18,A03,083745,Cinel; Cameron Alexander,8,0,30,22
1657274705559,MATH 18,B01,083748,Rideout; David Porter,4,0,37,33
1657274705559,MATH 18,B02,083749,Rideout; David Porter,4,0,36,32
1657274705559,MATH 18,B03,083750,Rideout; David Porter,2,0,37,35
1657274705559,MATH 18,B04,083751,Rideout; David Porter,6,0,36,30
1657274705559,MATH 18,B05,093473,Rideout; David Porter,5,0,36,31
1657274705559,MATH 18,B06,093474,Rideout; David Porter,5,0,36,31
1657274711584,MATH 20A,A01,083754,Zheng; Zequn,14,0,40,26
1657274717609,MATH 20B,A01,083756,Briones; Jor-el Thomas Caparas,3,0,36,33
1657274717609,MATH 20B,A02,083757,Briones; Jor-el Thomas Caparas,1,0,36,35
1657274717609,MATH 20B,A03,093475,Briones; Jor-el Thomas Caparas,2,0,36,34
1657274723639,MATH 20C,A01,083760,Briones; Jor-el Thomas Caparas,1,0,35,34
1657274723639,MATH 20C,A02,083761,Briones; Jor-el Thomas Caparas,8,0,35,27
1657274723639,MATH 20C,A03,093476,Briones; Jor-el Thomas Caparas,0,1,36,36
1657274723639,MATH 20C,B01,083762,Bach; Quang Tran,1,0,30,29
1657274729666,MATH 20D,A01,083765,Tran; Brian Kha,5,0,30,25
1657274729666,MATH 20D,A02,083766,Tran; Brian Kha,5,0,30,25
1657274729666,MATH 20D,A03,083767,Tran; Brian Kha,4,0,30,26
1657274735698,MATH 20E,A01,083771,Ganguly; Soumya,7,0,32,25
1657274735698,MATH 20E,A02,083772,Ganguly; Soumya,7,0,32,25
1657274735698,MATH 20E,B01,083773,Ciotti; Benjamin,19,0,35,16
1657274735698,MATH 20E,B02,083774,Ciotti; Benjamin,17,0,35,18
1657274741740,MATH 103A,A01,083777,Greenfeld; Be'Eri,3,0,36,33
1657274741740,MATH 103A,A02,083778,Greenfeld; Be'Eri,5,0,36,31
1657274741740,MATH 103A,A03,093561,Greenfeld; Be'Eri,4,0,36,32
1657274741740,MATH 103A,B01,083779,Greenfeld; Be'Eri,6,0,36,30
1657274741740,MATH 103A,B02,083780,Greenfeld; Be'Eri,3,0,36,33
1657274741740,MATH 103A,B03,093562,Greenfeld; Be'Eri,3,0,36,33
1657274747766,MATH 105,A01,085443,Carter; Anne Toulson,15,0,35,20
1657274747766,MATH 105,A02,093477,Carter; Anne Toulson,20,0,35,15
1657274753793,MATH 109,A01,083213,Ganzberger; Geoffrey Michael,2,0,34,32
1657274753793,MATH 109,A02,083214,Ganzberger; Geoffrey Michael,4,0,34,30
1657274753793,MATH 109,A03,093478,Ganzberger; Geoffrey Michael,2,0,34,32
1657274753793,MATH 109,B01,083215,Ganzberger; Geoffrey Michael,1,0,32,31
1657274753793,MATH 109,B02,083216,Ganzberger; Geoffrey Michael,1,0,32,31
1657274753793,MATH 109,B03,093479,Ganzberger; Geoffrey Michael,8,0,32,24
1657274759827,MATH 142A,A01,083219,Chow; Bennett,7,0,32,25
1657274759827,MATH 142A,A02,083220,Chow; Bennett,10,0,32,22
1657274759827,MATH 142A,A03,093480,Chow; Bennett,7,0,32,25
1657274759827,MATH 142A,B03,093481,Chow; Bennett,8,0,32,24
1657274759827,MATH 142A,B04,093558,Chow; Bennett,12,0,32,20
1657274759827,MATH 142A,B05,093559,Chow; Bennett,6,0,32,26
1657274765857,MATH 193A,A01,083224,Rotar; Vladimir,7,0,34,27
1657274765857,MATH 193A,A02,083225,Rotar; Vladimir,6,0,34,28
1657274765857,MATH 193A,A03,083781,Rotar; Vladimir,2,0,34,32
1657274765857,MATH 193A,A04,083782,Rotar; Vladimir,8,0,34,26
1657274765857,MATH 193A,A05,093482,Rotar; Vladimir,6,0,34,28
1657274771888,MATH 197,001,091859,McAuley; Julian John,9999,0,9999,0
1657274771888,MATH 197,002,095566,Kedlaya; Kiran S.,9997,0,9999,2
1657274771888,MATH 197,003,095567,Xiao; Ming,9999,0,9999,0
1657274771888,MATH 197,004,095571,Perols; Johan Lars,9998,0,9999,1
1657274778946,COGS 9,A01,083615,Shannon; Kyle Michael,8,0,75,67
1657274784974,COGS 11,A01,083617,Boyle; Mary E. T.,22,0,48,26
1657274791004,COGS 13,A01,083071,Bastos; Amalia Pinkusfeld,9,0,71,62
1657274797032,COGS 14A,A01,092681,Semenuks; Arturs,2,1,100,98
1657274803062,COGS 14B,A01,083073,Cheng; Tzu-Han,6,0,63,57
1657274809089,COGS 17,A01,092677,Semenuks; Arturs,5,0,81,76
1657274815119,COGS 100,A01,083619,Allen; Michael Gordon,16,0,70,54
1657274821147,COGS 101A,A01,083621,Davis; Joshua Daniel,9,0,68,59
1657274827172,COGS 101B,A01,091572,Allen; Michael Gordon,11,0,65,54
1657274833197,COGS 101C,A01,083625,Delgado; Tania,17,0,35,18
1657274839221,COGS 107A,A01,083627,Boyle; Mary E. T.,13,0,60,47
1657274845244,COGS 118A,A01,083075,Gupta; Anjum,18,0,76,58
1657274851275,CSE 3,A50,083646,Miranda; Gregory Joseph,24,0,50,26
1657274857300,CSE 8A,A50,083650,Miranda; Gregory Joseph,17,1,56,39
1657274863325,CSE 11,A01,083080,Cao; Yingjun,5,15,40,35
1657274869352,CSE 12,A01,083652,Krause-Levy; Sophia Louisa,26,1,120,94
1657274875378,CSE 15L,A01,083654,Morris; Justin Loren,9,0,50,41
1657274875378,CSE 15L,A02,083655,Morris; Justin Loren,9,0,50,41
1657274881411,CSE 20,A01,083657,Tran; Khoa Dang,38,0,80,42
1657274887522,CSE 21,A01,095574,Bach; Quang Tran,22,0,48,26
1657274893557,CSE 30,A01,083084,Eldon; John,4,0,80,76
1657274893557,CSE 30,B01,095061,Bhaskar; Nishant,8,0,50,42
1657274899581,CSE 100,A01,083659,Cao; Yingjun,4,4,70,66
1657274905609,CSE 134B,A01,083661,Powell; Thomas Allan,21,0,100,79
1657274911634,CSE 140,A01,083663,Gungor; Onat,13,0,85,72
1657274917657,CSE 140L,A01,083088,Eldon; John,19,0,100,81
1657274923682,CSE 175,A01,083665,Kumar; Rakesh,3,0,25,22
1657274929705,CSE 190,A00,092507,Dubnov; Shlomo,7,0,20,13
1657274935736,ECE 45,A01,083139,Congero; Spencer William,5,0,75,70
1657274941760,ECE 65,A50,083695,Saad; Andrew S,12,0,30,18
1657274941760,ECE 65,A51,095125,Saad; Andrew S,25,0,26,1
1657274947784,ECE 109,A01,091882,Touri; Behrouz,19,0,70,51
1657274953814,ECE 180,A00,083140,Abi Samra; Nicholas Camill,1,0,30,29
1657274953814,ECE 180,B00,083141,Abi Samra; Nicholas Camill,0,0,30,30
1657274959837,MATH 10A,A01,083735,Patchell; Gregory David,2,0,30,28
1657274959837,MATH 10A,A02,083736,Patchell; Gregory David,20,0,30,10
1657274959837,MATH 10A,A03,083737,Patchell; Gregory David,16,0,30,14
1657274965861,MATH 10B,A01,083207,Lim; Seonhee,7,0,34,27
1657274965861,MATH 10B,A02,083208,Lim; Seonhee,9,0,35,26
1657274965861,MATH 10B,A03,093472,Lim; Seonhee,5,0,34,29
1657274965861,MATH 10B,B01,083739,Sinha; Shubham,11,0,30,19
1657274971887,MATH 18,A01,083743,Cinel; Cameron Alexander,6,0,30,24
1657274971887,MATH 18,A02,083744,Cinel; Cameron Alexander,17,0,30,13
1657274971887,MATH 18,A03,083745,Cinel; Cameron Alexander,8,0,30,22
1657274971887,MATH 18,B01,083748,Rideout; David Porter,4,0,37,33
1657274971887,MATH 18,B02,083749,Rideout; David Porter,4,0,36,32
1657274971887,MATH 18,B03,083750,Rideout; David Porter,2,0,37,35
1657274971887,MATH 18,B04,083751,Rideout; David Porter,6,0,36,30
1657274971887,MATH 18,B05,093473,Rideout; David Porter,5,0,36,31
1657274971887,MATH 18,B06,093474,Rideout; David Porter,5,0,36,31
1657274977911,MATH 20A,A01,083754,Zheng; Zequn,14,0,40,26
1657274983937,MATH 20B,A01,083756,Briones; Jor-el Thomas Caparas,3,0,36,33
1657274983937,MATH 20B,A02,083757,Briones; Jor-el Thomas Caparas,1,0,36,35
1657274983937,MATH 20B,A03,093475,Briones; Jor-el Thomas Caparas,2,0,36,34
1657274989965,MATH 20C,A01,083760,Briones; Jor-el Thomas Caparas,1,0,35,34
1657274989965,MATH 20C,A02,083761,Briones; Jor-el Thomas Caparas,8,0,35,27
1657274989965,MATH 20C,A03,093476,Briones; Jor-el Thomas Caparas,0,1,36,36
1657274989965,MATH 20C,B01,083762,Bach; Quang Tran,1,0,30,29
1657274995991,MATH 20D,A01,083765,Tran; Brian Kha,5,0,30,25
1657274995991,MATH 20D,A02,083766,Tran; Brian Kha,5,0,30,25
1657274995991,MATH 20D,A03,083767,Tran; Brian Kha,4,0,30,26
1657275002017,MATH 20E,A01,083771,Ganguly; Soumya,7,0,32,25
1657275002017,MATH 20E,A02,083772,Ganguly; Soumya,7,0,32,25
1657275002017,MATH 20E,B01,083773,Ciotti; Benjamin,19,0,35,16
1657275002017,MATH 20E,B02,083774,Ciotti; Benjamin,17,0,35,18
1657275008042,MATH 103A,A01,083777,Greenfeld; Be'Eri,3,0,36,33
1657275008042,MATH 103A,A02,083778,Greenfeld; Be'Eri,5,0,36,31
1657275008042,MATH 103A,A03,093561,Greenfeld; Be'Eri,4,0,36,32
1657275008042,MATH 103A,B01,083779,Greenfeld; Be'Eri,6,0,36,30
1657275008042,MATH 103A,B02,083780,Greenfeld; Be'Eri,3,0,36,33
1657275008042,MATH 103A,B03,093562,Greenfeld; Be'Eri,3,0,36,33
1657275014073,MATH 105,A01,085443,Carter; Anne Toulson,15,0,35,20
1657275014073,MATH 105,A02,093477,Carter; Anne Toulson,20,0,35,15
1657275020099,MATH 109,A01,083213,Ganzberger; Geoffrey Michael,2,0,34,32
1657275020099,MATH 109,A02,083214,Ganzberger; Geoffrey Michael,4,0,34,30
1657275020099,MATH 109,A03,093478,Ganzberger; Geoffrey Michael,2,0,34,32
1657275020099,MATH 109,B01,083215,Ganzberger; Geoffrey Michael,1,0,32,31
1657275020099,MATH 109,B02,083216,Ganzberger; Geoffrey Michael,1,0,32,31
1657275020099,MATH 109,B03,093479,Ganzberger; Geoffrey Michael,8,0,32,24
1657275026125,MATH 142A,A01,083219,Chow; Bennett,7,0,32,25
1657275026125,MATH 142A,A02,083220,Chow; Bennett,10,0,32,22
1657275026125,MATH 142A,A03,093480,Chow; Bennett,7,0,32,25
1657275026125,MATH 142A,B03,093481,Chow; Bennett,8,0,32,24
1657275026125,MATH 142A,B04,093558,Chow; Bennett,12,0,32,20
1657275026125,MATH 142A,B05,093559,Chow; Bennett,6,0,32,26
1657275032154,MATH 193A,A01,083224,Rotar; Vladimir,7,0,34,27
1657275032154,MATH 193A,A02,083225,Rotar; Vladimir,6,0,34,28
1657275032154,MATH 193A,A03,083781,Rotar; Vladimir,2,0,34,32
1657275032154,MATH 193A,A04,083782,Rotar; Vladimir,8,0,34,26
1657275032154,MATH 193A,A05,093482,Rotar; Vladimir,6,0,34,28
1657275038178,MATH 197,001,091859,McAuley; Julian John,9999,0,9999,0
1657275038178,MATH 197,002,095566,Kedlaya; Kiran S.,9997,0,9999,2
1657275038178,MATH 197,003,095567,Xiao; Ming,9999,0,9999,0
1657275038178,MATH 197,004,095571,Perols; Johan Lars,9998,0,9999,1
1657275045233,COGS 9,A01,083615,Shannon; Kyle Michael,8,0,75,67
1657275051258,COGS 11,A01,083617,Boyle; Mary E. T.,22,0,48,26
1657275057282,COGS 13,A01,083071,Bastos; Amalia Pinkusfeld,9,0,71,62
1657275063310,COGS 14A,A01,092681,Semenuks; Arturs,2,1,100,98
1657275069336,COGS 14B,A01,083073,Cheng; Tzu-Han,6,0,63,57
1657275075364,COGS 17,A01,092677,Semenuks; Arturs,5,0,81,76
1657275081396,COGS 100,A01,083619,Allen; Michael Gordon,16,0,70,54
1657275087422,COGS 101A,A01,083621,Davis; Joshua Daniel,9,0,68,59
1657275093446,COGS 101B,A01,091572,Allen; Michael Gordon,11,0,65,54
1657275099479,COGS 101C,A01,083625,Delgado; Tania,17,0,35,18
1657275105506,COGS 107A,A01,083627,Boyle; Mary E. T.,13,0,60,47
1657275111532,COGS 118A,A01,083075,Gupta; Anjum,18,0,76,58
1657275117556,CSE 3,A50,083646,Miranda; Gregory Joseph,24,0,50,26
1657275123586,CSE 8A,A50,083650,Miranda; Gregory Joseph,17,1,56,39
1657275129611,CSE 11,A01,083080,Cao; Yingjun,5,15,40,35
1657275135637,CSE 12,A01,083652,Krause-Levy; Sophia Louisa,26,1,120,94
1657275141671,CSE 15L,A01,083654,Morris; Justin Loren,9,0,50,41
1657275141671,CSE 15L,A02,083655,Morris; Justin Loren,9,0,50,41
1657275147695,CSE 20,A01,083657,Tran; Khoa Dang,38,0,80,42
1657275153730,CSE 21,A01,095574,Bach; Quang Tran,22,0,48,26
1657275159762,CSE 30,A01,083084,Eldon; John,4,0,80,76
1657275159762,CSE 30,B01,095061,Bhaskar; Nishant,8,0,50,42
1657275165790,CSE 100,A01,083659,Cao; Yingjun,4,4,70,66
1657275171819,CSE 134B,A01,083661,Powell; Thomas Allan,21,0,100,79
1657275177843,CSE 140,A01,083663,Gungor; Onat,13,0,85,72
1657275183868,CSE 140L,A01,083088,Eldon; John,19,0,100,81
1657275189892,CSE 175,A01,083665,Kumar; Rakesh,3,0,25,22
1657275195916,CSE 190,A00,092507,Dubnov; Shlomo,7,0,20,13
1657275201946,ECE 45,A01,083139,Congero; Spencer William,5,0,75,70
1657275207974,ECE 65,A50,083695,Saad; Andrew S,12,0,30,18
1657275207974,ECE 65,A51,095125,Saad; Andrew S,25,0,26,1
1657275213998,ECE 109,A01,091882,Touri; Behrouz,19,0,70,51
1657275220021,ECE 180,A00,083140,Abi Samra; Nicholas Camill,1,0,30,29
1657275220021,ECE 180,B00,083141,Abi Samra; Nicholas Camill,0,0,30,30
1657275226047,MATH 10A,A01,083735,Patchell; Gregory David,2,0,30,28
1657275226047,MATH 10A,A02,083736,Patchell; Gregory David,20,0,30,10
1657275226047,MATH 10A,A03,083737,Patchell; Gregory David,16,0,30,14
1657275232075,MATH 10B,A01,083207,Lim; Seonhee,7,0,34,27
1657275232075,MATH 10B,A02,083208,Lim; Seonhee,9,0,35,26
1657275232075,MATH 10B,A03,093472,Lim; Seonhee,5,0,34,29
1657275232075,MATH 10B,B01,083739,Sinha; Shubham,11,0,30,19
1657275238101,MATH 18,A01,083743,Cinel; Cameron Alexander,6,0,30,24
1657275238101,MATH 18,A02,083744,Cinel; Cameron Alexander,17,0,30,13
1657275238101,MATH 18,A03,083745,Cinel; Cameron Alexander,8,0,30,22
1657275238101,MATH 18,B01,083748,Rideout; David Porter,4,0,37,33
1657275238101,MATH 18,B02,083749,Rideout; David Porter,4,0,36,32
1657275238101,MATH 18,B03,083750,Rideout; David Porter,2,0,37,35
1657275238101,MATH 18,B04,083751,Rideout; David Porter,6,0,36,30
1657275238101,MATH 18,B05,093473,Rideout; David Porter,5,0,36,31
1657275238101,MATH 18,B06,093474,Rideout; David Porter,5,0,36,31
1657275244129,MATH 20A,A01,083754,Zheng; Zequn,14,0,40,26
1657275250154,MATH 20B,A01,083756,Briones; Jor-el Thomas Caparas,3,0,36,33
1657275250154,MATH 20B,A02,083757,Briones; Jor-el Thomas Caparas,1,0,36,35
1657275250154,MATH 20B,A03,093475,Briones; Jor-el Thomas Caparas,2,0,36,34
1657275256189,MATH 20C,A01,083760,Briones; Jor-el Thomas Caparas,1,0,35,34
1657275256189,MATH 20C,A02,083761,Briones; Jor-el Thomas Caparas,8,0,35,27
1657275256189,MATH 20C,A03,093476,Briones; Jor-el Thomas Caparas,0,1,36,36
1657275256189,MATH 20C,B01,083762,Bach; Quang Tran,1,0,30,29
1657275262221,MATH 20D,A01,083765,Tran; Brian Kha,5,0,30,25
1657275262221,MATH 20D,A02,083766,Tran; Brian Kha,5,0,30,25
1657275262221,MATH 20D,A03,083767,Tran; Brian Kha,4,0,30,26
1657275268246,MATH 20E,A01,083771,Ganguly; Soumya,7,0,32,25
1657275268246,MATH 20E,A02,083772,Ganguly; Soumya,7,0,32,25
1657275268246,MATH 20E,B01,083773,Ciotti; Benjamin,19,0,35,16
1657275268246,MATH 20E,B02,083774,Ciotti; Benjamin,17,0,35,18
1657275274271,MATH 103A,A01,083777,Greenfeld; Be'Eri,3,0,36,33
1657275274271,MATH 103A,A02,083778,Greenfeld; Be'Eri,5,0,36,31
1657275274271,MATH 103A,A03,093561,Greenfeld; Be'Eri,4,0,36,32
1657275274271,MATH 103A,B01,083779,Greenfeld; Be'Eri,6,0,36,30
1657275274271,MATH 103A,B02,083780,Greenfeld; Be'Eri,3,0,36,33
1657275274271,MATH 103A,B03,093562,Greenfeld; Be'Eri,3,0,36,33
1657275280295,MATH 105,A01,085443,Carter; Anne Toulson,15,0,35,20
1657275280295,MATH 105,A02,093477,Carter; Anne Toulson,20,0,35,15
1657275286318,MATH 109,A01,083213,Ganzberger; Geoffrey Michael,2,0,34,32
1657275286318,MATH 109,A02,083214,Ganzberger; Geoffrey Michael,4,0,34,30
1657275286318,MATH 109,A03,093478,Ganzberger; Geoffrey Michael,2,0,34,32
1657275286318,MATH 109,B01,083215,Ganzberger; Geoffrey Michael,1,0,32,31
1657275286318,MATH 109,B02,083216,Ganzberger; Geoffrey Michael,1,0,32,31
1657275286318,MATH 109,B03,093479,Ganzberger; Geoffrey Michael,8,0,32,24
1657275292350,MATH 142A,A01,083219,Chow; Bennett,7,0,32,25
1657275292350,MATH 142A,A02,083220,Chow; Bennett,10,0,32,22
1657275292350,MATH 142A,A03,093480,Chow; Bennett,7,0,32,25
1657275292350,MATH 142A,B03,093481,Chow; Bennett,8,0,32,24
1657275292350,MATH 142A,B04,093558,Chow; Bennett,12,0,32,20
1657275292350,MATH 142A,B05,093559,Chow; Bennett,6,0,32,26
1657275298376,MATH 193A,A01,083224,Rotar; Vladimir,7,0,34,27
1657275298376,MATH 193A,A02,083225,Rotar; Vladimir,6,0,34,28
1657275298376,MATH 193A,A03,083781,Rotar; Vladimir,2,0,34,32
1657275298376,MATH 193A,A04,083782,Rotar; Vladimir,8,0,34,26
1657275298376,MATH 193A,A05,093482,Rotar; Vladimir,6,0,34,28
1657275304399,MATH 197,001,091859,McAuley; Julian John,9999,0,9999,0
1657275304399,MATH 197,002,095566,Kedlaya; Kiran S.,9997,0,9999,2
1657275304399,MATH 197,003,095567,Xiao; Ming,9999,0,9999,0
1657275304399,MATH 197,004,095571,Perols; Johan Lars,9998,0,9999,1
1657275311468,COGS 9,A01,083615,Shannon; Kyle Michael,8,0,75,67
1657275317495,COGS 11,A01,083617,Boyle; Mary E. T.,22,0,48,26
1657275323525,COGS 13,A01,083071,Bastos; Amalia Pinkusfeld,9,0,71,62
1657275329555,COGS 14A,A01,092681,Semenuks; Arturs,2,1,100,98
1657275335579,COGS 14B,A01,083073,Cheng; Tzu-Han,6,0,63,57
1657275341603,COGS 17,A01,092677,Semenuks; Arturs,5,0,81,76
1657275347631,COGS 100,A01,083619,Allen; Michael Gordon,16,0,70,54
1657275353655,COGS 101A,A01,083621,Davis; Joshua Daniel,9,0,68,59
1657275359680,COGS 101B,A01,091572,Allen; Michael Gordon,11,0,65,54
1657275365708,COGS 101C,A01,083625,Delgado; Tania,17,0,35,18
1657275371739,COGS 107A,A01,083627,Boyle; Mary E. T.,13,0,60,47
1657275377768,COGS 118A,A01,083075,Gupta; Anjum,18,0,76,58
1657275383794,CSE 3,A50,083646,Miranda; Gregory Joseph,24,0,50,26
1657275389822,CSE 8A,A50,083650,Miranda; Gregory Joseph,17,1,56,39
1657275395847,CSE 11,A01,083080,Cao; Yingjun,5,15,40,35
1657275401869,CSE 12,A01,083652,Krause-Levy; Sophia Louisa,26,1,120,94
1657275407895,CSE 15L,A01,083654,Morris; Justin Loren,9,0,50,41
1657275407895,CSE 15L,A02,083655,Morris; Justin Loren,9,0,50,41
1657275413924,CSE 20,A01,083657,Tran; Khoa Dang,38,0,80,42
1657275419948,CSE 21,A01,095574,Bach; Quang Tran,22,0,48,26
1657275425972,CSE 30,A01,083084,Eldon; John,4,0,80,76
1657275425972,CSE 30,B01,095061,Bhaskar; Nishant,8,0,50,42
1657275431996,CSE 100,A01,083659,Cao; Yingjun,4,4,70,66
1657275438018,CSE 134B,A01,083661,Powell; Thomas Allan,21,0,100,79
1657275444043,CSE 140,A01,083663,Gungor; Onat,13,0,85,72
1657275450067,CSE 140L,A01,083088,Eldon; John,19,0,100,81
1657275456091,CSE 175,A01,083665,Kumar; Rakesh,3,0,25,22
1657275462127,CSE 190,A00,092507,Dubnov; Shlomo,7,0,20,13
1657275468154,ECE 45,A01,083139,Congero; Spencer William,5,0,75,70
1657275474184,ECE 65,A50,083695,Saad; Andrew S,12,0,30,18
1657275474184,ECE 65,A51,095125,Saad; Andrew S,25,0,26,1
1657275480206,ECE 109,A01,091882,Touri; Behrouz,19,0,70,51
1657275486300,ECE 180,A00,083140,Abi Samra; Nicholas Camill,1,0,30,29
1657275486300,ECE 180,B00,083141,Abi Samra; Nicholas Camill,0,0,30,30
1657275492334,MATH 10A,A01,083735,Patchell; Gregory David,2,0,30,28
1657275492334,MATH 10A,A02,083736,Patchell; Gregory David,20,0,30,10
1657275492334,MATH 10A,A03,083737,Patchell; Gregory David,16,0,30,14
1657275498357,MATH 10B,A01,083207,Lim; Seonhee,7,0,34,27
1657275498357,MATH 10B,A02,083208,Lim; Seonhee,9,0,35,26
1657275498357,MATH 10B,A03,093472,Lim; Seonhee,5,0,34,29
1657275498357,MATH 10B,B01,083739,Sinha; Shubham,11,0,30,19
1657275504382,MATH 18,A01,083743,Cinel; Cameron Alexander,6,0,30,24
1657275504382,MATH 18,A02,083744,Cinel; Cameron Alexander,17,0,30,13
1657275504382,MATH 18,A03,083745,Cinel; Cameron Alexander,8,0,30,22
1657275504382,MATH 18,B01,083748,Rideout; David Porter,4,0,37,33
1657275504382,MATH 18,B02,083749,Rideout; David Porter,4,0,36,32
1657275504382,MATH 18,B03,083750,Rideout; David Porter,2,0,37,35
1657275504382,MATH 18,B04,083751,Rideout; David Porter,6,0,36,30
1657275504382,MATH 18,B05,093473,Rideout; David Porter,5,0,36,31
1657275504382,MATH 18,B06,093474,Rideout; David Porter,5,0,36,31
1657275510409,MATH 20A,A01,083754,Zheng; Zequn,14,0,40,26
1657275516434,MATH 20B,A01,083756,Briones; Jor-el Thomas Caparas,3,0,36,33
1657275516434,MATH 20B,A02,083757,Briones; Jor-el Thomas Caparas,1,0,36,35
1657275516434,MATH 20B,A03,093475,Briones; Jor-el Thomas Caparas,2,0,36,34
1657275522457,MATH 20C,A01,083760,Briones; Jor-el Thomas Caparas,1,0,35,34
1657275522457,MATH 20C,A02,083761,Briones; Jor-el Thomas Caparas,8,0,35,27
1657275522457,MATH 20C,A03,093476,Briones; Jor-el Thomas Caparas,0,1,36,36
1657275522457,MATH 20C,B01,083762,Bach; Quang Tran,1,0,30,29
1657275528479,MATH 20D,A01,083765,Tran; Brian Kha,5,0,30,25
1657275528479,MATH 20D,A02,083766,Tran; Brian Kha,5,0,30,25
1657275528479,MATH 20D,A03,083767,Tran; Brian Kha,4,0,30,26
1657275534510,MATH 20E,A01,083771,Ganguly; Soumya,7,0,32,25
1657275534510,MATH 20E,A02,083772,Ganguly; Soumya,7,0,32,25
1657275534510,MATH 20E,B01,083773,Ciotti; Benjamin,19,0,35,16
1657275534510,MATH 20E,B02,083774,Ciotti; Benjamin,17,0,35,18
1657275540539,MATH 103A,A01,083777,Greenfeld; Be'Eri,3,0,36,33
1657275540539,MATH 103A,A02,083778,Greenfeld; Be'Eri,5,0,36,31
1657275540539,MATH 103A,A03,093561,Greenfeld; Be'Eri,4,0,36,32
1657275540539,MATH 103A,B01,083779,Greenfeld; Be'Eri,6,0,36,30
1657275540539,MATH 103A,B02,083780,Greenfeld; Be'Eri,3,0,36,33
1657275540539,MATH 103A,B03,093562,Greenfeld; Be'Eri,3,0,36,33
1657275546568,MATH 105,A01,085443,Carter; Anne Toulson,15,0,35,20
1657275546568,MATH 105,A02,093477,Carter; Anne Toulson,20,0,35,15
1657275552597,MATH 109,A01,083213,Ganzberger; Geoffrey Michael,2,0,34,32
1657275552597,MATH 109,A02,083214,Ganzberger; Geoffrey Michael,4,0,34,30
1657275552597,MATH 109,A03,093478,Ganzberger; Geoffrey Michael,2,0,34,32
1657275552597,MATH 109,B01,083215,Ganzberger; Geoffrey Michael,1,0,32,31
1657275552597,MATH 109,B02,083216,Ganzberger; Geoffrey Michael,1,0,32,31
1657275552597,MATH 109,B03,093479,Ganzberger; Geoffrey Michael,8,0,32,24
1657275558627,MATH 142A,A01,083219,Chow; Bennett,7,0,32,25
1657275558627,MATH 142A,A02,083220,Chow; Bennett,10,0,32,22
1657275558627,MATH 142A,A03,093480,Chow; Bennett,7,0,32,25
1657275558627,MATH 142A,B03,093481,Chow; Bennett,8,0,32,24
1657275558627,MATH 142A,B04,093558,Chow; Bennett,12,0,32,20
1657275558627,MATH 142A,B05,093559,Chow; Bennett,6,0,32,26
1657275564652,MATH 193A,A01,083224,Rotar; Vladimir,7,0,34,27
1657275564652,MATH 193A,A02,083225,Rotar; Vladimir,6,0,34,28
1657275564652,MATH 193A,A03,083781,Rotar; Vladimir,2,0,34,32
1657275564652,MATH 193A,A04,083782,Rotar; Vladimir,8,0,34,26
1657275564652,MATH 193A,A05,093482,Rotar; Vladimir,6,0,34,28
1657275570678,MATH 197,001,091859,McAuley; Julian John,9999,0,9999,0
1657275570678,MATH 197,002,095566,Kedlaya; Kiran S.,9997,0,9999,2
1657275570678,MATH 197,003,095567,Xiao; Ming,9999,0,9999,0
1657275570678,MATH 197,004,095571,Perols; Johan Lars,9998,0,9999,1
1657275577752,COGS 9,A01,083615,Shannon; Kyle Michael,8,0,75,67
1657275583774,COGS 11,A01,083617,Boyle; Mary E. T.,22,0,48,26
1657275589796,COGS 13,A01,083071,Bastos; Amalia Pinkusfeld,9,0,71,62
1657275595823,COGS 14A,A01,092681,Semenuks; Arturs,2,1,100,98
1657275601846,COGS 14B,A01,083073,Cheng; Tzu-Han,6,0,63,57
1657275607872,COGS 17,A01,092677,Semenuks; Arturs,5,0,81,76
1657275613900,COGS 100,A01,083619,Allen; Michael Gordon,16,0,70,54
1657275619923,COGS 101A,A01,083621,Davis; Joshua Daniel,9,0,68,59
1657275625950,COGS 101B,A01,091572,Allen; Michael Gordon,11,0,65,54
1657275631982,COGS 101C,A01,083625,Delgado; Tania,17,0,35,18
1657275638008,COGS 107A,A01,083627,Boyle; Mary E. T.,13,0,60,47
1657275644032,COGS 118A,A01,083075,Gupta; Anjum,18,0,76,58
1657275650060,CSE 3,A50,083646,Miranda; Gregory Joseph,24,0,50,26
1657275656090,CSE 8A,A50,083650,Miranda; Gregory Joseph,17,1,56,39
1657275662119,CSE 11,A01,083080,Cao; Yingjun,5,15,40,35
1657275668150,CSE 12,A01,083652,Krause-Levy; Sophia Louisa,26,1,120,94
1657275674178,CSE 15L,A01,083654,Morris; Justin Loren,9,0,50,41
1657275674178,CSE 15L,A02,083655,Morris; Justin Loren,9,0,50,41
1657275680205,CSE 20,A01,083657,Tran; Khoa Dang,38,0,80,42
1657275686227,CSE 21,A01,095574,Bach; Quang Tran,22,0,48,26
1657275692248,CSE 30,A01,083084,Eldon; John,4,0,80,76
1657275692248,CSE 30,B01,095061,Bhaskar; Nishant,8,0,50,42
1657275698276,CSE 100,A01,083659,Cao; Yingjun,4,4,70,66
1657275704300,CSE 134B,A01,083661,Powell; Thomas Allan,21,0,100,79
1657275710323,CSE 140,A01,083663,Gungor; Onat,13,0,85,72
1657275716347,CSE 140L,A01,083088,Eldon; John,19,0,100,81
1657275722372,CSE 175,A01,083665,Kumar; Rakesh,3,0,25,22
1657275728399,CSE 190,A00,092507,Dubnov; Shlomo,7,0,20,13
1657275734426,ECE 45,A01,083139,Congero; Spencer William,5,0,75,70
1657275740455,ECE 65,A50,083695,Saad; Andrew S,12,0,30,18
1657275740455,ECE 65,A51,095125,Saad; Andrew S,25,0,26,1
1657275746484,ECE 109,A01,091882,Touri; Behrouz,19,0,70,51
1657275752512,ECE 180,A00,083140,Abi Samra; Nicholas Camill,1,0,30,29
1657275752512,ECE 180,B00,083141,Abi Samra; Nicholas Camill,0,0,30,30
1657275758536,MATH 10A,A01,083735,Patchell; Gregory David,2,0,30,28
1657275758536,MATH 10A,A02,083736,Patchell; Gregory David,20,0,30,10
1657275758536,MATH 10A,A03,083737,Patchell; Gregory David,16,0,30,14
1657275764559,MATH 10B,A01,083207,Lim; Seonhee,7,0,34,27
1657275764559,MATH 10B,A02,083208,Lim; Seonhee,9,0,35,26
1657275764559,MATH 10B,A03,093472,Lim; Seonhee,5,0,34,29
1657275764559,MATH 10B,B01,083739,Sinha; Shubham,11,0,30,19
1657275770593,MATH 18,A01,083743,Cinel; Cameron Alexander,6,0,30,24
1657275770593,MATH 18,A02,083744,Cinel; Cameron Alexander,17,0,30,13
1657275770593,MATH 18,A03,083745,Cinel; Cameron Alexander,8,0,30,22
1657275770593,MATH 18,B01,083748,Rideout; David Porter,4,0,37,33
1657275770593,MATH 18,B02,083749,Rideout; David Porter,4,0,36,32
1657275770593,MATH 18,B03,083750,Rideout; David Porter,2,0,37,35
1657275770593,MATH 18,B04,083751,Rideout; David Porter,6,0,36,30
1657275770593,MATH 18,B05,093473,Rideout; David Porter,5,0,36,31
1657275770593,MATH 18,B06,093474,Rideout; David Porter,5,0,36,31
1657275776622,MATH 20A,A01,083754,Zheng; Zequn,14,0,40,26
1657275782644,MATH 20B,A01,083756,Briones; Jor-el Thomas Caparas,3,0,36,33
1657275782644,MATH 20B,A02,083757,Briones; Jor-el Thomas Caparas,1,0,36,35
1657275782644,MATH 20B,A03,093475,Briones; Jor-el Thomas Caparas,2,0,36,34
1657275788672,MATH 20C,A01,083760,Briones; Jor-el Thomas Caparas,1,0,35,34
1657275788672,MATH 20C,A02,083761,Briones; Jor-el Thomas Caparas,8,0,35,27
1657275788672,MATH 20C,A03,093476,Briones; Jor-el Thomas Caparas,0,1,36,36
1657275788672,MATH 20C,B01,083762,Bach; Quang Tran,1,0,30,29
1657275794700,MATH 20D,A01,083765,Tran; Brian Kha,5,0,30,25
1657275794700,MATH 20D,A02,083766,Tran; Brian Kha,5,0,30,25
1657275794700,MATH 20D,A03,083767,Tran; Brian Kha,4,0,30,26
1657275800728,MATH 20E,A01,083771,Ganguly; Soumya,7,0,32,25
1657275800728,MATH 20E,A02,083772,Ganguly; Soumya,7,0,32,25
1657275800728,MATH 20E,B01,083773,Ciotti; Benjamin,19,0,35,16
1657275800728,MATH 20E,B02,083774,Ciotti; Benjamin,17,0,35,18
1657275806753,MATH 103A,A01,083777,Greenfeld; Be'Eri,3,0,36,33
1657275806753,MATH 103A,A02,083778,Greenfeld; Be'Eri,5,0,36,31
1657275806753,MATH 103A,A03,093561,Greenfeld; Be'Eri,4,0,36,32
1657275806753,MATH 103A,B01,083779,Greenfeld; Be'Eri,6,0,36,30
1657275806753,MATH 103A,B02,083780,Greenfeld; Be'Eri,3,0,36,33
1657275806753,MATH 103A,B03,093562,Greenfeld; Be'Eri,3,0,36,33
1657275812776,MATH 105,A01,085443,Carter; Anne Toulson,15,0,35,20
1657275812776,MATH 105,A02,093477,Carter; Anne Toulson,20,0,35,15
1657275818805,MATH 109,A01,083213,Ganzberger; Geoffrey Michael,2,0,34,32
1657275818805,MATH 109,A02,083214,Ganzberger; Geoffrey Michael,4,0,34,30
1657275818805,MATH 109,A03,093478,Ganzberger; Geoffrey Michael,2,0,34,32
1657275818805,MATH 109,B01,083215,Ganzberger; Geoffrey Michael,1,0,32,31
1657275818805,MATH 109,B02,083216,Ganzberger; Geoffrey Michael,1,0,32,31
1657275818805,MATH 109,B03,093479,Ganzberger; Geoffrey Michael,8,0,32,24
1657275824829,MATH 142A,A01,083219,Chow; Bennett,7,0,32,25
1657275824829,MATH 142A,A02,083220,Chow; Bennett,10,0,32,22
1657275824829,MATH 142A,A03,093480,Chow; Bennett,7,0,32,25
1657275824829,MATH 142A,B03,093481,Chow; Bennett,8,0,32,24
1657275824829,MATH 142A,B04,093558,Chow; Bennett,12,0,32,20
1657275824829,MATH 142A,B05,093559,Chow; Bennett,6,0,32,26
1657275830854,MATH 193A,A01,083224,Rotar; Vladimir,7,0,34,27
1657275830854,MATH 193A,A02,083225,Rotar; Vladimir,6,0,34,28
1657275830854,MATH 193A,A03,083781,Rotar; Vladimir,2,0,34,32
1657275830854,MATH 193A,A04,083782,Rotar; Vladimir,8,0,34,26
1657275830854,MATH 193A,A05,093482,Rotar; Vladimir,6,0,34,28
1657275836881,MATH 197,001,091859,McAuley; Julian John,9999,0,9999,0
1657275836881,MATH 197,002,095566,Kedlaya; Kiran S.,9997,0,9999,2
1657275836881,MATH 197,003,095567,Xiao; Ming,9999,0,9999,0
1657275836881,MATH 197,004,095571,Perols; Johan Lars,9998,0,9999,1
1657275843941,COGS 9,A01,083615,Shannon; Kyle Michael,8,0,75,67
1657275849965,COGS 11,A01,083617,Boyle; Mary E. T.,22,0,48,26
1657275855990,COGS 13,A01,083071,Bastos; Amalia Pinkusfeld,9,0,71,62
1657275862019,COGS 14A,A01,092681,Semenuks; Arturs,2,1,100,98
1657275868043,COGS 14B,A01,083073,Cheng; Tzu-Han,6,0,63,57
1657275874067,COGS 17,A01,092677,Semenuks; Arturs,5,0,81,76
1657275880093,COGS 100,A01,083619,Allen; Michael Gordon,16,0,70,54
1657275886135,COGS 101A,A01,083621,Davis; Joshua Daniel,9,0,68,59
1657275892167,COGS 101B,A01,091572,Allen; Michael Gordon,11,0,65,54
1657275898193,COGS 101C,A01,083625,Delgado; Tania,17,0,35,18
1657275904223,COGS 107A,A01,083627,Boyle; Mary E. T.,13,0,60,47
1657275910245,COGS 118A,A01,083075,Gupta; Anjum,18,0,76,58
1657275916268,CSE 3,A50,083646,Miranda; Gregory Joseph,24,0,50,26
1657275922303,CSE 8A,A50,083650,Miranda; Gregory Joseph,17,1,56,39
1657275928330,CSE 11,A01,083080,Cao; Yingjun,5,15,40,35
1657275934353,CSE 12,A01,083652,Krause-Levy; Sophia Louisa,26,1,120,94
1657275940377,CSE 15L,A01,083654,Morris; Justin Loren,9,0,50,41
1657275940377,CSE 15L,A02,083655,Morris; Justin Loren,9,0,50,41
1657275946406,CSE 20,A01,083657,Tran; Khoa Dang,38,0,80,42
1657275952429,CSE 21,A01,095574,Bach; Quang Tran,22,0,48,26
1657275958458,CSE 30,A01,083084,Eldon; John,4,0,80,76
1657275958458,CSE 30,B01,095061,Bhaskar; Nishant,8,0,50,42
1657275964487,CSE 100,A01,083659,Cao; Yingjun,4,4,70,66
1657275970512,CSE 134B,A01,083661,Powell; Thomas Allan,21,0,100,79
1657275976534,CSE 140,A01,083663,Gungor; Onat,13,0,85,72
1657275982558,CSE 140L,A01,083088,Eldon; John,19,0,100,81
1657275988585,CSE 175,A01,083665,Kumar; Rakesh,3,0,25,22
1657275994608,CSE 190,A00,092507,Dubnov; Shlomo,7,0,20,13
1657276000635,ECE 45,A01,083139,Congero; Spencer William,5,0,75,70
1657276006661,ECE 65,A50,083695,Saad; Andrew S,12,0,30,18
1657276006661,ECE 65,A51,095125,Saad; Andrew S,25,0,26,1
1657276012684,ECE 109,A01,091882,Touri; Behrouz,19,0,70,51
1657276018712,ECE 180,A00,083140,Abi Samra; Nicholas Camill,1,0,30,29
1657276018712,ECE 180,B00,083141,Abi Samra; Nicholas Camill,0,0,30,30
1657276024741,MATH 10A,A01,083735,Patchell; Gregory David,2,0,30,28
1657276024741,MATH 10A,A02,083736,Patchell; Gregory David,20,0,30,10
1657276024741,MATH 10A,A03,083737,Patchell; Gregory David,16,0,30,14
1657276030772,MATH 10B,A01,083207,Lim; Seonhee,7,0,34,27
1657276030772,MATH 10B,A02,083208,Lim; Seonhee,9,0,35,26
1657276030772,MATH 10B,A03,093472,Lim; Seonhee,5,0,34,29
1657276030772,MATH 10B,B01,083739,Sinha; Shubham,11,0,30,19
1657276036803,MATH 18,A01,083743,Cinel; Cameron Alexander,6,0,30,24
1657276036803,MATH 18,A02,083744,Cinel; Cameron Alexander,17,0,30,13
1657276036803,MATH 18,A03,083745,Cinel; Cameron Alexander,8,0,30,22
1657276036803,MATH 18,B01,083748,Rideout; David Porter,4,0,37,33
1657276036803,MATH 18,B02,083749,Rideout; David Porter,4,0,36,32
1657276036803,MATH 18,B03,083750,Rideout; David Porter,2,0,37,35
1657276036803,MATH 18,B04,083751,Rideout; David Porter,6,0,36,30
1657276036803,MATH 18,B05,093473,Rideout; David Porter,5,0,36,31
1657276036803,MATH 18,B06,093474,Rideout; David Porter,5,0,36,31
1657276042828,MATH 20A,A01,083754,Zheng; Zequn,14,0,40,26
1657276048856,MATH 20B,A01,083756,Briones; Jor-el Thomas Caparas,3,0,36,33
1657276048856,MATH 20B,A02,083757,Briones; Jor-el Thomas Caparas,1,0,36,35
1657276048856,MATH 20B,A03,093475,Briones; Jor-el Thomas Caparas,2,0,36,34
1657276054881,MATH 20C,A01,083760,Briones; Jor-el Thomas Caparas,1,0,35,34
1657276054881,MATH 20C,A02,083761,Briones; Jor-el Thomas Caparas,8,0,35,27
1657276054881,MATH 20C,A03,093476,Briones; Jor-el Thomas Caparas,0,1,36,36
1657276054881,MATH 20C,B01,083762,Bach; Quang Tran,1,0,30,29
1657276060904,MATH 20D,A01,083765,Tran; Brian Kha,5,0,30,25
1657276060904,MATH 20D,A02,083766,Tran; Brian Kha,5,0,30,25
1657276060904,MATH 20D,A03,083767,Tran; Brian Kha,4,0,30,26
1657276066929,MATH 20E,A01,083771,Ganguly; Soumya,7,0,32,25
1657276066929,MATH 20E,A02,083772,Ganguly; Soumya,7,0,32,25
1657276066929,MATH 20E,B01,083773,Ciotti; Benjamin,19,0,35,16
1657276066929,MATH 20E,B02,083774,Ciotti; Benjamin,17,0,35,18
1657276072951,MATH 103A,A01,083777,Greenfeld; Be'Eri,3,0,36,33
1657276072951,MATH 103A,A02,083778,Greenfeld; Be'Eri,5,0,36,31
1657276072951,MATH 103A,A03,093561,Greenfeld; Be'Eri,4,0,36,32
1657276072951,MATH 103A,B01,083779,Greenfeld; Be'Eri,6,0,36,30
1657276072951,MATH 103A,B02,083780,Greenfeld; Be'Eri,3,0,36,33
1657276072951,MATH 103A,B03,093562,Greenfeld; Be'Eri,3,0,36,33
1657276078981,MATH 105,A01,085443,Carter; Anne Toulson,15,0,35,20
1657276078981,MATH 105,A02,093477,Carter; Anne Toulson,20,0,35,15
1657276085101,MATH 109,A01,083213,Ganzberger; Geoffrey Michael,2,0,34,32
1657276085101,MATH 109,A02,083214,Ganzberger; Geoffrey Michael,4,0,34,30
1657276085101,MATH 109,A03,093478,Ganzberger; Geoffrey Michael,2,0,34,32
1657276085101,MATH 109,B01,083215,Ganzberger; Geoffrey Michael,1,0,32,31
1657276085101,MATH 109,B02,083216,Ganzberger; Geoffrey Michael,1,0,32,31
1657276085101,MATH 109,B03,093479,Ganzberger; Geoffrey Michael,8,0,32,24
1657276091127,MATH 142A,A01,083219,Chow; Bennett,7,0,32,25
1657276091127,MATH 142A,A02,083220,Chow; Bennett,10,0,32,22
1657276091127,MATH 142A,A03,093480,Chow; Bennett,7,0,32,25
1657276091127,MATH 142A,B03,093481,Chow; Bennett,8,0,32,24
1657276091127,MATH 142A,B04,093558,Chow; Bennett,12,0,32,20
1657276091127,MATH 142A,B05,093559,Chow; Bennett,6,0,32,26
1657276097155,MATH 193A,A01,083224,Rotar; Vladimir,7,0,34,27
1657276097155,MATH 193A,A02,083225,Rotar; Vladimir,6,0,34,28
1657276097155,MATH 193A,A03,083781,Rotar; Vladimir,2,0,34,32
1657276097155,MATH 193A,A04,083782,Rotar; Vladimir,8,0,34,26
1657276097155,MATH 193A,A05,093482,Rotar; Vladimir,6,0,34,28
1657276103209,MATH 197,001,091859,McAuley; Julian John,9999,0,9999,0
1657276103209,MATH 197,002,095566,Kedlaya; Kiran S.,9997,0,9999,2
1657276103209,MATH 197,003,095567,Xiao; Ming,9999,0,9999,0
1657276103209,MATH 197,004,095571,Perols; Johan Lars,9998,0,9999,1
1657276110270,COGS 9,A01,083615,Shannon; Kyle Michael,8,0,75,67
1657276116302,COGS 11,A01,083617,Boyle; Mary E. T.,22,0,48,26
1657276122325,COGS 13,A01,083071,Bastos; Amalia Pinkusfeld,9,0,71,62
1657276128347,COGS 14A,A01,092681,Semenuks; Arturs,2,1,100,98
1657276134370,COGS 14B,A01,083073,Cheng; Tzu-Han,6,0,63,57
1657276140395,COGS 17,A01,092677,Semenuks; Arturs,5,0,81,76
1657276146419,COGS 100,A01,083619,Allen; Michael Gordon,16,0,70,54
1657276152448,COGS 101A,A01,083621,Davis; Joshua Daniel,9,0,68,59
1657276158472,COGS 101B,A01,091572,Allen; Michael Gordon,11,0,65,54
1657276164495,COGS 101C,A01,083625,Delgado; Tania,17,0,35,18
1657276170523,COGS 107A,A01,083627,Boyle; Mary E. T.,13,0,60,47
1657276176548,COGS 118A,A01,083075,Gupta; Anjum,18,0,76,58
1657276182573,CSE 3,A50,083646,Miranda; Gregory Joseph,24,0,50,26
1657276188597,CSE 8A,A50,083650,Miranda; Gregory Joseph,17,1,56,39
1657276194623,CSE 11,A01,083080,Cao; Yingjun,5,15,40,35
1657276200651,CSE 12,A01,083652,Krause-Levy; Sophia Louisa,26,1,120,94
1657276206688,CSE 15L,A01,083654,Morris; Justin Loren,9,0,50,41
1657276206688,CSE 15L,A02,083655,Morris; Justin Loren,9,0,50,41
1657276212717,CSE 20,A01,083657,Tran; Khoa Dang,38,0,80,42
1657276218738,CSE 21,A01,095574,Bach; Quang Tran,22,0,48,26
1657276224763,CSE 30,A01,083084,Eldon; John,4,0,80,76
1657276224763,CSE 30,B01,095061,Bhaskar; Nishant,8,0,50,42
1657276230787,CSE 100,A01,083659,Cao; Yingjun,4,4,70,66
1657276236813,CSE 134B,A01,083661,Powell; Thomas Allan,21,0,100,79
1657276242837,CSE 140,A01,083663,Gungor; Onat,13,0,85,72
1657276248863,CSE 140L,A01,083088,Eldon; John,19,0,100,81
1657276254888,CSE 175,A01,083665,Kumar; Rakesh,3,0,25,22
1657276260917,CSE 190,A00,092507,Dubnov; Shlomo,7,0,20,13
1657276266946,ECE 45,A01,083139,Congero; Spencer William,5,0,75,70
1657276272971,ECE 65,A50,083695,Saad; Andrew S,12,0,30,18
1657276272971,ECE 65,A51,095125,Saad; Andrew S,25,0,26,1
1657276279001,ECE 109,A01,091882,Touri; Behrouz,19,0,70,51
1657276285037,ECE 180,A00,083140,Abi Samra; Nicholas Camill,1,0,30,29
1657276285037,ECE 180,B00,083141,Abi Samra; Nicholas Camill,0,0,30,30
1657276291060,MATH 10A,A01,083735,Patchell; Gregory David,2,0,30,28
1657276291060,MATH 10A,A02,083736,Patchell; Gregory David,20,0,30,10
1657276291060,MATH 10A,A03,083737,Patchell; Gregory David,16,0,30,14
1657276297092,MATH 10B,A01,083207,Lim; Seonhee,7,0,34,27
1657276297092,MATH 10B,A02,083208,Lim; Seonhee,9,0,35,26
1657276297092,MATH 10B,A03,093472,Lim; Seonhee,5,0,34,29
1657276297092,MATH 10B,B01,083739,Sinha; Shubham,11,0,30,19
1657276303120,MATH 18,A01,083743,Cinel; Cameron Alexander,6,0,30,24
1657276303120,MATH 18,A02,083744,Cinel; Cameron Alexander,17,0,30,13
1657276303120,MATH 18,A03,083745,Cinel; Cameron Alexander,8,0,30,22
1657276303120,MATH 18,B01,083748,Rideout; David Porter,4,0,37,33
1657276303120,MATH 18,B02,083749,Rideout; David Porter,4,0,36,32
1657276303120,MATH 18,B03,083750,Rideout; David Porter,2,0,37,35
1657276303120,MATH 18,B04,083751,Rideout; David Porter,6,0,36,30
1657276303120,MATH 18,B05,093473,Rideout; David Porter,5,0,36,31
1657276303120,MATH 18,B06,093474,Rideout; David Porter,5,0,36,31
1657276309145,MATH 20A,A01,083754,Zheng; Zequn,14,0,40,26
1657276315179,MATH 20B,A01,083756,Briones; Jor-el Thomas Caparas,3,0,36,33
1657276315179,MATH 20B,A02,083757,Briones; Jor-el Thomas Caparas,1,0,36,35
1657276315179,MATH 20B,A03,093475,Briones; Jor-el Thomas Caparas,2,0,36,34
1657276321213,MATH 20C,A01,083760,Briones; Jor-el Thomas Caparas,1,0,35,34
1657276321213,MATH 20C,A02,083761,Briones; Jor-el Thomas Caparas,8,0,35,27
1657276321213,MATH 20C,A03,093476,Briones; Jor-el Thomas Caparas,0,1,36,36
1657276321213,MATH 20C,B01,083762,Bach; Quang Tran,1,0,30,29
1657276327259,MATH 20D,A01,083765,Tran; Brian Kha,5,0,30,25
1657276327259,MATH 20D,A02,083766,Tran; Brian Kha,5,0,30,25
1657276327259,MATH 20D,A03,083767,Tran; Brian Kha,4,0,30,26
1657276333289,MATH 20E,A01,083771,Ganguly; Soumya,7,0,32,25
1657276333289,MATH 20E,A02,083772,Ganguly; Soumya,7,0,32,25
1657276333289,MATH 20E,B01,083773,Ciotti; Benjamin,19,0,35,16
1657276333289,MATH 20E,B02,083774,Ciotti; Benjamin,17,0,35,18
1657276339311,MATH 103A,A01,083777,Greenfeld; Be'Eri,3,0,36,33
1657276339311,MATH 103A,A02,083778,Greenfeld; Be'Eri,5,0,36,31
1657276339311,MATH 103A,A03,093561,Greenfeld; Be'Eri,4,0,36,32
1657276339311,MATH 103A,B01,083779,Greenfeld; Be'Eri,6,0,36,30
1657276339311,MATH 103A,B02,083780,Greenfeld; Be'Eri,3,0,36,33
1657276339311,MATH 103A,B03,093562,Greenfeld; Be'Eri,3,0,36,33
1657276345353,MATH 105,A01,085443,Carter; Anne Toulson,15,0,35,20
1657276345353,MATH 105,A02,093477,Carter; Anne Toulson,20,0,35,15
1657276351388,MATH 109,A01,083213,Ganzberger; Geoffrey Michael,2,0,34,32
1657276351388,MATH 109,A02,083214,Ganzberger; Geoffrey Michael,4,0,34,30
1657276351388,MATH 109,A03,093478,Ganzberger; Geoffrey Michael,2,0,34,32
1657276351388,MATH 109,B01,083215,Ganzberger; Geoffrey Michael,1,0,32,31
1657276351388,MATH 109,B02,083216,Ganzberger; Geoffrey Michael,1,0,32,31
1657276351388,MATH 109,B03,093479,Ganzberger; Geoffrey Michael,8,0,32,24
1657276357412,MATH 142A,A01,083219,Chow; Bennett,7,0,32,25
1657276357412,MATH 142A,A02,083220,Chow; Bennett,10,0,32,22
1657276357412,MATH 142A,A03,093480,Chow; Bennett,7,0,32,25
1657276357412,MATH 142A,B03,093481,Chow; Bennett,8,0,32,24
1657276357412,MATH 142A,B04,093558,Chow; Bennett,12,0,32,20
1657276357412,MATH 142A,B05,093559,Chow; Bennett,6,0,32,26
1657276363442,MATH 193A,A01,083224,Rotar; Vladimir,7,0,34,27
1657276363442,MATH 193A,A02,083225,Rotar; Vladimir,6,0,34,28
1657276363442,MATH 193A,A03,083781,Rotar; Vladimir,2,0,34,32
1657276363442,MATH 193A,A04,083782,Rotar; Vladimir,8,0,34,26
1657276363442,MATH 193A,A05,093482,Rotar; Vladimir,6,0,34,28
1657276369474,MATH 197,001,091859,McAuley; Julian John,9999,0,9999,0
1657276369474,MATH 197,002,095566,Kedlaya; Kiran S.,9997,0,9999,2
1657276369474,MATH 197,003,095567,Xiao; Ming,9999,0,9999,0
1657276369474,MATH 197,004,095571,Perols; Johan Lars,9998,0,9999,1
1657276376555,COGS 9,A01,083615,Shannon; Kyle Michael,8,0,75,67
1657276382583,COGS 11,A01,083617,Boyle; Mary E. T.,22,0,48,26
1657276388608,COGS 13,A01,083071,Bastos; Amalia Pinkusfeld,9,0,71,62
1657276394638,COGS 14A,A01,092681,Semenuks; Arturs,2,1,100,98
1657276400667,COGS 14B,A01,083073,Cheng; Tzu-Han,6,0,63,57
1657276406690,COGS 17,A01,092677,Semenuks; Arturs,5,0,81,76
1657276412719,COGS 100,A01,083619,Allen; Michael Gordon,16,0,70,54
1657276418750,COGS 101A,A01,083621,Davis; Joshua Daniel,9,0,68,59
1657276424775,COGS 101B,A01,091572,Allen; Michael Gordon,11,0,65,54
1657276430804,COGS 101C,A01,083625,Delgado; Tania,17,0,35,18
1657276436826,COGS 107A,A01,083627,Boyle; Mary E. T.,13,0,60,47
1657276442850,COGS 118A,A01,083075,Gupta; Anjum,18,0,76,58
1657276448879,CSE 3,A50,083646,Miranda; Gregory Joseph,24,0,50,26
1657276454910,CSE 8A,A50,083650,Miranda; Gregory Joseph,17,1,56,39
1657276460933,CSE 11,A01,083080,Cao; Yingjun,5,15,40,35
1657276466964,CSE 12,A01,083652,Krause-Levy; Sophia Louisa,26,1,120,94
1657276472997,CSE 15L,A01,083654,Morris; Justin Loren,9,0,50,41
1657276472997,CSE 15L,A02,083655,Morris; Justin Loren,9,0,50,41
1657276479021,CSE 20,A01,083657,Tran; Khoa Dang,38,0,80,42
1657276485047,CSE 21,A01,095574,Bach; Quang Tran,22,0,48,26
1657276491072,CSE 30,A01,083084,Eldon; John,4,0,80,76
1657276491072,CSE 30,B01,095061,Bhaskar; Nishant,8,0,50,42
1657276497096,CSE 100,A01,083659,Cao; Yingjun,4,4,70,66
1657276503124,CSE 134B,A01,083661,Powell; Thomas Allan,21,0,100,79
1657276509155,CSE 140,A01,083663,Gungor; Onat,13,0,85,72
1657276515177,CSE 140L,A01,083088,Eldon; John,19,0,100,81
1657276521206,CSE 175,A01,083665,Kumar; Rakesh,3,0,25,22
1657276527232,CSE 190,A00,092507,Dubnov; Shlomo,7,0,20,13
1657276533261,ECE 45,A01,083139,Congero; Spencer William,5,0,75,70
1657276539296,ECE 65,A50,083695,Saad; Andrew S,12,0,30,18
1657276539296,ECE 65,A51,095125,Saad; Andrew S,25,0,26,1
1657276545320,ECE 109,A01,091882,Touri; Behrouz,19,0,70,51
1657276551362,ECE 180,A00,083140,Abi Samra; Nicholas Camill,1,0,30,29
1657276551362,ECE 180,B00,083141,Abi Samra; Nicholas Camill,0,0,30,30
1657276557388,MATH 10A,A01,083735,Patchell; Gregory David,2,0,30,28
1657276557388,MATH 10A,A02,083736,Patchell; Gregory David,20,0,30,10
1657276557388,MATH 10A,A03,083737,Patchell; Gregory David,16,0,30,14
1657276563425,MATH 10B,A01,083207,Lim; Seonhee,7,0,34,27
1657276563425,MATH 10B,A02,083208,Lim; Seonhee,9,0,35,26
1657276563425,MATH 10B,A03,093472,Lim; Seonhee,5,0,34,29
1657276563425,MATH 10B,B01,083739,Sinha; Shubham,11,0,30,19
1657276569451,MATH 18,A01,083743,Cinel; Cameron Alexander,6,0,30,24
1657276569451,MATH 18,A02,083744,Cinel; Cameron Alexander,17,0,30,13
1657276569451,MATH 18,A03,083745,Cinel; Cameron Alexander,8,0,30,22
1657276569451,MATH 18,B01,083748,Rideout; David Porter,4,0,37,33
1657276569451,MATH 18,B02,083749,Rideout; David Porter,4,0,36,32
1657276569451,MATH 18,B03,083750,Rideout; David Porter,2,0,37,35
1657276569451,MATH 18,B04,083751,Rideout; David Porter,6,0,36,30
1657276569451,MATH 18,B05,093473,Rideout; David Porter,5,0,36,31
1657276569451,MATH 18,B06,093474,Rideout; David Porter,5,0,36,31
1657276575475,MATH 20A,A01,083754,Zheng; Zequn,14,0,40,26
1657276581501,MATH 20B,A01,083756,Briones; Jor-el Thomas Caparas,3,0,36,33
1657276581501,MATH 20B,A02,083757,Briones; Jor-el Thomas Caparas,1,0,36,35
1657276581501,MATH 20B,A03,093475,Briones; Jor-el Thomas Caparas,2,0,36,34
1657276587535,MATH 20C,A01,083760,Briones; Jor-el Thomas Caparas,1,0,35,34
1657276587535,MATH 20C,A02,083761,Briones; Jor-el Thomas Caparas,8,0,35,27
1657276587535,MATH 20C,A03,093476,Briones; Jor-el Thomas Caparas,0,1,36,36
1657276587535,MATH 20C,B01,083762,Bach; Quang Tran,1,0,30,29
1657276593574,MATH 20D,A01,083765,Tran; Brian Kha,5,0,30,25
1657276593574,MATH 20D,A02,083766,Tran; Brian Kha,5,0,30,25
1657276593574,MATH 20D,A03,083767,Tran; Brian Kha,4,0,30,26
1657276599605,MATH 20E,A01,083771,Ganguly; Soumya,7,0,32,25
1657276599605,MATH 20E,A02,083772,Ganguly; Soumya,7,0,32,25
1657276599605,MATH 20E,B01,083773,Ciotti; Benjamin,19,0,35,16
1657276599605,MATH 20E,B02,083774,Ciotti; Benjamin,17,0,35,18
1657276605632,MATH 103A,A01,083777,Greenfeld; Be'Eri,3,0,36,33
1657276605632,MATH 103A,A02,083778,Greenfeld; Be'Eri,5,0,36,31
1657276605632,MATH 103A,A03,093561,Greenfeld; Be'Eri,4,0,36,32
1657276605632,MATH 103A,B01,083779,Greenfeld; Be'Eri,6,0,36,30
1657276605632,MATH 103A,B02,083780,Greenfeld; Be'Eri,3,0,36,33
1657276605632,MATH 103A,B03,093562,Greenfeld; Be'Eri,3,0,36,33
1657276611656,MATH 105,A01,085443,Carter; Anne Toulson,15,0,35,20
1657276611656,MATH 105,A02,093477,Carter; Anne Toulson,20,0,35,15
1657276617690,MATH 109,A01,083213,Ganzberger; Geoffrey Michael,2,0,34,32
1657276617690,MATH 109,A02,083214,Ganzberger; Geoffrey Michael,4,0,34,30
1657276617690,MATH 109,A03,093478,Ganzberger; Geoffrey Michael,2,0,34,32
1657276617690,MATH 109,B01,083215,Ganzberger; Geoffrey Michael,1,0,32,31
1657276617690,MATH 109,B02,083216,Ganzberger; Geoffrey Michael,1,0,32,31
1657276617690,MATH 109,B03,093479,Ganzberger; Geoffrey Michael,8,0,32,24
1657276623724,MATH 142A,A01,083219,Chow; Bennett,7,0,32,25
1657276623724,MATH 142A,A02,083220,Chow; Bennett,10,0,32,22
1657276623724,MATH 142A,A03,093480,Chow; Bennett,7,0,32,25
1657276623724,MATH 142A,B03,093481,Chow; Bennett,8,0,32,24
1657276623724,MATH 142A,B04,093558,Chow; Bennett,12,0,32,20
1657276623724,MATH 142A,B05,093559,Chow; Bennett,6,0,32,26
1657276629768,MATH 193A,A01,083224,Rotar; Vladimir,7,0,34,27
1657276629768,MATH 193A,A02,083225,Rotar; Vladimir,6,0,34,28
1657276629768,MATH 193A,A03,083781,Rotar; Vladimir,2,0,34,32
1657276629768,MATH 193A,A04,083782,Rotar; Vladimir,8,0,34,26
1657276629768,MATH 193A,A05,093482,Rotar; Vladimir,6,0,34,28
1657276635793,MATH 197,001,091859,McAuley; Julian John,9999,0,9999,0
1657276635793,MATH 197,002,095566,Kedlaya; Kiran S.,9997,0,9999,2
1657276635793,MATH 197,003,095567,Xiao; Ming,9999,0,9999,0
1657276635793,MATH 197,004,095571,Perols; Johan Lars,9998,0,9999,1
1657276642869,COGS 9,A01,083615,Shannon; Kyle Michael,8,0,75,67
1657276648898,COGS 11,A01,083617,Boyle; Mary E. T.,22,0,48,26
1657276654933,COGS 13,A01,083071,Bastos; Amalia Pinkusfeld,9,0,71,62
1657276660958,COGS 14A,A01,092681,Semenuks; Arturs,2,1,100,98
1657276666989,COGS 14B,A01,083073,Cheng; Tzu-Han,6,0,63,57
1657276673015,COGS 17,A01,092677,Semenuks; Arturs,5,0,81,76
1657276679138,COGS 100,A01,083619,Allen; Michael Gordon,16,0,70,54
1657276685169,COGS 101A,A01,083621,Davis; Joshua Daniel,9,0,68,59
1657276691192,COGS 101B,A01,091572,Allen; Michael Gordon,11,0,65,54
1657276697222,COGS 101C,A01,083625,Delgado; Tania,17,0,35,18
1657276703244,COGS 107A,A01,083627,Boyle; Mary E. T.,13,0,60,47
1657276709281,COGS 118A,A01,083075,Gupta; Anjum,18,0,76,58
1657276715306,CSE 3,A50,083646,Miranda; Gregory Joseph,24,0,50,26
1657276721330,CSE 8A,A50,083650,Miranda; Gregory Joseph,17,1,56,39
1657276727360,CSE 11,A01,083080,Cao; Yingjun,5,15,40,35
1657276733392,CSE 12,A01,083652,Krause-Levy; Sophia Louisa,26,1,120,94
1657276739421,CSE 15L,A01,083654,Morris; Justin Loren,9,0,50,41
1657276739421,CSE 15L,A02,083655,Morris; Justin Loren,9,0,50,41
1657276745455,CSE 20,A01,083657,Tran; Khoa Dang,38,0,80,42
1657276751484,CSE 21,A01,095574,Bach; Quang Tran,22,0,48,26
1657276757509,CSE 30,A01,083084,Eldon; John,4,0,80,76
1657276757509,CSE 30,B01,095061,Bhaskar; Nishant,8,0,50,42
1657276763533,CSE 100,A01,083659,Cao; Yingjun,4,4,70,66
1657276769564,CSE 134B,A01,083661,Powell; Thomas Allan,21,0,100,79
1657276775589,CSE 140,A01,083663,Gungor; Onat,13,0,85,72
1657276781617,CSE 140L,A01,083088,Eldon; John,19,0,100,81
1657276787645,CSE 175,A01,083665,Kumar; Rakesh,3,0,25,22
1657276793677,CSE 190,A00,092507,Dubnov; Shlomo,7,0,20,13
1657276799708,ECE 45,A01,083139,Congero; Spencer William,5,0,75,70
1657276805734,ECE 65,A50,083695,Saad; Andrew S,12,0,30,18
1657276805734,ECE 65,A51,095125,Saad; Andrew S,25,0,26,1
1657276811760,ECE 109,A01,091882,Touri; Behrouz,19,0,70,51
1657276817787,ECE 180,A00,083140,Abi Samra; Nicholas Camill,1,0,30,29
1657276817787,ECE 180,B00,083141,Abi Samra; Nicholas Camill,0,0,30,30
1657276823813,MATH 10A,A01,083735,Patchell; Gregory David,2,0,30,28
1657276823813,MATH 10A,A02,083736,Patchell; Gregory David,20,0,30,10
1657276823813,MATH 10A,A03,083737,Patchell; Gregory David,16,0,30,14
1657276829849,MATH 10B,A01,083207,Lim; Seonhee,7,0,34,27
1657276829849,MATH 10B,A02,083208,Lim; Seonhee,9,0,35,26
1657276829849,MATH 10B,A03,093472,Lim; Seonhee,5,0,34,29
1657276829849,MATH 10B,B01,083739,Sinha; Shubham,11,0,30,19
1657276835877,MATH 18,A01,083743,Cinel; Cameron Alexander,6,0,30,24
1657276835877,MATH 18,A02,083744,Cinel; Cameron Alexander,17,0,30,13
1657276835877,MATH 18,A03,083745,Cinel; Cameron Alexander,8,0,30,22
1657276835877,MATH 18,B01,083748,Rideout; David Porter,4,0,37,33
1657276835877,MATH 18,B02,083749,Rideout; David Porter,4,0,36,32
1657276835877,MATH 18,B03,083750,Rideout; David Porter,2,0,37,35
1657276835877,MATH 18,B04,083751,Rideout; David Porter,6,0,36,30
1657276835877,MATH 18,B05,093473,Rideout; David Porter,5,0,36,31
1657276835877,MATH 18,B06,093474,Rideout; David Porter,5,0,36,31
1657276841909,MATH 20A,A01,083754,Zheng; Zequn,14,0,40,26
1657276847941,MATH 20B,A01,083756,Briones; Jor-el Thomas Caparas,3,0,36,33
1657276847941,MATH 20B,A02,083757,Briones; Jor-el Thomas Caparas,1,0,36,35
1657276847941,MATH 20B,A03,093475,Briones; Jor-el Thomas Caparas,2,0,36,34
1657276853966,MATH 20C,A01,083760,Briones; Jor-el Thomas Caparas,1,0,35,34
1657276853966,MATH 20C,A02,083761,Briones; Jor-el Thomas Caparas,8,0,35,27
1657276853966,MATH 20C,A03,093476,Briones; Jor-el Thomas Caparas,0,1,36,36
1657276853966,MATH 20C,B01,083762,Bach; Quang Tran,1,0,30,29
1657276860000,MATH 20D,A01,083765,Tran; Brian Kha,5,0,30,25
1657276860000,MATH 20D,A02,083766,Tran; Brian Kha,5,0,30,25
1657276860000,MATH 20D,A03,083767,Tran; Brian Kha,4,0,30,26
1657276866025,MATH 20E,A01,083771,Ganguly; Soumya,7,0,32,25
1657276866025,MATH 20E,A02,083772,Ganguly; Soumya,7,0,32,25
1657276866025,MATH 20E,B01,083773,Ciotti; Benjamin,19,0,35,16
1657276866025,MATH 20E,B02,083774,Ciotti; Benjamin,17,0,35,18
1657276872058,MATH 103A,A01,083777,Greenfeld; Be'Eri,3,0,36,33
1657276872058,MATH 103A,A02,083778,Greenfeld; Be'Eri,5,0,36,31
1657276872058,MATH 103A,A03,093561,Greenfeld; Be'Eri,4,0,36,32
1657276872058,MATH 103A,B01,083779,Greenfeld; Be'Eri,6,0,36,30
1657276872058,MATH 103A,B02,083780,Greenfeld; Be'Eri,3,0,36,33
1657276872058,MATH 103A,B03,093562,Greenfeld; Be'Eri,3,0,36,33
1657276878084,MATH 105,A01,085443,Carter; Anne Toulson,15,0,35,20
1657276878084,MATH 105,A02,093477,Carter; Anne Toulson,20,0,35,15
1657276884109,MATH 109,A01,083213,Ganzberger; Geoffrey Michael,2,0,34,32
1657276884109,MATH 109,A02,083214,Ganzberger; Geoffrey Michael,4,0,34,30
1657276884109,MATH 109,A03,093478,Ganzberger; Geoffrey Michael,2,0,34,32
1657276884109,MATH 109,B01,083215,Ganzberger; Geoffrey Michael,1,0,32,31
1657276884109,MATH 109,B02,083216,Ganzberger; Geoffrey Michael,1,0,32,31
1657276884109,MATH 109,B03,093479,Ganzberger; Geoffrey Michael,8,0,32,24
1657276890134,MATH 142A,A01,083219,Chow; Bennett,7,0,32,25
1657276890134,MATH 142A,A02,083220,Chow; Bennett,10,0,32,22
1657276890134,MATH 142A,A03,093480,Chow; Bennett,7,0,32,25
1657276890134,MATH 142A,B03,093481,Chow; Bennett,8,0,32,24
1657276890134,MATH 142A,B04,093558,Chow; Bennett,12,0,32,20
1657276890134,MATH 142A,B05,093559,Chow; Bennett,6,0,32,26
1657276896158,MATH 193A,A01,083224,Rotar; Vladimir,7,0,34,27
1657276896158,MATH 193A,A02,083225,Rotar; Vladimir,6,0,34,28
1657276896158,MATH 193A,A03,083781,Rotar; Vladimir,2,0,34,32
1657276896158,MATH 193A,A04,083782,Rotar; Vladimir,8,0,34,26
1657276896158,MATH 193A,A05,093482,Rotar; Vladimir,6,0,34,28
1657276902190,MATH 197,001,091859,McAuley; Julian John,9999,0,9999,0
1657276902190,MATH 197,002,095566,Kedlaya; Kiran S.,9997,0,9999,2
1657276902190,MATH 197,003,095567,Xiao; Ming,9999,0,9999,0
1657276902190,MATH 197,004,095571,Perols; Johan Lars,9998,0,9999,1
1657276909260,COGS 9,A01,083615,Shannon; Kyle Michael,8,0,75,67
1657276915284,COGS 11,A01,083617,Boyle; Mary E. T.,22,0,48,26
1657276921308,COGS 13,A01,083071,Bastos; Amalia Pinkusfeld,9,0,71,62
1657276927332,COGS 14A,A01,092681,Semenuks; Arturs,2,1,100,98
1657276933361,COGS 14B,A01,083073,Cheng; Tzu-Han,6,0,63,57
1657276939389,COGS 17,A01,092677,Semenuks; Arturs,5,0,81,76
1657276945413,COGS 100,A01,083619,Allen; Michael Gordon,16,0,70,54
1657276951438,COGS 101A,A01,083621,Davis; Joshua Daniel,9,0,68,59
1657276957464,COGS 101B,A01,091572,Allen; Michael Gordon,11,0,65,54
1657276963488,COGS 101C,A01,083625,Delgado; Tania,17,0,35,18
1657276969512,COGS 107A,A01,083627,Boyle; Mary E. T.,13,0,60,47
1657276975535,COGS 118A,A01,083075,Gupta; Anjum,18,0,76,58
1657276981574,CSE 3,A50,083646,Miranda; Gregory Joseph,24,0,50,26
1657276987603,CSE 8A,A50,083650,Miranda; Gregory Joseph,17,1,56,39
1657276993634,CSE 11,A01,083080,Cao; Yingjun,5,15,40,35
1657276999658,CSE 12,A01,083652,Krause-Levy; Sophia Louisa,26,1,120,94
1657277005685,CSE 15L,A01,083654,Morris; Justin Loren,9,0,50,41
1657277005685,CSE 15L,A02,083655,Morris; Justin Loren,9,0,50,41
1657277011717,CSE 20,A01,083657,Tran; Khoa Dang,38,0,80,42
1657277017740,CSE 21,A01,095574,Bach; Quang Tran,22,0,48,26
1657277023773,CSE 30,A01,083084,Eldon; John,4,0,80,76
1657277023773,CSE 30,B01,095061,Bhaskar; Nishant,8,0,50,42
1657277029799,CSE 100,A01,083659,Cao; Yingjun,4,4,70,66
1657277035823,CSE 134B,A01,083661,Powell; Thomas Allan,21,0,100,79
1657277041854,CSE 140,A01,083663,Gungor; Onat,13,0,85,72
1657277047878,CSE 140L,A01,083088,Eldon; John,19,0,100,81
1657277053905,CSE 175,A01,083665,Kumar; Rakesh,3,0,25,22
1657277059931,CSE 190,A00,092507,Dubnov; Shlomo,7,0,20,13
1657277065963,ECE 45,A01,083139,Congero; Spencer William,5,0,75,70
1657277071994,ECE 65,A50,083695,Saad; Andrew S,12,0,30,18
1657277071994,ECE 65,A51,095125,Saad; Andrew S,25,0,26,1
1657277078019,ECE 109,A01,091882,Touri; Behrouz,19,0,70,51
1657277092743,ECE 180,A00,083140,Abi Samra; Nicholas Camill,1,0,30,29
1657277092743,ECE 180,B00,083141,Abi Samra; Nicholas Camill,0,0,30,30
1657277098771,MATH 10A,A01,083735,Patchell; Gregory David,2,0,30,28
1657277098771,MATH 10A,A02,083736,Patchell; Gregory David,20,0,30,10
1657277098771,MATH 10A,A03,083737,Patchell; Gregory David,16,0,30,14
1657277118879,MATH 10B,A01,083207,Lim; Seonhee,7,0,34,27
1657277118879,MATH 10B,A02,083208,Lim; Seonhee,9,0,35,26
1657277118879,MATH 10B,A03,093472,Lim; Seonhee,5,0,34,29
1657277118879,MATH 10B,B01,083739,Sinha; Shubham,11,0,30,19
1657277124918,MATH 18,A01,083743,Cinel; Cameron Alexander,6,0,30,24
1657277124918,MATH 18,A02,083744,Cinel; Cameron Alexander,17,0,30,13
1657277124918,MATH 18,A03,083745,Cinel; Cameron Alexander,8,0,30,22
1657277124918,MATH 18,B01,083748,Rideout; David Porter,4,0,37,33
1657277124918,MATH 18,B02,083749,Rideout; David Porter,4,0,36,32
1657277124918,MATH 18,B03,083750,Rideout; David Porter,2,0,37,35
1657277124918,MATH 18,B04,083751,Rideout; David Porter,6,0,36,30
1657277124918,MATH 18,B05,093473,Rideout; David Porter,5,0,36,31
1657277124918,MATH 18,B06,093474,Rideout; David Porter,5,0,36,31
1657277143371,MATH 20A,A01,083754,Zheng; Zequn,14,0,40,26
1657277149396,MATH 20B,A01,083756,Briones; Jor-el Thomas Caparas,3,0,36,33
1657277149396,MATH 20B,A02,083757,Briones; Jor-el Thomas Caparas,1,0,36,35
1657277149396,MATH 20B,A03,093475,Briones; Jor-el Thomas Caparas,2,0,36,34
1657277167186,MATH 20C,A01,083760,Briones; Jor-el Thomas Caparas,1,0,35,34
1657277167186,MATH 20C,A02,083761,Briones; Jor-el Thomas Caparas,8,0,35,27
1657277167186,MATH 20C,A03,093476,Briones; Jor-el Thomas Caparas,0,1,36,36
1657277167186,MATH 20C,B01,083762,Bach; Quang Tran,1,0,30,29
1657277173217,MATH 20D,A01,083765,Tran; Brian Kha,5,0,30,25
1657277173217,MATH 20D,A02,083766,Tran; Brian Kha,5,0,30,25
1657277173217,MATH 20D,A03,083767,Tran; Brian Kha,4,0,30,26
1657277190880,MATH 20E,A01,083771,Ganguly; Soumya,7,0,32,25
1657277190880,MATH 20E,A02,083772,Ganguly; Soumya,7,0,32,25
1657277190880,MATH 20E,B01,083773,Ciotti; Benjamin,19,0,35,16
1657277190880,MATH 20E,B02,083774,Ciotti; Benjamin,17,0,35,18
1657277196908,MATH 103A,A01,083777,Greenfeld; Be'Eri,3,0,36,33
1657277196908,MATH 103A,A02,083778,Greenfeld; Be'Eri,5,0,36,31
1657277196908,MATH 103A,A03,093561,Greenfeld; Be'Eri,4,0,36,32
1657277196908,MATH 103A,B01,083779,Greenfeld; Be'Eri,6,0,36,30
1657277196908,MATH 103A,B02,083780,Greenfeld; Be'Eri,3,0,36,33
1657277196908,MATH 103A,B03,093562,Greenfeld; Be'Eri,3,0,36,33
1657277214467,MATH 105,A01,085443,Carter; Anne Toulson,15,0,35,20
1657277214467,MATH 105,A02,093477,Carter; Anne Toulson,20,0,35,15
1657277220491,MATH 109,A01,083213,Ganzberger; Geoffrey Michael,2,0,34,32
1657277220491,MATH 109,A02,083214,Ganzberger; Geoffrey Michael,4,0,34,30
1657277220491,MATH 109,A03,093478,Ganzberger; Geoffrey Michael,2,0,34,32
1657277220491,MATH 109,B01,083215,Ganzberger; Geoffrey Michael,1,0,32,31
1657277220491,MATH 109,B02,083216,Ganzberger; Geoffrey Michael,1,0,32,31
1657277220491,MATH 109,B03,093479,Ganzberger; Geoffrey Michael,8,0,32,24
1657277237857,MATH 142A,A01,083219,Chow; Bennett,7,0,32,25
1657277237857,MATH 142A,A02,083220,Chow; Bennett,10,0,32,22
1657277237857,MATH 142A,A03,093480,Chow; Bennett,7,0,32,25
1657277237857,MATH 142A,B03,093481,Chow; Bennett,8,0,32,24
1657277237857,MATH 142A,B04,093558,Chow; Bennett,12,0,32,20
1657277237857,MATH 142A,B05,093559,Chow; Bennett,6,0,32,26
1657277243884,MATH 193A,A01,083224,Rotar; Vladimir,7,0,34,27
1657277243884,MATH 193A,A02,083225,Rotar; Vladimir,6,0,34,28
1657277243884,MATH 193A,A03,083781,Rotar; Vladimir,2,0,34,32
1657277243884,MATH 193A,A04,083782,Rotar; Vladimir,8,0,34,26
1657277243884,MATH 193A,A05,093482,Rotar; Vladimir,6,0,34,28
1657277261282,MATH 197,001,091859,McAuley; Julian John,9999,0,9999,0
1657277261282,MATH 197,002,095566,Kedlaya; Kiran S.,9997,0,9999,2
1657277261282,MATH 197,003,095567,Xiao; Ming,9999,0,9999,0
1657277261282,MATH 197,004,095571,Perols; Johan Lars,9998,0,9999,1
1657277268364,COGS 9,A01,083615,Shannon; Kyle Michael,8,0,75,67
1657277283934,COGS 11,A01,083617,Boyle; Mary E. T.,22,0,48,26
1657277289966,COGS 13,A01,083071,Bastos; Amalia Pinkusfeld,9,0,71,62
1657277306782,COGS 14A,A01,092681,Semenuks; Arturs,2,1,100,98
1657277312807,COGS 14B,A01,083073,Cheng; Tzu-Han,6,0,63,57
1657277321305,COGS 17,A01,092677,Semenuks; Arturs,5,0,81,76
1657277327328,COGS 100,A01,083619,Allen; Michael Gordon,16,0,70,54
1657277333359,COGS 101A,A01,083621,Davis; Joshua Daniel,9,0,68,59
1657277339386,COGS 101B,A01,091572,Allen; Michael Gordon,11,0,65,54
1657277345419,COGS 101C,A01,083625,Delgado; Tania,17,0,35,18
1657277351449,COGS 107A,A01,083627,Boyle; Mary E. T.,13,0,60,47
1657277357478,COGS 118A,A01,083075,Gupta; Anjum,18,0,76,58
1657277363503,CSE 3,A50,083646,Miranda; Gregory Joseph,24,0,50,26
1657277369527,CSE 8A,A50,083650,Miranda; Gregory Joseph,17,1,56,39
1657277375551,CSE 11,A01,083080,Cao; Yingjun,5,15,40,35
1657277381576,CSE 12,A01,083652,Krause-Levy; Sophia Louisa,26,1,120,94
1657277387600,CSE 15L,A01,083654,Morris; Justin Loren,9,0,50,41
1657277387600,CSE 15L,A02,083655,Morris; Justin Loren,9,0,50,41
1657277393712,CSE 20,A01,083657,Tran; Khoa Dang,38,0,80,42
1657277399737,CSE 21,A01,095574,Bach; Quang Tran,22,0,48,26
1657277405768,CSE 30,A01,083084,Eldon; John,4,0,80,76
1657277405768,CSE 30,B01,095061,Bhaskar; Nishant,8,0,50,42
1657277411792,CSE 100,A01,083659,Cao; Yingjun,4,4,70,66
1657277417820,CSE 134B,A01,083661,Powell; Thomas Allan,21,0,100,79
1657277423852,CSE 140,A01,083663,Gungor; Onat,13,0,85,72
1657277429881,CSE 140L,A01,083088,Eldon; John,19,0,100,81
1657277435913,CSE 175,A01,083665,Kumar; Rakesh,3,0,25,22
1657277441937,CSE 190,A00,092507,Dubnov; Shlomo,7,0,20,13
1657277447962,ECE 45,A01,083139,Congero; Spencer William,5,0,75,70
1657277453995,ECE 65,A50,083695,Saad; Andrew S,12,0,30,18
1657277453995,ECE 65,A51,095125,Saad; Andrew S,25,0,26,1
1657277460024,ECE 109,A01,091882,Touri; Behrouz,19,0,70,51
1657277466053,ECE 180,A00,083140,Abi Samra; Nicholas Camill,1,0,30,29
1657277466053,ECE 180,B00,083141,Abi Samra; Nicholas Camill,0,0,30,30
1657277472079,MATH 10A,A01,083735,Patchell; Gregory David,2,0,30,28
1657277472079,MATH 10A,A02,083736,Patchell; Gregory David,20,0,30,10
1657277472079,MATH 10A,A03,083737,Patchell; Gregory David,16,0,30,14
1657277478107,MATH 10B,A01,083207,Lim; Seonhee,7,0,34,27
1657277478107,MATH 10B,A02,083208,Lim; Seonhee,9,0,35,26
1657277478107,MATH 10B,A03,093472,Lim; Seonhee,5,0,34,29
1657277478107,MATH 10B,B01,083739,Sinha; Shubham,11,0,30,19
1657277484146,MATH 18,A01,083743,Cinel; Cameron Alexander,6,0,30,24
1657277484146,MATH 18,A02,083744,Cinel; Cameron Alexander,17,0,30,13
1657277484146,MATH 18,A03,083745,Cinel; Cameron Alexander,8,0,30,22
1657277484146,MATH 18,B01,083748,Rideout; David Porter,4,0,37,33
1657277484146,MATH 18,B02,083749,Rideout; David Porter,4,0,36,32
1657277484146,MATH 18,B03,083750,Rideout; David Porter,2,0,37,35
1657277484146,MATH 18,B04,083751,Rideout; David Porter,6,0,36,30
1657277484146,MATH 18,B05,093473,Rideout; David Porter,5,0,36,31
1657277484146,MATH 18,B06,093474,Rideout; David Porter,5,0,36,31
1657277490171,MATH 20A,A01,083754,Zheng; Zequn,14,0,40,26
1657277496205,MATH 20B,A01,083756,Briones; Jor-el Thomas Caparas,3,0,36,33
1657277496205,MATH 20B,A02,083757,Briones; Jor-el Thomas Caparas,1,0,36,35
1657277496205,MATH 20B,A03,093475,Briones; Jor-el Thomas Caparas,2,0,36,34
1657277502231,MATH 20C,A01,083760,Briones; Jor-el Thomas Caparas,1,0,35,34
1657277502231,MATH 20C,A02,083761,Briones; Jor-el Thomas Caparas,8,0,35,27
1657277502231,MATH 20C,A03,093476,Briones; Jor-el Thomas Caparas,0,1,36,36
1657277502231,MATH 20C,B01,083762,Bach; Quang Tran,1,0,30,29
1657277508257,MATH 20D,A01,083765,Tran; Brian Kha,5,0,30,25
1657277508257,MATH 20D,A02,083766,Tran; Brian Kha,5,0,30,25
1657277508257,MATH 20D,A03,083767,Tran; Brian Kha,4,0,30,26
1657277514289,MATH 20E,A01,083771,Ganguly; Soumya,7,0,32,25
1657277514289,MATH 20E,A02,083772,Ganguly; Soumya,7,0,32,25
1657277514289,MATH 20E,B01,083773,Ciotti; Benjamin,19,0,35,16
1657277514289,MATH 20E,B02,083774,Ciotti; Benjamin,17,0,35,18
1657277520327,MATH 103A,A01,083777,Greenfeld; Be'Eri,3,0,36,33
1657277520327,MATH 103A,A02,083778,Greenfeld; Be'Eri,5,0,36,31
1657277520327,MATH 103A,A03,093561,Greenfeld; Be'Eri,4,0,36,32
1657277520327,MATH 103A,B01,083779,Greenfeld; Be'Eri,6,0,36,30
1657277520327,MATH 103A,B02,083780,Greenfeld; Be'Eri,3,0,36,33
1657277520327,MATH 103A,B03,093562,Greenfeld; Be'Eri,3,0,36,33
1657277526357,MATH 105,A01,085443,Carter; Anne Toulson,15,0,35,20
1657277526357,MATH 105,A02,093477,Carter; Anne Toulson,20,0,35,15
1657277532390,MATH 109,A01,083213,Ganzberger; Geoffrey Michael,2,0,34,32
1657277532390,MATH 109,A02,083214,Ganzberger; Geoffrey Michael,4,0,34,30
1657277532390,MATH 109,A03,093478,Ganzberger; Geoffrey Michael,2,0,34,32
1657277532390,MATH 109,B01,083215,Ganzberger; Geoffrey Michael,1,0,32,31
1657277532390,MATH 109,B02,083216,Ganzberger; Geoffrey Michael,1,0,32,31
1657277532390,MATH 109,B03,093479,Ganzberger; Geoffrey Michael,8,0,32,24
1657277538416,MATH 142A,A01,083219,Chow; Bennett,7,0,32,25
1657277538416,MATH 142A,A02,083220,Chow; Bennett,10,0,32,22
1657277538416,MATH 142A,A03,093480,Chow; Bennett,7,0,32,25
1657277538416,MATH 142A,B03,093481,Chow; Bennett,8,0,32,24
1657277538416,MATH 142A,B04,093558,Chow; Bennett,12,0,32,20
1657277538416,MATH 142A,B05,093559,Chow; Bennett,6,0,32,26
1657277544443,MATH 193A,A01,083224,Rotar; Vladimir,7,0,34,27
1657277544443,MATH 193A,A02,083225,Rotar; Vladimir,6,0,34,28
1657277544443,MATH 193A,A03,083781,Rotar; Vladimir,2,0,34,32
1657277544443,MATH 193A,A04,083782,Rotar; Vladimir,8,0,34,26
1657277544443,MATH 193A,A05,093482,Rotar; Vladimir,6,0,34,28
1657277550473,MATH 197,001,091859,McAuley; Julian John,9999,0,9999,0
1657277550473,MATH 197,002,095566,Kedlaya; Kiran S.,9997,0,9999,2
1657277550473,MATH 197,003,095567,Xiao; Ming,9999,0,9999,0
1657277550473,MATH 197,004,095571,Perols; Johan Lars,9998,0,9999,1
1657277565395,COGS 9,A01,083615,Shannon; Kyle Michael,8,0,75,67
1657277571420,COGS 11,A01,083617,Boyle; Mary E. T.,22,0,48,26
1657277577698,COGS 13,A01,083071,Bastos; Amalia Pinkusfeld,9,0,71,62
1657277583723,COGS 14A,A01,092681,Semenuks; Arturs,2,1,100,98
1657277589752,COGS 14B,A01,083073,Cheng; Tzu-Han,6,0,63,57
1657277595783,COGS 17,A01,092677,Semenuks; Arturs,5,0,81,76
1657277601811,COGS 100,A01,083619,Allen; Michael Gordon,16,0,70,54
1657277607837,COGS 101A,A01,083621,Davis; Joshua Daniel,9,0,68,59
1657277613864,COGS 101B,A01,091572,Allen; Michael Gordon,11,0,65,54
1657277619890,COGS 101C,A01,083625,Delgado; Tania,17,0,35,18
1657277625916,COGS 107A,A01,083627,Boyle; Mary E. T.,13,0,60,47
1657277631941,COGS 118A,A01,083075,Gupta; Anjum,18,0,76,58
1657277637970,CSE 3,A50,083646,Miranda; Gregory Joseph,24,0,50,26
1657277643994,CSE 8A,A50,083650,Miranda; Gregory Joseph,17,1,56,39
1657277650020,CSE 11,A01,083080,Cao; Yingjun,5,15,40,35
1657277656044,CSE 12,A01,083652,Krause-Levy; Sophia Louisa,26,1,120,94
1657277662070,CSE 15L,A01,083654,Morris; Justin Loren,9,0,50,41
1657277662070,CSE 15L,A02,083655,Morris; Justin Loren,9,0,50,41
1657277668096,CSE 20,A01,083657,Tran; Khoa Dang,38,0,80,42
1657277674122,CSE 21,A01,095574,Bach; Quang Tran,22,0,48,26
1657277680156,CSE 30,A01,083084,Eldon; John,4,0,80,76
1657277680156,CSE 30,B01,095061,Bhaskar; Nishant,8,0,50,42
1657277686179,CSE 100,A01,083659,Cao; Yingjun,4,4,70,66
1657277692204,CSE 134B,A01,083661,Powell; Thomas Allan,21,0,100,79
1657277698233,CSE 140,A01,083663,Gungor; Onat,13,0,85,72
1657277704257,CSE 140L,A01,083088,Eldon; John,19,0,100,81
1657277710283,CSE 175,A01,083665,Kumar; Rakesh,3,0,25,22
1657277716307,CSE 190,A00,092507,Dubnov; Shlomo,7,0,20,13
1657277722333,ECE 45,A01,083139,Congero; Spencer William,5,0,75,70
1657277728360,ECE 65,A50,083695,Saad; Andrew S,12,0,30,18
1657277728360,ECE 65,A51,095125,Saad; Andrew S,25,0,26,1
1657277734384,ECE 109,A01,091882,Touri; Behrouz,19,0,70,51
1657277740408,ECE 180,A00,083140,Abi Samra; Nicholas Camill,1,0,30,29
1657277740408,ECE 180,B00,083141,Abi Samra; Nicholas Camill,0,0,30,30
1657277746434,MATH 10A,A01,083735,Patchell; Gregory David,2,0,30,28
1657277746434,MATH 10A,A02,083736,Patchell; Gregory David,20,0,30,10
1657277746434,MATH 10A,A03,083737,Patchell; Gregory David,16,0,30,14
1657277752476,MATH 10B,A01,083207,Lim; Seonhee,7,0,34,27
1657277752476,MATH 10B,A02,083208,Lim; Seonhee,9,0,35,26
1657277752476,MATH 10B,A03,093472,Lim; Seonhee,5,0,34,29
1657277752476,MATH 10B,B01,083739,Sinha; Shubham,11,0,30,19
1657277758504,MATH 18,A01,083743,Cinel; Cameron Alexander,6,0,30,24
1657277758504,MATH 18,A02,083744,Cinel; Cameron Alexander,17,0,30,13
1657277758504,MATH 18,A03,083745,Cinel; Cameron Alexander,8,0,30,22
1657277758504,MATH 18,B01,083748,Rideout; David Porter,4,0,37,33
1657277758504,MATH 18,B02,083749,Rideout; David Porter,4,0,36,32
1657277758504,MATH 18,B03,083750,Rideout; David Porter,2,0,37,35
1657277758504,MATH 18,B04,083751,Rideout; David Porter,6,0,36,30
1657277758504,MATH 18,B05,093473,Rideout; David Porter,5,0,36,31
1657277758504,MATH 18,B06,093474,Rideout; David Porter,5,0,36,31
1657277764532,MATH 20A,A01,083754,Zheng; Zequn,14,0,40,26
1657277770559,MATH 20B,A01,083756,Briones; Jor-el Thomas Caparas,3,0,36,33
1657277770559,MATH 20B,A02,083757,Briones; Jor-el Thomas Caparas,1,0,36,35
1657277770559,MATH 20B,A03,093475,Briones; Jor-el Thomas Caparas,2,0,36,34
1657277776585,MATH 20C,A01,083760,Briones; Jor-el Thomas Caparas,1,0,35,34
1657277776585,MATH 20C,A02,083761,Briones; Jor-el Thomas Caparas,8,0,35,27
1657277776585,MATH 20C,A03,093476,Briones; Jor-el Thomas Caparas,0,1,36,36
1657277776585,MATH 20C,B01,083762,Bach; Quang Tran,1,0,30,29
1657277782614,MATH 20D,A01,083765,Tran; Brian Kha,5,0,30,25
1657277782614,MATH 20D,A02,083766,Tran; Brian Kha,5,0,30,25
1657277782614,MATH 20D,A03,083767,Tran; Brian Kha,4,0,30,26
1657277788649,MATH 20E,A01,083771,Ganguly; Soumya,7,0,32,25
1657277788649,MATH 20E,A02,083772,Ganguly; Soumya,7,0,32,25
1657277788649,MATH 20E,B01,083773,Ciotti; Benjamin,19,0,35,16
1657277788649,MATH 20E,B02,083774,Ciotti; Benjamin,17,0,35,18
1657277794682,MATH 103A,A01,083777,Greenfeld; Be'Eri,3,0,36,33
1657277794682,MATH 103A,A02,083778,Greenfeld; Be'Eri,5,0,36,31
1657277794682,MATH 103A,A03,093561,Greenfeld; Be'Eri,4,0,36,32
1657277794682,MATH 103A,B01,083779,Greenfeld; Be'Eri,6,0,36,30
1657277794682,MATH 103A,B02,083780,Greenfeld; Be'Eri,3,0,36,33
1657277794682,MATH 103A,B03,093562,Greenfeld; Be'Eri,3,0,36,33
1657277800707,MATH 105,A01,085443,Carter; Anne Toulson,15,0,35,20
1657277800707,MATH 105,A02,093477,Carter; Anne Toulson,20,0,35,15
1657277806731,MATH 109,A01,083213,Ganzberger; Geoffrey Michael,2,0,34,32
1657277806731,MATH 109,A02,083214,Ganzberger; Geoffrey Michael,4,0,34,30
1657277806731,MATH 109,A03,093478,Ganzberger; Geoffrey Michael,2,0,34,32
1657277806731,MATH 109,B01,083215,Ganzberger; Geoffrey Michael,1,0,32,31
1657277806731,MATH 109,B02,083216,Ganzberger; Geoffrey Michael,1,0,32,31
1657277806731,MATH 109,B03,093479,Ganzberger; Geoffrey Michael,8,0,32,24
1657277812756,MATH 142A,A01,083219,Chow; Bennett,7,0,32,25
1657277812756,MATH 142A,A02,083220,Chow; Bennett,10,0,32,22
1657277812756,MATH 142A,A03,093480,Chow; Bennett,7,0,32,25
1657277812756,MATH 142A,B03,093481,Chow; Bennett,8,0,32,24
1657277812756,MATH 142A,B04,093558,Chow; Bennett,12,0,32,20
1657277812756,MATH 142A,B05,093559,Chow; Bennett,6,0,32,26
1657277818780,MATH 193A,A01,083224,Rotar; Vladimir,7,0,34,27
1657277818780,MATH 193A,A02,083225,Rotar; Vladimir,6,0,34,28
1657277818780,MATH 193A,A03,083781,Rotar; Vladimir,2,0,34,32
1657277818780,MATH 193A,A04,083782,Rotar; Vladimir,8,0,34,26
1657277818780,MATH 193A,A05,093482,Rotar; Vladimir,6,0,34,28
1657277826330,MATH 197,001,091859,McAuley; Julian John,9999,0,9999,0
1657277826330,MATH 197,002,095566,Kedlaya; Kiran S.,9997,0,9999,2
1657277826330,MATH 197,003,095567,Xiao; Ming,9999,0,9999,0
1657277826330,MATH 197,004,095571,Perols; Johan Lars,9998,0,9999,1
1657277833426,COGS 9,A01,083615,Shannon; Kyle Michael,8,0,75,67
1657277839454,COGS 11,A01,083617,Boyle; Mary E. T.,22,0,48,26
1657277845485,COGS 13,A01,083071,Bastos; Amalia Pinkusfeld,9,0,71,62
1657277851517,COGS 14A,A01,092681,Semenuks; Arturs,2,1,100,98
1657277857543,COGS 14B,A01,083073,Cheng; Tzu-Han,6,0,63,57
1657277863568,COGS 17,A01,092677,Semenuks; Arturs,5,0,81,76
1657277869599,COGS 100,A01,083619,Allen; Michael Gordon,16,0,70,54
1657277875623,COGS 101A,A01,083621,Davis; Joshua Daniel,9,0,68,59
1657277881650,COGS 101B,A01,091572,Allen; Michael Gordon,11,0,65,54
1657277887681,COGS 101C,A01,083625,Delgado; Tania,17,0,35,18
1657277893705,COGS 107A,A01,083627,Boyle; Mary E. T.,13,0,60,47
1657277899734,COGS 118A,A01,083075,Gupta; Anjum,18,0,76,58
1657277905759,CSE 3,A50,083646,Miranda; Gregory Joseph,24,0,50,26
1657277911784,CSE 8A,A50,083650,Miranda; Gregory Joseph,17,1,56,39
1657277917813,CSE 11,A01,083080,Cao; Yingjun,5,15,40,35
1657277923836,CSE 12,A01,083652,Krause-Levy; Sophia Louisa,26,1,120,94
1657277929861,CSE 15L,A01,083654,Morris; Justin Loren,9,0,50,41
1657277929861,CSE 15L,A02,083655,Morris; Justin Loren,9,0,50,41
1657277935887,CSE 20,A01,083657,Tran; Khoa Dang,38,0,80,42
1657277941913,CSE 21,A01,095574,Bach; Quang Tran,22,0,48,26
1657277947946,CSE 30,A01,083084,Eldon; John,4,0,80,76
1657277947946,CSE 30,B01,095061,Bhaskar; Nishant,8,0,50,42
1657277953972,CSE 100,A01,083659,Cao; Yingjun,4,4,70,66
1657277959996,CSE 134B,A01,083661,Powell; Thomas Allan,21,0,100,79
1657277966021,CSE 140,A01,083663,Gungor; Onat,13,0,85,72
1657277972045,CSE 140L,A01,083088,Eldon; John,19,0,100,81
1657277978072,CSE 175,A01,083665,Kumar; Rakesh,3,0,25,22
1657277984097,CSE 190,A00,092507,Dubnov; Shlomo,7,0,20,13
1657277990123,ECE 45,A01,083139,Congero; Spencer William,5,0,75,70
1657277996161,ECE 65,A50,083695,Saad; Andrew S,12,0,30,18
1657277996161,ECE 65,A51,095125,Saad; Andrew S,25,0,26,1
1657278002300,ECE 109,A01,091882,Touri; Behrouz,19,0,70,51
1657278008325,ECE 180,A00,083140,Abi Samra; Nicholas Camill,1,0,30,29
1657278008325,ECE 180,B00,083141,Abi Samra; Nicholas Camill,0,0,30,30
1657278014350,MATH 10A,A01,083735,Patchell; Gregory David,2,0,30,28
1657278014350,MATH 10A,A02,083736,Patchell; Gregory David,20,0,30,10
1657278014350,MATH 10A,A03,083737,Patchell; Gregory David,16,0,30,14
1657278020377,MATH 10B,A01,083207,Lim; Seonhee,7,0,34,27
1657278020377,MATH 10B,A02,083208,Lim; Seonhee,9,0,35,26
1657278020377,MATH 10B,A03,093472,Lim; Seonhee,5,0,34,29
1657278020377,MATH 10B,B01,083739,Sinha; Shubham,11,0,30,19
1657278026404,MATH 18,A01,083743,Cinel; Cameron Alexander,6,0,30,24
1657278026404,MATH 18,A02,083744,Cinel; Cameron Alexander,17,0,30,13
1657278026404,MATH 18,A03,083745,Cinel; Cameron Alexander,8,0,30,22
1657278026404,MATH 18,B01,083748,Rideout; David Porter,4,0,37,33
1657278026404,MATH 18,B02,083749,Rideout; David Porter,4,0,36,32
1657278026404,MATH 18,B03,083750,Rideout; David Porter,2,0,37,35
1657278026404,MATH 18,B04,083751,Rideout; David Porter,6,0,36,30
1657278026404,MATH 18,B05,093473,Rideout; David Porter,5,0,36,31
1657278026404,MATH 18,B06,093474,Rideout; David Porter,5,0,36,31
1657278032433,MATH 20A,A01,083754,Zheng; Zequn,14,0,40,26
1657278038457,MATH 20B,A01,083756,Briones; Jor-el Thomas Caparas,3,0,36,33
1657278038457,MATH 20B,A02,083757,Briones; Jor-el Thomas Caparas,1,0,36,35
1657278038457,MATH 20B,A03,093475,Briones; Jor-el Thomas Caparas,2,0,36,34
1657278044488,MATH 20C,A01,083760,Briones; Jor-el Thomas Caparas,1,0,35,34
1657278044488,MATH 20C,A02,083761,Briones; Jor-el Thomas Caparas,8,0,35,27
1657278044488,MATH 20C,A03,093476,Briones; Jor-el Thomas Caparas,0,1,36,36
1657278044488,MATH 20C,B01,083762,Bach; Quang Tran,1,0,30,29
1657278050518,MATH 20D,A01,083765,Tran; Brian Kha,5,0,30,25
1657278050518,MATH 20D,A02,083766,Tran; Brian Kha,5,0,30,25
1657278050518,MATH 20D,A03,083767,Tran; Brian Kha,4,0,30,26
1657278056557,MATH 20E,A01,083771,Ganguly; Soumya,7,0,32,25
1657278056557,MATH 20E,A02,083772,Ganguly; Soumya,7,0,32,25
1657278056557,MATH 20E,B01,083773,Ciotti; Benjamin,19,0,35,16
1657278056557,MATH 20E,B02,083774,Ciotti; Benjamin,17,0,35,18
1657278062584,MATH 103A,A01,083777,Greenfeld; Be'Eri,3,0,36,33
1657278062584,MATH 103A,A02,083778,Greenfeld; Be'Eri,5,0,36,31
1657278062584,MATH 103A,A03,093561,Greenfeld; Be'Eri,4,0,36,32
1657278062584,MATH 103A,B01,083779,Greenfeld; Be'Eri,6,0,36,30
1657278062584,MATH 103A,B02,083780,Greenfeld; Be'Eri,3,0,36,33
1657278062584,MATH 103A,B03,093562,Greenfeld; Be'Eri,3,0,36,33
1657278068609,MATH 105,A01,085443,Carter; Anne Toulson,15,0,35,20
1657278068609,MATH 105,A02,093477,Carter; Anne Toulson,20,0,35,15
1657278074638,MATH 109,A01,083213,Ganzberger; Geoffrey Michael,2,0,34,32
1657278074638,MATH 109,A02,083214,Ganzberger; Geoffrey Michael,4,0,34,30
1657278074638,MATH 109,A03,093478,Ganzberger; Geoffrey Michael,2,0,34,32
1657278074638,MATH 109,B01,083215,Ganzberger; Geoffrey Michael,1,0,32,31
1657278074638,MATH 109,B02,083216,Ganzberger; Geoffrey Michael,1,0,32,31
1657278074638,MATH 109,B03,093479,Ganzberger; Geoffrey Michael,8,0,32,24
1657278080669,MATH 142A,A01,083219,Chow; Bennett,7,0,32,25
1657278080669,MATH 142A,A02,083220,Chow; Bennett,10,0,32,22
1657278080669,MATH 142A,A03,093480,Chow; Bennett,7,0,32,25
1657278080669,MATH 142A,B03,093481,Chow; Bennett,8,0,32,24
1657278080669,MATH 142A,B04,093558,Chow; Bennett,12,0,32,20
1657278080669,MATH 142A,B05,093559,Chow; Bennett,6,0,32,26
1657278086695,MATH 193A,A01,083224,Rotar; Vladimir,7,0,34,27
1657278086695,MATH 193A,A02,083225,Rotar; Vladimir,6,0,34,28
1657278086695,MATH 193A,A03,083781,Rotar; Vladimir,2,0,34,32
1657278086695,MATH 193A,A04,083782,Rotar; Vladimir,8,0,34,26
1657278086695,MATH 193A,A05,093482,Rotar; Vladimir,6,0,34,28
1657278092726,MATH 197,001,091859,McAuley; Julian John,9999,0,9999,0
1657278092726,MATH 197,002,095566,Kedlaya; Kiran S.,9997,0,9999,2
1657278092726,MATH 197,003,095567,Xiao; Ming,9999,0,9999,0
1657278092726,MATH 197,004,095571,Perols; Johan Lars,9998,0,9999,1
1657278099803,COGS 9,A01,083615,Shannon; Kyle Michael,8,0,75,67
1657278105826,COGS 11,A01,083617,Boyle; Mary E. T.,22,0,48,26
1657278111853,COGS 13,A01,083071,Bastos; Amalia Pinkusfeld,9,0,71,62
1657278117878,COGS 14A,A01,092681,Semenuks; Arturs,2,1,100,98
1657278123906,COGS 14B,A01,083073,Cheng; Tzu-Han,6,0,63,57
1657278129931,COGS 17,A01,092677,Semenuks; Arturs,5,0,81,76
1657278135957,COGS 100,A01,083619,Allen; Michael Gordon,16,0,70,54
1657278141982,COGS 101A,A01,083621,Davis; Joshua Daniel,9,0,68,59
1657278148005,COGS 101B,A01,091572,Allen; Michael Gordon,11,0,65,54
1657278154034,COGS 101C,A01,083625,Delgado; Tania,17,0,35,18
1657278160063,COGS 107A,A01,083627,Boyle; Mary E. T.,13,0,60,47
1657278166088,COGS 118A,A01,083075,Gupta; Anjum,18,0,76,58
1657278172114,CSE 3,A50,083646,Miranda; Gregory Joseph,24,0,50,26
1657278178143,CSE 8A,A50,083650,Miranda; Gregory Joseph,17,1,56,39
1657278184172,CSE 11,A01,083080,Cao; Yingjun,5,15,40,35
1657278190196,CSE 12,A01,083652,Krause-Levy; Sophia Louisa,26,1,120,94
1657278196222,CSE 15L,A01,083654,Morris; Justin Loren,9,0,50,41
1657278196222,CSE 15L,A02,083655,Morris; Justin Loren,9,0,50,41
1657278202247,CSE 20,A01,083657,Tran; Khoa Dang,38,0,80,42
1657278208344,CSE 21,A01,095574,Bach; Quang Tran,22,0,48,26
1657278214377,CSE 30,A01,083084,Eldon; John,4,0,80,76
1657278214377,CSE 30,B01,095061,Bhaskar; Nishant,8,0,50,42
1657278220407,CSE 100,A01,083659,Cao; Yingjun,4,4,70,66
1657278226434,CSE 134B,A01,083661,Powell; Thomas Allan,21,0,100,79
1657278232463,CSE 140,A01,083663,Gungor; Onat,13,0,85,72
1657278238493,CSE 140L,A01,083088,Eldon; John,19,0,100,81
1657278244521,CSE 175,A01,083665,Kumar; Rakesh,3,0,25,22
1657278250547,CSE 190,A00,092507,Dubnov; Shlomo,7,0,20,13
1657278256582,ECE 45,A01,083139,Congero; Spencer William,5,0,75,70
